a	abcdefghijklmnopqrstuvwxyz
aa	abdefijklmnopqrstuvxy
aaa	rv
aad	bko
aae	v
aaf	v
aaj	aqw
aal	irv
aali	y
aaliy	a
aaliya	h
aao	bhm
aaq	abeinoqsvy
aar	dho
aard	vw
aardv	a
aardva	r
aardvar	k
aardw	o
aardwo	l
aardwol	f
aarh	u
aarhu	s
aaro	n
aas	v
aasv	o
aasvo	g
aasvog	e
aasvoge	l
aat	v
aau	r
aav	e
aax	hiuvx
aay	hov
ab	abcdefghijklmnopqrstuvy
aba	bcflnrstv
abab	a
abac	iku
abacu	s
abacus	e
abacuse	s
abaf	t
abal	o
abalo	n
abalon	e
aban	d
aband	o
abando	n
abandon	aeims
abandona	b
abandonab	l
abandonabl	e
abandone	der
abandoner	s
abandoni	n
abandonin	g
abandonm	e
abandonme	n
abandonmen	t
abandonment	s
abar	t
abart	h
abas	ehi
abase	dms
abasem	e
abaseme	n
abasemen	t
abasement	s
abash	eim
abashe	ds
abashed	ln
abashedl	y
abashedn	e
abashedne	s
abashednes	s
abashedness	e
abashednesse	s
abashi	n
abashin	g
abashm	e
abashme	n
abashmen	t
abasi	n
abasin	g
abat	aeiot
abata	b
abatab	l
abatabl	e
abate	dmrs
abatem	e
abateme	n
abatemen	t
abatement	s
abater	s
abati	ns
abatin	g
abato	r
abator	s
abatt	o
abatto	i
abattoi	r
abattoir	s
abb	aeory
abba	ct
abbac	y
abbat	ei
abbate	s
abbates	s
abbati	a
abbatia	l
abbe	sy
abbes	s
abbess	e
abbesse	s
abbey	s
abbo	t
abbot	cst
abbotc	iy
abbotci	e
abbotcie	s
abbots	h
abbotsh	i
abbotshi	p
abbotship	s
abbr	e
abbre	v
abbrev	i
abbrevi	a
abbrevia	t
abbreviat	eio
abbreviate	ds
abbreviati	no
abbreviatin	g
abbreviatio	n
abbreviation	s
abbreviato	r
abbreviator	sy
abc	dos
abco	u
abcou	l
abcoul	o
abcoulo	m
abcoulom	b
abd	imouv
abdi	c
abdic	a
abdica	bnt
abdicab	l
abdicabl	e
abdican	t
abdicat	eio
abdicate	ds
abdicati	nov
abdicatin	g
abdicatio	n
abdication	s
abdicativ	e
abdicato	r
abdicator	s
abdo	m
abdom	ei
abdome	n
abdomen	s
abdomi	n
abdomin	a
abdomina	l
abdominal	l
abdominall	y
abdu	cl
abduc	t
abduct	eios
abducte	d
abducti	no
abductin	g
abductio	n
abduction	s
abducto	r
abductor	es
abductore	s
abe	acdflrstuvwy
abea	m
abec	e
abece	d
abeced	a
abeceda	r
abecedar	i
abecedari	a
abecedaria	n
abel	ims
abeli	a
abelia	n
abelm	o
abelmo	s
abelmos	k
abels	o
abelso	n
aber	dnr
aberd	e
aberde	e
aberdee	n
abern	a
aberna	t
abernat	h
abernath	y
aberr	a
aberra	nt
aberran	ct
aberranc	e
aberrat	i
aberrati	o
aberratio	n
aberration	as
aberrationa	l
aberrational	l
aberrationall	y
abes	t
abest	r
abestr	i
abestri	n
abestrin	e
abet	mst
abetm	e
abetme	n
abetmen	t
abetment	s
abett	aeio
abetta	ln
abettal	s
abettan	c
abettanc	e
abette	dr
abetter	s
abetti	n
abettin	g
abetto	r
abettor	s
abew	v
abey	a
abeya	n
abeyan	c
abeyanc	e
abf	a
abfa	r
abfar	a
abfara	d
abg	w
abh	eio
abhe	n
abhen	r
abhenr	y
abho	r
abhor	rs
abhorr	ei
abhorre	dnr
abhorren	ct
abhorrenc	e
abhorrence	s
abhorrent	l
abhorrentl	y
abhorrer	s
abhorri	bn
abhorrib	l
abhorribl	e
abhorrin	g
abi	defglrsv
abid	aeij
abida	n
abidan	c
abidanc	e
abide	drs
abider	s
abidi	n
abidin	g
abiding	s
abidj	a
abidja	n
abie	n
abien	t
abig	a
abiga	i
abigai	l
abil	ei
abile	n
abilen	e
abili	t
abilit	iy
abiliti	e
abilitie	s
ability	p
abilityp	o
abilitypo	w
abilitypow	e
abilitypowe	r
abilitypower	c
abilitypowerc	a
abilitypowerca	r
abilitypowercar	r
abilitypowercarr	y
abj	euv
abje	c
abjec	t
abject	eiln
abjecte	d
abjected	n
abjectedn	e
abjectedne	s
abjectednes	s
abjectedness	e
abjectednesse	s
abjecti	o
abjectio	n
abjection	s
abjectl	y
abjectn	e
abjectne	s
abjectnes	s
abjectness	e
abjectnesse	s
abju	r
abjur	aei
abjura	t
abjurat	i
abjurati	o
abjuratio	n
abjure	ds
abjuri	n
abjurin	g
abk	diorv
abl	aeouy
abla	ctuz
ablac	t
ablact	a
ablacta	t
ablactat	i
ablactati	o
ablactatio	n
ablat	eio
ablate	ds
ablati	nov
ablatin	g
ablatio	n
ablation	s
ablativ	e
ablato	r
ablator	s
ablau	t
ablaz	e
able	bnrs
ableb	o
ablebo	d
ablebod	i
ablebodi	e
ablebodie	d
ablen	e
ablene	s
ablenes	s
ables	t
ablo	o
abloo	m
ablu	st
ablus	h
ablut	i
abluti	o
ablutio	n
abn	eloprv
abne	gr
abneg	a
abnega	t
abnegat	ei
abnegati	o
abnegatio	n
abno	r
abnor	m
abnorm	ai
abnorma	l
abnormal	ilns
abnormali	stz
abnormalis	m
abnormalit	iy
abnormaliti	e
abnormalitie	s
abnormaliz	e
abnormall	y
abnormaln	e
abnormalne	s
abnormalnes	s
abnormalness	e
abnormalnesse	s
abnormi	t
abnormit	y
abo	adilmrsuv
aboa	r
aboar	d
abod	ei
abode	ds
abodi	n
abodin	g
aboi	l
abol	i
aboli	st
abolis	h
abolish	aeim
abolisha	b
abolishab	l
abolishabl	e
abolishe	drs
abolisher	s
abolishi	n
abolishin	g
abolishm	e
abolishme	n
abolishmen	t
abolishment	s
abolit	i
aboliti	o
abolitio	n
abolition	ais
abolitiona	r
abolitionar	y
abolitioni	s
abolitionis	mt
abolitionist	s
abom	i
abomi	n
abomin	a
abomina	bt
abominab	l
abominabl	ey
abominable	n
abominablen	e
abominablene	s
abominablenes	s
abominableness	e
abominablenesse	s
abominat	ei
abominati	o
abominatio	n
abor	aintv
abora	l
abori	g
aborig	i
aborigi	n
aborigin	ae
aborigina	l
aboriginal	ils
aboriginali	t
aboriginalit	i
aboriginaliti	e
aboriginalitie	s
aboriginall	y
aborigine	s
aborn	i
aborni	n
abornin	g
abort	eimos
aborte	der
aborter	s
aborti	cnov
abortic	i
abortici	d
aborticid	e
abortin	g
abortio	n
abortion	ais
abortiona	l
abortioni	s
abortionis	t
abortionist	s
abortiv	e
abortive	ln
abortivel	y
abortiven	e
abortivene	s
abortivenes	s
abortiveness	e
abortivenesse	s
abortm	e
abortme	n
abortmen	t
aborto	r
abortor	i
abortori	u
abortoriu	m
abou	nt
aboun	d
abound	eis
abounde	dr
aboundi	n
aboundin	g
abounding	l
aboundingl	y
about	n
aboutn	e
aboutne	s
aboutnes	s
abov	e
above	bgms
aboveb	o
abovebo	a
aboveboa	r
aboveboar	d
aboveg	r
abovegr	o
abovegro	u
abovegrou	n
abovegroun	d
abovem	e
aboveme	n
abovemen	t
abovement	i
abovementi	o
abovementio	n
abovemention	e
abovementione	d
abp	d
abq	dp
abr	aeiou
abra	cdhms
abrac	a
abraca	d
abracad	a
abracada	b
abracadab	r
abracadabr	a
abrad	aei
abrada	n
abradan	t
abrade	ds
abradi	n
abradin	g
abrah	a
abraha	m
abram	os
abramo	f
abramof	f
abrams	o
abramso	n
abras	i
abrasi	ov
abrasio	n
abrasion	as
abrasiona	l
abrasiv	e
abrasive	lns
abrasivel	y
abrasiven	e
abrasivene	s
abrasivenes	s
abrasiveness	e
abrasivenesse	s
abre	a
abrea	cs
abreac	t
abreact	i
abreacti	o
abreactio	n
abreaction	s
abreas	t
abri	d
abrid	g
abridg	eim
abridge	dmrs
abridgem	e
abridgeme	n
abridgemen	t
abridger	s
abridgi	n
abridgin	g
abridgm	e
abridgme	n
abridgmen	t
abro	ag
abroa	d
abroad	s
abrog	a
abroga	t
abrogat	ei
abrogate	ds
abrogati	no
abrogatin	g
abrogatio	n
abru	p
abrup	t
abrupt	eln
abrupte	rs
abruptes	t
abruptl	y
abruptn	e
abruptne	s
abruptnes	s
abruptness	e
abruptnesse	s
abs	ceiostu
absc	eio
absce	s
absces	s
abscess	e
abscesse	ds
absci	ns
abscin	d
abscis	s
absciss	ai
abscissa	s
abscissi	o
abscissio	n
absco	n
abscon	ds
abscond	eis
absconde	dnr
absconden	c
abscondenc	e
absconder	s
abscondi	n
abscondin	g
abscons	i
absconsi	o
absconsio	n
abse	ins
absei	l
abseil	eis
abseile	dr
abseili	n
abseilin	g
absen	ct
absenc	e
absence	s
absent	aeilmns
absenta	t
absentat	i
absentati	o
absentatio	n
absentation	s
absente	ders
absentee	is
absenteei	s
absenteeis	m
absenteeism	s
absentees	h
absenteesh	i
absenteeshi	p
absenter	s
absentes	t
absenti	an
absentin	g
absentl	y
absentm	i
absentmi	n
absentmin	d
absentmind	e
absentminde	d
absentn	e
absentne	s
absentnes	s
absentness	e
absentnesse	s
absi	n
absin	t
absint	h
absinth	ei
absinthi	s
absinthis	m
abso	lr
absol	uv
absolu	t
absolut	ei
absolute	lnrs
absolutel	y
absoluten	e
absolutene	s
absolutenes	s
absoluteness	e
absolutenesse	s
absolutes	t
absoluti	os
absolutio	n
absolution	s
absolutis	mt
absolv	aei
absolva	b
absolvab	l
absolvabl	e
absolve	dnrs
absolven	t
absolvent	s
absolver	s
absolvi	n
absolvin	g
absor	bp
absorb	aeis
absorba	bn
absorbab	il
absorbabi	l
absorbabil	i
absorbabili	t
absorbabilit	iy
absorbabiliti	e
absorbabilitie	s
absorbabl	e
absorban	t
absorbant	s
absorbe	dnr
absorbed	ln
absorbedl	y
absorbedn	e
absorbedne	s
absorbednes	s
absorbedness	e
absorbednesse	s
absorben	ct
absorbenc	y
absorbent	s
absorber	s
absorbi	n
absorbin	g
absorbing	l
absorbingl	y
absorp	t
absorpt	ai
absorpta	n
absorptan	c
absorptanc	e
absorpti	ov
absorptio	n
absorption	as
absorptiona	l
absorptiv	e
abst	aeir
absta	i
abstai	n
abstain	eis
abstaine	dr
abstainer	s
abstaini	n
abstainin	g
abste	mnr
abstem	i
abstemi	o
abstemio	u
abstemiou	s
absten	t
abstent	i
abstenti	o
abstentio	nu
abstention	is
abstentioni	s
abstentionis	m
abstentiou	s
abster	g
absterg	e
absterge	n
abstergen	t
absti	n
abstin	e
abstine	n
abstinen	ct
abstinenc	ei
abstinence	s
abstinenci	e
abstinencie	s
abstinent	l
abstinentl	y
abstr	au
abstra	c
abstrac	t
abstract	aeilnos
abstracta	b
abstractab	l
abstractabl	e
abstracte	drs
abstracter	s
abstractes	t
abstracti	no
abstractin	g
abstractio	n
abstraction	ais
abstractiona	l
abstractioni	s
abstractionis	mt
abstractl	y
abstractn	e
abstractne	s
abstractnes	s
abstractness	e
abstractnesse	s
abstracto	r
abstractor	s
abstru	s
abstrus	e
abstruse	n
abstrusen	e
abstrusene	s
abstrusenes	s
absu	r
absur	d
absurd	eilns
absurde	rs
absurdes	t
absurdi	t
absurdit	iy
absurditi	e
absurditie	s
absurdl	y
absurdn	e
absurdne	s
absurdnes	s
absurdness	e
absurdnesse	s
abt	o
abu	elnstz
abul	i
abuli	a
abun	d
abund	a
abunda	n
abundan	ct
abundanc	ey
abundance	s
abundant	l
abundantl	y
abus	aei
abusa	bg
abusab	l
abusabl	e
abusag	e
abuse	dfrs
abusef	u
abusefu	l
abuseful	l
abusefull	y
abuser	s
abusi	nv
abusin	g
abusiv	e
abusive	ln
abusivel	y
abusiven	e
abusivene	s
abusivenes	s
abusiveness	e
abusivenesse	s
abut	mst
abutm	e
abutme	n
abutmen	t
abutt	aei
abutta	l
abuttal	s
abutte	dr
abutter	s
abutti	n
abuttin	g
abuz	z
aby	s
abys	ms
abysm	a
abysma	l
abysmal	l
abysmall	y
abyss	aei
abyssa	l
abysse	s
abyssi	n
abyssin	i
abyssini	a
abyssinia	n
abyssinian	s
ac	abcdefghijklmnopqrstuwxy
aca	cdlnprv
acac	i
acaci	a
acacia	s
acad	ei
acade	m
academ	iy
academi	aces
academic	ais
academica	l
academical	l
academicall	y
academici	asz
academicia	n
academician	s
academicis	m
academiciz	e
academie	s
academis	t
academy	a
academya	w
academyaw	a
academyawa	r
academyawar	d
acadi	a
acal	e
acale	p
acalep	h
acan	t
acant	h
acanth	u
acanthu	s
acap	u
acapu	l
acapul	c
acapulc	o
acb	r
acc	ehiloruv
acce	dlnps
acced	e
accede	ds
accel	e
accele	r
acceler	ao
accelera	bnt
accelerab	l
accelerabl	e
acceleran	dt
accelerand	o
accelerando	s
accelerat	eio
accelerate	ds
accelerated	l
acceleratedl	y
accelerati	no
acceleratin	g
accelerating	l
acceleratingl	y
acceleratio	n
acceleration	s
accelerato	r
accelerator	s
accelero	m
accelerom	e
accelerome	t
acceleromet	e
acceleromete	r
accelerometer	s
accen	t
accent	eilsu
accente	d
accenti	n
accentin	g
accentl	e
accentle	s
accentles	s
accentu	a
accentua	blt
accentuab	l
accentuabl	e
accentuat	eio
accentuate	ds
accentuati	no
accentuatin	g
accentuatio	n
accentuation	s
accentuato	r
accep	t
accept	aeios
accepta	bnt
acceptab	il
acceptabi	l
acceptabil	i
acceptabili	t
acceptabilit	iy
acceptabiliti	e
acceptabilitie	s
acceptabl	ey
acceptable	n
acceptablen	e
acceptablene	s
acceptablenes	s
acceptableness	e
acceptablenesse	s
acceptan	c
acceptanc	ey
acceptance	s
acceptat	i
acceptati	o
acceptatio	n
accepte	dr
accepter	s
accepti	n
acceptin	g
accepting	ln
acceptingl	y
acceptingn	e
acceptingne	s
acceptingnes	s
acceptingness	e
acceptingnesse	s
accepto	r
acceptor	s
acces	s
access	aeio
accessa	r
accessar	iy
accessari	e
accessarie	s
accesse	ds
accessi	bno
accessib	il
accessibi	l
accessibil	i
accessibili	t
accessibilit	iy
accessibiliti	e
accessibilitie	s
accessibl	ey
accessible	n
accessiblen	e
accessiblene	s
accessiblenes	s
accessibleness	e
accessiblenesse	s
accessin	g
accessio	n
accession	eis
accessione	d
accessioni	n
accessionin	g
accesso	r
accessor	isy
accessori	eln
accessorie	s
accessoril	y
accessorin	e
accessorine	s
accessorines	s
accessoriness	e
accessorinesse	s
acch	o
acci	dp
accid	e
accide	n
acciden	ct
accidenc	e
accident	als
accidenta	l
accidental	ilns
accidentali	t
accidentalit	iy
accidentaliti	e
accidentalitie	s
accidentall	y
accidentaln	e
accidentalne	s
accidentalnes	s
accidentalness	e
accidentalnesse	s
accidentl	y
accip	i
accipi	t
accipit	r
accipitr	a
accipitra	l
accl	ai
accla	im
acclai	m
acclaim	eis
acclaime	dr
acclaimer	s
acclaimi	n
acclaimin	g
acclam	a
acclama	t
acclamat	i
acclamati	o
acclamatio	n
acclamation	s
accli	mv
acclim	a
acclima	t
acclimat	ei
acclimate	ds
acclimati	nosz
acclimatin	g
acclimatio	n
acclimatis	aei
acclimatisa	b
acclimatisab	l
acclimatisabl	e
acclimatise	ds
acclimatisi	n
acclimatisin	g
acclimatiz	aei
acclimatiza	bt
acclimatizab	l
acclimatizabl	e
acclimatizat	i
acclimatizati	o
acclimatizatio	n
acclimatization	s
acclimatize	drs
acclimatizer	s
acclimatizi	n
acclimatizin	g
accliv	i
acclivi	t
acclivit	oy
acclivito	u
acclivitou	s
acco	lmrsu
accol	a
accola	d
accolad	ei
accolade	ds
accoladi	n
accoladin	g
accom	mp
accomm	o
accommo	d
accommod	a
accommoda	bt
accommodab	l
accommodabl	e
accommodat	eio
accommodate	ds
accommodati	nov
accommodatin	g
accommodating	l
accommodatingl	y
accommodatio	n
accommodation	as
accommodationa	l
accommodativ	e
accommodative	n
accommodativen	e
accommodativene	s
accommodativenes	s
accommodativeness	e
accommodativenesse	s
accommodato	r
accommodator	sy
accomp	al
accompa	n
accompan	aiy
accompana	b
accompanab	l
accompanabl	e
accompani	ems
accompanie	drs
accompanim	e
accompanime	n
accompanimen	t
accompaniment	as
accompanimenta	l
accompanis	t
accompanist	s
accompany	i
accompanyi	n
accompanyin	g
accompl	i
accompli	cs
accomplic	e
accomplice	s
accomplices	h
accomplicesh	i
accompliceshi	p
accomplis	h
accomplish	aeim
accomplisha	b
accomplishab	l
accomplishabl	e
accomplishe	drs
accomplisher	s
accomplishi	n
accomplishin	g
accomplishm	e
accomplishme	n
accomplishmen	t
accomplishment	s
accor	d
accord	aeims
accorda	bn
accordab	l
accordabl	e
accordan	ct
accordanc	ey
accordance	s
accorde	dr
accorder	s
accordi	no
accordin	g
according	l
accordingl	y
accordio	n
accordion	eis
accordione	d
accordioni	ns
accordionin	g
accordionis	t
accordionist	s
accordm	e
accordme	n
accordmen	t
accos	t
accost	aeis
accosta	b
accostab	l
accostabl	e
accoste	dr
accosti	n
accostin	g
accou	cnt
accouc	h
accouch	e
accouche	m
accouchem	e
accoucheme	n
accouchemen	t
accoun	t
account	aeis
accounta	bn
accountab	il
accountabi	l
accountabil	i
accountabili	t
accountabilit	y
accountabl	ey
accountable	n
accountablen	e
accountablene	s
accountablenes	s
accountableness	e
accountablenesse	s
accountan	ct
accountanc	iy
accountanci	e
accountancie	s
accountant	s
accountants	h
accountantsh	i
accountantshi	p
accountantship	s
accounte	dr
accounti	n
accountin	g
accout	er
accoute	r
accouter	m
accouterm	e
accouterme	n
accoutermen	t
accouterment	s
accoutr	e
accoutre	m
accoutrem	e
accoutreme	n
accoutremen	t
accoutrement	s
accr	aeu
accre	dt
accred	i
accredi	t
accredit	ae
accredita	t
accreditat	i
accreditati	o
accreditatio	n
accreditation	s
accredite	d
accret	ei
accreti	o
accretio	n
accretion	s
accru	aei
accrua	bl
accruab	l
accruabl	e
accrue	dmrs
accruem	e
accrueme	n
accruemen	t
accruement	s
accrui	n
accruin	g
accu	lmprs
accul	t
accult	u
accultu	r
accultur	a
accultura	t
acculturat	ei
acculturate	ds
acculturati	no
acculturatin	g
acculturatio	n
accum	bu
accumb	e
accumbe	n
accumben	t
accumu	l
accumul	a
accumula	bt
accumulab	l
accumulabl	e
accumulat	eio
accumulate	ds
accumulati	nov
accumulatin	g
accumulatio	n
accumulation	s
accumulativ	e
accumulato	r
accumulator	s
accup	h
accuph	a
accupha	s
accuphas	e
accur	as
accura	ct
accurac	iy
accuraci	e
accuracie	s
accurat	e
accurate	ln
accuratel	y
accuraten	e
accuratene	s
accuratenes	s
accurateness	e
accuratenesse	s
accurs	et
accurse	d
accus	aeit
accusa	blnt
accusab	l
accusabl	y
accusan	t
accusant	s
accusat	io
accusati	ov
accusatio	n
accusation	s
accusativ	e
accusative	ls
accusativel	y
accusato	r
accusator	iy
accusatori	a
accusatoria	l
accuse	dmrs
accusem	e
accuseme	n
accusemen	t
accuser	s
accusi	n
accusin	g
accusing	l
accusingl	y
accust	o
accusto	m
accustom	aeis
accustoma	bnrt
accustomab	l
accustomabl	ey
accustoman	c
accustomanc	e
accustomar	y
accustomat	i
accustomati	o
accustomatio	n
accustomation	s
accustome	d
accustomed	ln
accustomedl	y
accustomedn	e
accustomedne	s
accustomednes	s
accustomedness	e
accustomednesse	s
accustomi	n
accustomin	g
acd	abjnx
acdb	el
acdbe	n
acdben	t
acdbent	i
acdbenti	t
acdbentit	y
acdbl	i
acdbli	n
acdblin	e
ace	bdrstw
acer	bo
acerb	ai
acerba	t
acerbat	e
acerbi	ct
acerbit	y
acero	s
aceros	e
acet	aioy
aceta	lnt
acetan	i
acetani	l
acetanil	i
acetanili	d
acetanilid	e
acetat	e
acetate	s
aceti	cf
acetif	i
acetifi	c
acetific	a
acetifica	t
acetificat	i
acetificati	o
acetificatio	n
aceto	nu
aceton	eiu
acetone	s
acetoni	c
acetonu	r
acetonur	i
acetonuri	a
acetou	s
acety	l
acetyl	ce
acetylc	h
acetylch	o
acetylcho	l
acetylchol	i
acetylcholi	n
acetylcholin	e
acetyle	n
acetylen	ei
acetylene	ls
acetylenel	a
acetylenela	m
acetylenelam	p
acetyleni	c
acew	v
acf	u
acfu	n
ach	aeior
acha	e
achae	a
achaea	n
achaean	s
ache	dnrs
achen	e
acher	o
achero	n
achi	eln
achie	v
achiev	aei
achieva	b
achievab	il
achievabi	l
achievabil	i
achievabili	t
achievabilit	y
achievabl	e
achieve	dmrs
achievem	e
achieveme	n
achievemen	t
achievement	s
achiever	s
achievi	n
achievin	g
achil	l
achill	e
achille	s
achilles	t
achillest	e
achilleste	n
achillesten	d
achillestend	o
achillestendo	n
achillestendon	s
achin	g
aching	l
achingl	y
acho	no
achon	d
achond	r
achondr	i
achondri	t
achondrit	e
achr	o
achro	m
achrom	a
achroma	t
achromat	i
achromati	c
aci	adnrv
acid	hilnosuy
acidh	e
acidhe	a
acidhea	d
acidi	cft
acidif	iy
acidifi	c
acidific	a
acidifica	t
acidificat	i
acidificati	o
acidificatio	n
acidify	i
acidifyi	n
acidifyin	g
acidit	iy
aciditi	e
aciditie	s
acidl	y
acidn	e
acidne	s
acidnes	s
acidness	e
acidnesse	s
acido	ips
acidoi	d
acidop	h
acidoph	i
acidophi	l
acidophil	o
acidophilo	u
acidophilou	s
acidos	i
acidosi	s
acidu	lm
acidul	ao
acidula	t
acidulat	ei
acidulate	d
acidulati	n
acidulatin	g
acidulo	u
acidulou	s
acin	g
acj	ov
ack	eln
acke	mr
ackem	m
ackemm	a
acker	m
ackerm	a
ackerma	n
ackl	e
ackle	y
ackn	o
ackno	w
acknow	l
acknowl	e
acknowle	d
acknowled	g
acknowledg	eim
acknowledge	admrs
acknowledgea	b
acknowledgeab	l
acknowledgeabl	e
acknowledged	l
acknowledgedl	y
acknowledgem	e
acknowledgeme	n
acknowledgemen	t
acknowledgement	s
acknowledger	s
acknowledgi	n
acknowledgin	g
acknowledgm	e
acknowledgme	n
acknowledgmen	t
acknowledgment	s
acl	v
acm	e
acn	ev
acne	ds
aco	clnru
acoc	k
acol	y
acoly	t
acolyt	e
acolyte	s
acon	i
aconi	t
aconit	e
acor	n
acorn	eis
acorne	d
acorni	n
acornin	g
acou	s
acous	t
acoust	i
acousti	c
acoustic	ais
acoustica	l
acoustical	l
acousticall	y
acoustici	a
acousticia	n
acq	u
acqu	ai
acqua	i
acquai	n
acquain	t
acquaint	aeis
acquainta	n
acquaintan	ct
acquaintanc	e
acquaintance	s
acquaintances	h
acquaintancesh	i
acquaintanceshi	p
acquaintanceship	s
acquainte	d
acquainted	n
acquaintedn	e
acquaintedne	s
acquaintednes	s
acquaintedness	e
acquaintednesse	s
acquainti	n
acquaintin	g
acqui	erst
acquie	s
acquies	c
acquiesc	ei
acquiesce	dns
acquiescen	ct
acquiescenc	e
acquiesci	n
acquiescin	g
acquiescing	l
acquiescingl	y
acquir	aei
acquira	b
acquirab	il
acquirabi	l
acquirabil	i
acquirabili	t
acquirabilit	iy
acquirabiliti	e
acquirabilitie	s
acquirabl	e
acquire	ders
acquiri	n
acquirin	g
acquis	i
acquisi	t
acquisit	io
acquisiti	ov
acquisitio	n
acquisition	as
acquisitiona	l
acquisitiv	e
acquisitive	n
acquisitiven	e
acquisitivene	s
acquisitivenes	s
acquisito	r
acquisitor	s
acquit	mst
acquitm	e
acquitme	n
acquitmen	t
acquitt	aei
acquitta	ln
acquittan	c
acquittanc	e
acquitte	dr
acquitter	s
acquitti	n
acquittin	g
acr	eiosvy
acre	ads
acrea	bg
acreab	l
acreabl	e
acreag	e
acri	dm
acrid	eiln
acride	rs
acrides	t
acridi	t
acridit	iy
acriditi	e
acriditie	s
acridl	y
acridn	e
acridne	s
acridnes	s
acridness	e
acridnesse	s
acrim	o
acrimo	n
acrimon	iy
acrimoni	eo
acrimonie	s
acrimonio	u
acrimoniou	s
acro	blmnps
acrob	a
acroba	ct
acrobac	y
acrobat	is
acrobati	cs
acrobatic	as
acrobatica	l
acrobatical	l
acrobaticall	y
acrobatics	e
acrobaticse	s
acrobatis	m
acrol	i
acroli	t
acrolit	h
acrom	e
acrome	g
acromeg	a
acromega	l
acromegal	iy
acromegali	c
acron	y
acrony	m
acronym	eios
acronyme	d
acronymi	cnz
acronymic	a
acronymica	l
acronymical	l
acronymicall	y
acronymin	g
acronymiz	e
acronymo	u
acronymou	s
acrop	ho
acroph	o
acropho	b
acrophob	i
acrophobi	a
acropo	l
acropol	i
acropoli	s
acros	st
acrost	i
acrosti	c
acry	l
acryl	i
acryli	c
acrylic	s
acs	v
act	aeiorsu
acta	be
actab	i
actabi	l
actabil	i
actabili	t
actabilit	i
actabiliti	e
actabilitie	s
actae	o
actaeo	n
acte	d
acti	novy
actin	gio
acting	s
actini	csu
actinis	m
actiniu	m
actino	m
actinom	e
actinome	t
actinomet	e
actinomete	r
actinometer	s
actio	n
action	aeis
actiona	bl
actionab	l
actionabl	e
actione	d
actioni	n
actionin	g
activ	aei
activa	t
activat	eio
activate	ds
activati	no
activatin	g
activatio	n
activation	s
activato	r
activator	s
active	lnsx
activel	y
activen	e
activene	s
activenes	s
activeness	e
activenesse	s
activi	st
activis	mt
activist	s
activit	iy
activiti	e
activitie	s
activity	p
activityp	u
activitypu	b
actiy	a
actiya	t
actiyat	o
actiyato	r
acto	nr
actor	ilsy
actori	s
actoris	h
actorl	y
actors	h
actorsh	i
actorshi	p
actr	e
actre	s
actres	s
actress	e
actresse	s
actu	a
actua	lrt
actual	ilns
actuali	stz
actualis	mt
actualist	i
actualisti	c
actualit	iy
actualiti	e
actualitie	s
actualiz	ae
actualiza	t
actualizat	i
actualizati	o
actualizatio	n
actuall	y
actualn	e
actualne	s
actualnes	s
actualness	e
actualnesse	s
actuar	iy
actuari	ae
actuaria	ln
actuarial	l
actuariall	y
actuarie	s
actuat	eio
actuate	ds
actuati	no
actuatin	g
actuatio	n
actuato	r
actuator	s
acu	ahimprt
acui	t
acuit	y
acum	e
acume	n
acumen	s
acup	u
acupu	n
acupun	c
acupunc	t
acupunct	u
acupunctu	ar
acupunctua	t
acupunctuat	i
acupunctuati	o
acupunctuatio	n
acupunctur	aei
acupunctura	t
acupuncturat	i
acupuncturati	o
acupuncturatio	n
acupuncture	ds
acupuncturi	ns
acupuncturin	g
acupuncturis	t
acupuncturist	s
acur	a
acut	e
acute	lnrs
acutel	y
acuten	e
acutene	s
acutenes	s
acuteness	e
acutenesse	s
acutes	t
acw	c
acx	i
acxi	o
acxio	m
acy	co
acyc	l
acycl	i
acycli	c
acyclic	a
acyclica	l
acyclical	l
acyclicall	y
ad	abcdefghijklmnoprstuvwxyz
ada	cdgimprsvx
adag	eiy
adage	s
adagi	ao
adagia	l
adagio	s
adai	r
adam	ais
adama	n
adaman	t
adamant	ils
adamanti	n
adamantin	e
adamantl	y
adami	t
adamit	e
adams	o
adamso	n
adap	t
adapt	aeios
adapta	bt
adaptab	il
adaptabi	l
adaptabil	i
adaptabili	t
adaptabilit	iy
adaptabiliti	e
adaptabilitie	s
adaptabl	ey
adaptable	n
adaptablen	e
adaptablene	s
adaptablenes	s
adaptableness	e
adaptablenesse	s
adaptat	i
adaptati	ov
adaptatio	n
adaptation	as
adaptationa	l
adaptational	l
adaptationall	y
adaptativ	e
adapte	cdr
adapted	n
adaptedn	e
adaptedne	s
adaptednes	s
adaptedness	e
adaptednesse	s
adapter	s
adapti	notv
adaptin	g
adaptio	n
adaptit	u
adaptitu	d
adaptitud	e
adaptiv	e
adaptive	l
adaptivel	y
adapto	r
adaptor	s
adax	i
adaxi	a
adaxia	l
adb	sv
adc	l
add	aeilqrsu
adda	bx
addab	l
addabl	e
adde	dnr
added	l
addedl	y
adden	d
addend	au
addendu	m
addendum	s
adder	s
addi	bcnst
addib	l
addibl	e
addic	t
addict	eis
addicte	d
addicti	nov
addictin	g
addictio	n
addiction	s
addictiv	e
addictive	ln
addictivel	y
addictiven	e
addictivene	s
addictivenes	s
addictiveness	e
addictivenesse	s
addin	g
addis	o
addiso	n
addit	i
additi	ov
additio	n
addition	as
additiona	l
additional	l
additionall	y
additiv	ei
additive	ls
additivel	y
additivi	t
additivit	iy
additiviti	e
additivitie	s
addl	e
addr	e
addre	s
addres	st
address	aeio
addressa	b
addressab	il
addressabi	l
addressabil	i
addressabili	t
addressabilit	y
addressabl	e
addresse	ders
addressee	s
addresser	s
addressi	n
addressin	g
addresso	gr
addressog	r
addressogr	a
addressogra	p
addressograp	h
addressor	s
addu	c
adduc	eit
adduce	ds
adduci	bn
adducib	l
adducibl	e
adducin	g
adduct	eios
adducte	d
adducti	no
adductin	g
adductio	n
adducto	r
ade	aeilmnpqvz
adel	aei
adela	i
adelai	d
adelaid	e
adeli	a
aden	io
adeni	n
adenin	e
adeno	is
adenoi	d
adenoid	as
adenoida	l
adenos	i
adenosi	n
adenosin	e
adep	t
adept	eilns
adepte	rs
adeptes	t
adepti	o
adeptio	n
adeptl	y
adeptn	e
adeptne	s
adeptnes	s
adeptness	e
adeptnesse	s
adepts	h
adeptsh	i
adeptshi	p
adeq	u
adequ	a
adequa	ct
adequac	iy
adequaci	e
adequacie	s
adequat	ei
adequate	ln
adequatel	y
adequaten	e
adequatene	s
adequatenes	s
adequateness	e
adequatenesse	s
adequati	v
adequativ	e
adf	ekptuy
adg	u
adgu	a
adgua	r
adguar	d
adguard	h
adguardh	o
adguardho	m
adguardhom	e
adh	deo
adhe	rs
adher	aei
adhera	b
adherab	l
adherabl	e
adhere	dnrs
adheren	ct
adherenc	e
adherent	ls
adherentl	y
adherer	s
adheri	n
adherin	g
adhes	i
adhesi	ov
adhesio	n
adhesion	as
adhesiona	l
adhesiv	e
adhesive	lns
adhesivel	y
adhesiven	e
adhesivene	s
adhesivenes	s
adhesiveness	e
adhesivenesse	s
adho	c
adhoc	ei
adhoce	r
adhocer	y
adhoci	s
adhocis	m
adi	adeoprt
adia	b
adiab	a
adiaba	t
adiabat	i
adiabati	c
adiabatic	a
adiabatica	l
adiabatical	l
adiabaticall	y
adid	a
adida	s
adie	u
adieu	x
adio	s
adip	eo
adipe	x
adipo	s
adipos	ei
adiposi	t
adiposit	y
adir	o
adiro	n
adiron	d
adirond	a
adironda	c
adirondac	k
adirondack	s
adj	aeoru
adja	c
adjac	e
adjace	n
adjacen	ct
adjacenc	y
adjacent	l
adjacentl	y
adje	c
adjec	t
adject	i
adjecti	v
adjectiv	aei
adjectiva	l
adjectival	l
adjectivall	y
adjective	ls
adjectivel	y
adjectivi	z
adjectiviz	e
adjo	iu
adjoi	n
adjoin	eis
adjoine	d
adjoini	n
adjoinin	g
adjou	r
adjour	n
adjourn	eims
adjourne	d
adjourni	n
adjournin	g
adjournm	e
adjournme	n
adjournmen	t
adju	dnrst
adjud	gi
adjudg	ei
adjudge	ds
adjudgi	n
adjudgin	g
adjudi	c
adjudic	a
adjudica	t
adjudicat	eiou
adjudicate	ds
adjudicati	nov
adjudicatin	g
adjudicatio	n
adjudication	s
adjudicativ	e
adjudicato	r
adjudicator	sy
adjudicatu	r
adjudicatur	e
adjun	c
adjunc	t
adjunct	ils
adjuncti	v
adjunctiv	e
adjunctl	y
adjur	aei
adjura	t
adjurat	i
adjurati	o
adjuratio	n
adjure	ds
adjuri	n
adjurin	g
adjus	t
adjust	aeimos
adjusta	b
adjustab	il
adjustabi	l
adjustabil	i
adjustabili	t
adjustabilit	iy
adjustabiliti	e
adjustabilitie	s
adjustabl	ey
adjustable	s
adjuste	dr
adjuster	s
adjusti	n
adjustin	g
adjustm	e
adjustme	n
adjustmen	t
adjustment	s
adjusto	r
adjustor	s
adjut	a
adjuta	n
adjutan	ct
adjutanc	y
adjutant	s
adk	bcdiluv
adkb	v
adki	n
adkin	s
adku	v
adl	es
adle	r
adler	i
adleri	a
adleria	n
adm	aeio
adma	n
adme	a
admea	s
admeas	u
admeasu	r
admeasur	e
admi	nrstx
admin	is
admini	cs
adminic	l
adminicl	e
adminis	t
administ	er
administe	r
administer	aeis
administera	t
administerat	i
administerati	v
administerativ	e
administere	d
administeri	n
administerin	g
administering	s
administr	ae
administra	bnt
administrab	l
administrabl	e
administran	t
administrant	s
administrat	eior
administrati	ov
administratio	n
administration	ais
administrationa	l
administrationi	s
administrationis	t
administrativ	e
administrative	l
administrativel	y
administrato	r
administrator	s
administrators	h
administratorsh	i
administratorshi	p
administratorship	s
administratr	ei
administratre	s
administratres	s
administratri	x
administre	r
admir	aei
admira	blt
admirab	il
admirabi	l
admirabil	i
admirabili	t
admirabilit	iy
admirabiliti	e
admirabilitie	s
admirabl	ey
admirable	n
admirablen	e
admirablene	s
admirablenes	s
admirableness	e
admirablenesse	s
admiral	ist
admirali	s
admiralis	s
admiraliss	i
admiralissi	m
admiralissim	o
admirals	h
admiralsh	i
admiralshi	p
admiralship	s
admiralt	y
admirat	i
admirati	ov
admiratio	n
admiration	s
admirativ	e
admirative	l
admirativel	y
admire	drs
admirer	s
admiri	n
admirin	g
admiring	l
admiringl	y
admis	s
admiss	ai
admissa	b
admissab	l
admissabl	e
admissi	bov
admissib	il
admissibi	l
admissibil	i
admissibili	t
admissibilit	iy
admissibiliti	e
admissibilitie	s
admissibl	ey
admissible	n
admissiblen	e
admissiblene	s
admissiblenes	s
admissibleness	e
admissiblenesse	s
admissio	n
admission	s
admissiv	e
admit	st
admitt	aei
admitta	n
admittan	c
admittanc	e
admittance	s
admitte	dr
admitted	l
admittedl	y
admitter	s
admitti	n
admittin	g
admix	eit
admixe	ds
admixi	n
admixin	g
admixt	u
admixtu	r
admixtur	e
admo	n
admon	i
admoni	st
admonis	h
admonish	eim
admonishe	drs
admonisher	s
admonishi	n
admonishin	g
admonishing	l
admonishingl	y
admonishm	e
admonishme	n
admonishmen	t
admonishment	s
admonit	io
admoniti	o
admonitio	n
admonition	s
admonito	r
admonitor	y
adn	lmv
ado	bflnpqrsvw
adob	e
adobe	lps
adobel	i
adobeli	k
adobelik	e
adobep	h
adobeph	o
adobepho	t
adobephot	o
adobephoto	s
adobephotos	h
adobephotosh	o
adobephotosho	p
adol	ep
adole	s
adoles	c
adolesc	e
adolesce	n
adolescen	ct
adolescenc	e
adolescence	s
adolescent	ls
adolescentl	y
adolp	h
adolph	u
adolphu	s
adon	i
adoni	s
adop	t
adopt	aeis
adopta	b
adoptab	il
adoptabi	l
adoptabil	i
adoptabili	t
adoptabilit	iy
adoptabiliti	e
adoptabilitie	s
adoptabl	e
adopte	der
adopter	s
adopti	nov
adoptin	g
adoptio	n
adoption	s
adoptiv	e
adoptive	l
adoptivel	y
ador	aein
adora	bnt
adorab	il
adorabi	l
adorabil	i
adorabili	t
adorabilit	iy
adorabiliti	e
adorabilitie	s
adorabl	ey
adorable	n
adorablen	e
adorablene	s
adorablenes	s
adorableness	e
adorablenesse	s
adoran	t
adorat	i
adorati	ov
adoratio	n
adorativ	e
adore	drs
adorer	s
adori	n
adorin	g
adoring	l
adoringl	y
adorn	eims
adorne	dr
adorner	s
adorni	n
adornin	g
adorning	l
adorningl	y
adornm	e
adornme	n
adornmen	t
adornment	s
adow	n
adp	v
adr	eijkosw
adre	n
adren	ao
adrena	l
adrenal	i
adrenali	n
adrenalin	e
adreno	c
adrenoc	o
adrenoco	r
adrenocor	t
adrenocort	i
adrenocorti	c
adrenocortic	o
adrenocortico	t
adrenocorticot	r
adrenocorticotr	o
adrenocorticotro	p
adrenocorticotrop	i
adrenocorticotropi	c
adri	aef
adria	nt
adriat	i
adriati	c
adrie	n
adrien	n
adrienn	e
adrif	t
adro	i
adroi	t
adroit	eln
adroite	rs
adroites	t
adroitl	y
adroitn	e
adroitne	s
adroitnes	s
adroitness	e
adroitnesse	s
ads	elmopru
adse	n
adsen	s
adsens	e
adsm	i
adsmi	t
adsmit	h
adso	r
adsor	bp
adsorb	eis
adsorbe	d
adsorbi	n
adsorbin	g
adsorp	t
adsorpt	i
adsorpti	ov
adsorptio	n
adsorptiv	e
adsp	o
adspo	w
adspow	e
adspowe	r
adsu	m
adt	o
adu	abcdilmrsuy
adul	at
adula	t
adulat	eio
adulate	ds
adulati	no
adulatin	g
adulatio	n
adulation	s
adulato	r
adulator	sy
adult	ehlnsv
adulte	r
adulter	aeioy
adultera	nt
adulteran	t
adulterat	ei
adulterate	ds
adulterati	no
adulteratin	g
adulteratio	n
adultere	rs
adulterer	s
adulteres	s
adulteri	e
adulterie	s
adultero	u
adulterou	s
adulterous	l
adulterousl	y
adulth	o
adultho	o
adulthoo	d
adulthood	s
adultl	iy
adultli	k
adultlik	e
adultn	e
adultne	s
adultnes	s
adultness	e
adultnesse	s
adultv	i
adultvi	d
adultvid	e
adultvide	o
adum	b
adumb	r
adumbr	a
adumbra	lt
adumbrat	ei
adumbrate	ds
adumbrati	nov
adumbratin	g
adumbratio	n
adumbrativ	e
adur	o
aduro	l
adus	t
aduu	v
adv	aeimo
adva	n
advan	ct
advanc	ei
advance	dmrs
advanced	lr
advancedl	e
advancedle	v
advancedlev	e
advancedleve	l
advancedr	i
advancedri	s
advancedris	c
advancedrisc	m
advancedriscm	a
advancedriscma	c
advancedriscmac	h
advancedriscmach	i
advancedriscmachi	n
advancedriscmachin	e
advancem	e
advanceme	n
advancemen	t
advancement	s
advancer	s
advanci	n
advancin	g
advancing	l
advancingl	y
advant	a
advanta	g
advantag	ei
advantage	dos
advantageo	u
advantageou	s
advantageous	ln
advantageousl	y
advantageousn	e
advantageousne	s
advantageousnes	s
advantageousness	e
advantageousnesse	s
advantagi	n
advantagin	g
adve	nr
adven	t
advent	isu
adventi	st
adventis	t
adventist	s
adventit	i
adventiti	o
adventitio	u
adventitiou	s
adventu	r
adventur	eio
adventure	dfrs
adventuref	u
adventurefu	l
adventurer	s
adventures	os
adventureso	m
adventuresom	e
adventuri	n
adventurin	g
adventuro	u
adventurou	s
adventurous	ln
adventurousl	y
adventurousn	e
adventurousne	s
adventurousnes	s
adventurousness	e
adventurousnesse	s
adver	bst
adverb	ils
adverbi	a
adverbia	l
adverbl	e
adverble	s
adverbles	s
advers	aei
adversa	rt
adversar	iy
adversari	en
adversarie	s
adversarin	e
adversarine	s
adversarines	s
adversariness	e
adversarinesse	s
adversat	i
adversati	v
adversativ	e
adverse	dlnrs
adversel	y
adversen	e
adversene	s
adversenes	s
adverseness	e
adversenesse	s
adverses	t
adversi	nt
adversin	g
adversit	iy
adversiti	e
adversitie	s
advert	eis
adverte	dn
adverten	t
adverti	nsz
advertin	g
advertis	aei
advertisa	b
advertisab	l
advertisabl	e
advertise	dmrs
advertisem	e
advertiseme	n
advertisemen	t
advertisement	as
advertisementa	l
advertiser	s
advertisi	n
advertisin	g
advertiz	e
advertize	m
advertizem	e
advertizeme	n
advertizemen	t
advertizement	s
advi	cs
advic	e
advice	fs
advicef	u
advicefu	l
advis	aeio
advisa	b
advisab	il
advisabi	l
advisabil	i
advisabili	t
advisabilit	iy
advisabiliti	e
advisabilitie	s
advisabl	ey
advisable	n
advisablen	e
advisablene	s
advisablenes	s
advisableness	e
advisablenesse	s
advise	demrs
advised	l
advisedl	y
advisee	s
advisem	e
adviseme	n
advisemen	t
advisement	s
adviser	s
advisers	h
advisersh	i
advisershi	p
advisership	s
advisi	n
advisin	g
adviso	r
advisor	isy
advisori	el
advisorie	s
advisoril	y
advo	cw
advoc	a
advoca	ct
advocac	iy
advocaci	e
advocacie	s
advocat	eior
advocate	ds
advocates	hs
advocatesh	i
advocateshi	p
advocati	nov
advocatin	g
advocatio	n
advocation	s
advocativ	e
advocato	r
advocator	s
advocatr	i
advocatri	c
advocatric	e
advow	s
advows	o
advowso	n
adw	aej
adwa	r
adwar	e
adx	vx
ady	ntvy
adyn	a
adyna	m
adynam	i
adynami	c
adyt	u
adytu	m
adz	ei
adze	ds
adzi	n
adzin	g
ae	adefghijklmnoprstuvwxz
aea	vz
aed	v
aee	mrv
aef	pqu
aeg	eiu
aege	a
aegea	n
aegi	s
ael	gv
aen	beprsuv
aene	ai
aenea	s
aenei	d
aeo	lnqt
aeol	iu
aeoli	a
aeolia	n
aeolian	s
aeolu	s
aeon	is
aeoni	a
aeonia	l
aep	fv
aer	ailoquvy
aera	t
aerat	eio
aerate	ds
aerati	no
aeratin	g
aeratio	n
aeration	s
aerato	r
aerator	s
aeri	aef
aeria	l
aerial	ilns
aeriali	st
aerialis	t
aerialit	y
aeriall	y
aerialn	e
aerialne	s
aerialnes	s
aerialness	e
aerialnesse	s
aerif	ioy
aerifi	c
aerific	a
aerifica	t
aerificat	i
aerificati	o
aerificatio	n
aerifo	r
aerifor	m
aero	abdeglmnps
aeroa	c
aeroac	o
aeroaco	u
aeroacou	s
aeroacous	t
aeroacoust	i
aeroacousti	c
aerob	aei
aeroba	ct
aerobac	t
aerobact	e
aerobacte	r
aerobat	i
aerobati	c
aerobatic	s
aerobi	co
aerobic	ais
aerobica	l
aerobical	l
aerobicall	y
aerobici	sz
aerobicis	t
aerobiciz	e
aerobicize	d
aerobics	e
aerobicse	s
aerobio	l
aerobiol	o
aerobiolo	g
aerobiolog	y
aerod	ory
aerodo	n
aerodon	e
aerodone	t
aerodonet	i
aerodoneti	c
aerodonetic	s
aerodr	o
aerodro	m
aerodrom	e
aerodrome	s
aerody	n
aerodyn	a
aerodyna	m
aerodynam	i
aerodynami	c
aerodynamic	ais
aerodynamica	l
aerodynamical	l
aerodynamicall	y
aerodynamici	s
aerodynamicis	t
aerodynamics	e
aerodynamicse	s
aeroe	m
aeroem	b
aeroemb	o
aeroembo	l
aeroembol	i
aeroemboli	s
aeroembolis	m
aerog	r
aerogr	a
aerogra	m
aerol	io
aeroli	t
aerolit	e
aerolo	g
aerolog	iy
aerologi	s
aerologis	t
aerom	e
aerome	t
aeromet	e
aeromete	r
aeron	ac
aerona	u
aeronau	t
aeronaut	i
aeronauti	c
aeronautic	as
aeronautica	l
aeronautical	l
aeronauticall	y
aeronautics	e
aeronauticse	s
aeronc	h
aeronch	a
aeroncha	i
aeronchai	r
aerop	ehlo
aerope	x
aeroph	a
aeropha	r
aerophar	e
aeropl	a
aeropla	n
aeroplan	ei
aeroplane	s
aeroplani	s
aeroplanis	t
aeropo	r
aeropor	t
aeros	mopt
aerosm	i
aerosmi	t
aerosmit	h
aeroso	l
aerosol	is
aerosoli	z
aerosoliz	ae
aerosoliza	t
aerosolizat	i
aerosolizati	o
aerosolizatio	n
aerosp	a
aerospa	c
aerospac	e
aerospace	s
aerost	a
aerosta	t
aes	cioqt
aesc	hu
aesch	y
aeschy	l
aeschyl	u
aeschylu	s
aescu	l
aescul	a
aescula	p
aesculap	i
aesculapi	u
aesculapiu	s
aeso	p
aesop	i
aesopi	a
aesopia	n
aest	hi
aesth	e
aesthe	t
aesthet	ei
aesthete	s
aestheti	c
aesthetic	ais
aesthetica	l
aesthetical	l
aestheticall	y
aesthetici	s
aestheticis	mt
aesti	v
aestiv	a
aestiva	lt
aestivat	e
aet	hir
aeth	e
aethe	r
aeti	o
aetio	l
aetiol	o
aetiolo	g
aetiolog	iy
aetiologi	ces
aetiologic	a
aetiologica	l
aetiological	l
aetiologicall	y
aetiologie	s
aetiologis	t
aetiologist	s
aeu	u
aev	o
aew	ruv
aez	rv
af	abcdefgiklmnopqrstuvxy
afa	drv
afar	s
afb	v
afc	b
afd	d
afe	adkvz
afea	r
afear	e
afeare	d
aff	adeilortuv
affa	bi
affab	il
affabi	l
affabil	i
affabili	t
affabilit	iy
affabiliti	e
affabilitie	s
affabl	ey
affable	nrs
affablen	e
affablene	s
affablenes	s
affableness	e
affablenesse	s
affables	t
affai	r
affair	es
affaire	s
affe	cnrt
affec	t
affect	aeis
affecta	bt
affectab	il
affectabi	l
affectabil	i
affectabili	t
affectabilit	iy
affectabiliti	e
affectabilitie	s
affectabl	e
affectat	i
affectati	o
affectatio	n
affectation	s
affecte	dr
affected	ln
affectedl	y
affectedn	e
affectedne	s
affectednes	s
affectedness	e
affectednesse	s
affecter	s
affecti	nov
affectin	g
affecting	l
affectingl	y
affectio	n
affection	als
affectiona	lt
affectionat	e
affectionate	dln
affectionatel	y
affectionaten	e
affectionatene	s
affectionatenes	s
affectionateness	e
affectionatenesse	s
affectionl	e
affectionle	s
affectionles	s
affectiv	e
affen	p
affenp	i
affenpi	n
affenpin	s
affenpins	c
affenpinsc	h
affenpinsch	e
affenpinsche	r
affer	e
affere	n
afferen	t
affet	t
affett	u
affettu	o
affettuo	s
affettuos	o
affi	adlnrx
affia	n
affian	ct
affianc	e
affiance	d
affid	a
affida	v
affidav	i
affidavi	t
affidavit	s
affil	i
affili	a
affilia	bt
affiliab	l
affiliabl	e
affiliat	ei
affiliate	ds
affiliati	nov
affiliatin	g
affiliatio	n
affiliation	s
affiliativ	e
affin	i
affini	t
affinit	iy
affiniti	e
affinitie	s
affir	m
affirm	aeis
affirma	bnt
affirmab	l
affirmabl	ey
affirman	ct
affirmanc	e
affirmance	s
affirmat	io
affirmati	ov
affirmatio	n
affirmation	s
affirmativ	e
affirmative	lns
affirmativel	y
affirmativen	e
affirmativene	s
affirmativenes	s
affirmato	r
affirmator	y
affirme	dr
affirmer	s
affirmi	n
affirmin	g
affirming	l
affirmingl	y
affix	aeim
affixa	blt
affixab	l
affixabl	e
affixat	i
affixati	o
affixatio	n
affixation	s
affixe	drs
affixer	s
affixi	an
affixia	l
affixin	g
affixm	e
affixme	n
affixmen	t
affixment	s
affl	aiu
affla	t
afflat	u
afflatu	s
affli	c
afflic	t
afflict	eis
afflicte	dr
afflicted	n
afflictedn	e
afflictedne	s
afflictednes	s
afflictedness	e
afflictednesse	s
afflicter	s
afflicti	nov
afflictin	g
afflicting	l
afflictingl	y
afflictio	n
affliction	s
afflictiv	e
afflu	ex
afflue	n
affluen	ct
affluenc	e
affluent	ls
affluentl	y
affo	r
affor	de
afford	aeis
afforda	b
affordab	il
affordabi	l
affordabil	i
affordabili	t
affordabilit	iy
affordabiliti	e
affordabilitie	s
affordabl	ey
afforde	dr
affordi	n
affordin	g
affore	s
affores	t
afforest	aeis
afforesta	t
afforestat	i
afforestati	o
afforestatio	n
afforestation	s
afforeste	d
afforesti	n
afforestin	g
affr	aeio
affra	y
affre	i
affrei	g
affreig	h
affreigh	t
affreight	m
affreightm	e
affreightme	n
affreightmen	t
affri	cg
affric	a
affrica	t
affricat	e
affricate	s
affrig	h
affrigh	t
affro	n
affron	t
affront	eis
affronte	dr
affronted	n
affrontedn	e
affrontedne	s
affrontednes	s
affrontedness	e
affrontednesse	s
affronter	s
affronti	n
affrontin	g
affronting	l
affrontingl	y
affu	s
affus	i
affusi	o
affusio	n
afg	h
afgh	a
afgha	n
afghan	is
afghani	s
afghanis	t
afghanist	a
afghanista	n
afi	acer
afic	i
afici	o
aficio	n
aficion	a
aficiona	d
aficionad	o
afie	l
afiel	d
afir	e
afk	av
afl	abouv
afla	m
aflam	e
aflo	a
afloa	t
aflu	t
aflut	t
aflutt	e
aflutte	r
afm	b
afn	cv
afo	eoruv
afoo	t
afor	e
afore	mst
aforem	e
aforeme	n
aforemen	t
aforement	i
aforementi	o
aforementio	n
aforemention	e
aforementione	d
afores	a
aforesa	i
aforesai	d
aforet	h
aforeth	o
aforetho	u
aforethou	g
aforethoug	h
aforethough	t
aforethought	s
afou	l
afr	aeio
afra	i
afrai	d
afraid	n
afraidn	e
afraidne	s
afraidnes	s
afre	es
afree	t
afres	h
afri	ck
afric	a
africa	n
african	ais
africana	m
africanam	e
africaname	r
africanamer	i
africanameri	c
africanameric	a
africanamerica	n
africani	z
africaniz	aei
africaniza	t
africanizat	i
africanizati	o
africanizatio	n
africanization	s
africanize	ds
africanizi	n
africanizin	g
afrik	a
afrika	an
afrikaa	n
afrikaan	s
afrikaans	e
afrikaanse	s
afrikan	e
afrikane	r
afrikaner	s
afro	c
afroc	a
afroca	r
afrocar	i
afrocari	b
afrocarib	b
afrocaribb	e
afrocaribbe	a
afrocaribbea	n
afs	v
aft	e
afte	rs
after	bcdeghilmnpstw
afterb	iu
afterbi	r
afterbir	t
afterbirt	h
afterbirth	s
afterbu	r
afterbur	n
afterburn	e
afterburne	r
afterc	a
afterca	r
aftercar	e
afterd	e
afterde	c
afterdec	k
aftere	f
afteref	f
aftereff	e
aftereffe	c
aftereffec	t
afterg	l
aftergl	o
afterglo	w
afterh	e
afterhe	a
afterhea	t
afteri	m
afterim	a
afterima	g
afterimag	e
afterl	i
afterli	fgv
afterlif	e
afterlife	s
afterlig	h
afterligh	t
afterliv	e
afterlive	s
afterm	ao
afterma	rt
aftermar	k
aftermark	e
aftermarke	t
aftermat	h
aftermath	s
aftermo	s
aftermos	t
aftern	eo
afterne	s
afternes	s
afterno	o
afternoo	n
afternoon	s
afterp	iu
afterpi	e
afterpie	c
afterpiec	e
afterpu	l
afterpul	s
afterpuls	e
afters	h
aftersh	ao
aftersha	v
aftershav	e
aftershave	s
aftersho	ck
aftershoc	k
aftershock	s
aftershok	z
aftershokz	a
aftershokza	e
aftershokzae	r
aftershokzaer	o
aftershokzaero	p
aftershokzaerop	e
aftershokzaerope	x
aftert	ah
afterta	s
aftertas	t
aftertast	e
aftertaste	s
afterth	o
aftertho	u
afterthou	g
afterthoug	h
afterthough	t
afterthought	s
afterw	ao
afterwa	r
afterwar	d
afterward	s
afterwo	r
afterwor	d
aftes	t
afv	adz
afy	gv
ag	acefghijlmnopqruvwxy
aga	imprtvz
agai	n
again	sw
agains	t
againw	a
againwa	r
againwar	d
agam	aeo
agame	m
agamem	n
agamemn	o
agamemno	n
agamo	g
agamog	e
agamoge	n
agamogen	e
agamogene	s
agamogenes	i
agamogenesi	s
agap	e
agar	i
agari	c
agat	ehio
agate	ls
agatel	i
agateli	k
agatelik	e
agath	a
agati	z
agatiz	e
agatize	d
agato	i
agatoi	d
agav	e
agaz	e
agc	a
age	adeilnrs
aged	ns
agedn	e
agedne	s
agednes	s
agedness	e
agednesse	s
agei	ns
agein	g
ageis	mt
ageism	s
ageist	s
agel	eo
agele	s
ageles	s
ageless	ln
agelessl	y
agelessn	e
agelessne	s
agelessnes	s
agelessness	e
agelessnesse	s
agelo	n
agelon	g
agen	cdt
agenc	iy
agenci	e
agencie	s
agend	au
agenda	ls
agendal	e
agendale	s
agendales	s
agendu	m
agent	eis
agente	d
agenti	n
agentin	g
agents	h
agentsh	i
agentshi	p
ager	as
agera	t
agerat	u
ageratu	m
agg	ilrv
aggi	e
aggie	s
aggl	ou
agglo	m
agglom	e
agglome	r
agglomer	a
agglomera	t
agglomerat	ei
agglomerate	ds
agglomerati	no
agglomeratin	g
agglomeratio	n
agglu	t
agglut	i
aggluti	n
agglutin	ai
agglutina	nt
agglutinan	t
agglutinat	ei
agglutinate	ds
agglutinati	nov
agglutinatin	g
agglutinatio	n
agglutinativ	e
agglutini	n
agglutinin	s
aggr	aei
aggra	nv
aggran	d
aggrand	i
aggrandi	z
aggrandiz	e
aggrandize	m
aggrandizem	e
aggrandizeme	n
aggrandizemen	t
aggrav	a
aggrava	t
aggravat	eio
aggravate	ds
aggravati	nov
aggravatin	g
aggravatio	n
aggravativ	e
aggravato	r
aggravator	s
aggre	gs
aggreg	a
aggrega	bt
aggregab	l
aggregabl	e
aggregat	eio
aggregate	dlns
aggregatel	y
aggregaten	e
aggregatene	s
aggregatenes	s
aggregateness	e
aggregatenesse	s
aggregati	nov
aggregatin	g
aggregatio	n
aggregation	s
aggregativ	e
aggregato	r
aggregator	y
aggres	s
aggress	io
aggressi	ov
aggressio	n
aggression	s
aggressiv	ei
aggressive	ln
aggressivel	y
aggressiven	e
aggressivene	s
aggressivenes	s
aggressiveness	e
aggressivenesse	s
aggressivi	t
aggressivit	iy
aggressiviti	e
aggressivitie	s
aggresso	r
aggressor	s
aggri	e
aggrie	v
aggriev	ei
aggrieve	ds
aggrieved	ln
aggrievedl	y
aggrievedn	e
aggrievedne	s
aggrievednes	s
aggrievedness	e
aggrievednesse	s
aggrievi	n
aggrievin	g
agh	a
agha	s
aghas	t
aghast	n
aghastn	e
aghastne	s
aghastnes	s
agi	lnstu
agil	ei
agile	lnrs
agilel	y
agilen	e
agilene	s
agilenes	s
agileness	e
agilenesse	s
agiles	t
agili	t
agilit	y
agin	g
aging	s
agis	mt
agism	s
agit	ap
agita	bt
agitab	l
agitabl	e
agitat	eio
agitate	ds
agitated	l
agitatedl	y
agitati	no
agitatin	g
agitating	l
agitatingl	y
agitatio	n
agitation	s
agitato	r
agitator	is
agitatori	a
agitatoria	l
agitp	r
agitpr	o
agitpro	p
agj	vy
agl	eio
agle	aty
aglea	m
agli	mt
aglim	m
aglimm	e
aglimme	r
aglit	t
aglitt	e
aglitte	r
aglo	w
agm	s
agn	eorv
agne	sw
agnes	b
agno	s
agnos	t
agnost	i
agnosti	c
agnostic	ais
agnostica	l
agnostical	l
agnosticall	y
agnostici	s
agnosticis	m
agnosticism	s
ago	ghnrsuv
agon	aiy
agona	l
agoni	cesz
agonie	s
agonis	eit
agonise	ds
agonisi	n
agonisin	g
agonist	i
agonisti	c
agoniz	ei
agonize	drs
agonized	l
agonizedl	y
agonizer	s
agonizi	n
agonizin	g
agonizing	l
agonizingl	y
agor	ao
agora	p
agorap	h
agoraph	o
agorapho	b
agoraphob	ei
agoraphobe	s
agoraphobi	ac
agoraphobia	s
agoraphobic	s
agoro	t
agou	t
agout	i
agq	fv
agr	aeioy
agra	frv
agraf	f
agraff	e
agrar	i
agrari	a
agraria	n
agrarian	ls
agrarianl	y
agrav	i
agravi	c
agre	e
agree	adimrs
agreea	bn
agreeab	il
agreeabi	l
agreeabil	i
agreeabili	t
agreeabilit	iy
agreeabiliti	e
agreeabilitie	s
agreeabl	ey
agreeable	n
agreeablen	e
agreeablene	s
agreeablenes	s
agreeableness	e
agreeablenesse	s
agreean	c
agreeanc	e
agreei	n
agreein	g
agreeing	l
agreeingl	y
agreem	e
agreeme	n
agreemen	t
agreement	s
agreer	s
agri	bcm
agrib	u
agribu	s
agribus	i
agribusi	n
agribusin	e
agribusine	s
agribusines	s
agribusiness	em
agribusinesse	s
agribusinessm	a
agribusinessma	n
agric	hou
agrich	e
agriche	m
agrichem	i
agrichemi	c
agrichemic	a
agrichemica	l
agrichemical	s
agrico	l
agricol	a
agricu	l
agricul	t
agricult	u
agricultu	r
agricultur	aei
agricultura	l
agricultural	il
agriculturali	s
agriculturalis	t
agriculturalist	s
agriculturall	y
agriculture	rs
agriculturi	s
agriculturis	t
agriculturist	s
agrim	o
agrimo	n
agrimon	y
agro	clnu
agroc	h
agroch	e
agroche	m
agrochem	i
agrochemi	c
agrochemic	a
agrochemica	l
agrochemical	s
agrol	o
agrolo	g
agrolog	y
agron	o
agrono	m
agronom	iy
agronomi	cs
agronomis	t
agrou	n
agroun	d
agu	aei
ague	d
agui	ls
aguil	e
aguile	r
aguiler	a
aguis	h
agw	a
agwa	y
ah	adefgikmnoprux
aha	bdrsv
ahd	dw
ahe	am
ahea	d
ahi	m
ahim	s
ahims	a
ahm	ae
ahma	d
ahmad	a
ahmada	b
ahmadab	a
ahmadaba	d
ahme	d
ahmed	a
ahmeda	b
ahmedab	a
ahmedaba	d
aho	y
ahr	rstv
ahx	v
ai	adegijklmnoqrstvwx
aid	aefilms
aida	bn
aidab	l
aidabl	e
aidan	c
aidanc	e
aide	drs
aided	e
aidede	c
aidedec	a
aidedeca	m
aidedecam	p
aider	s
aidf	u
aidfu	l
aidi	n
aidin	g
aidl	e
aidle	s
aidles	s
aidm	a
aidma	n
aids	s
aie	e
aig	cru
aigr	e
aigre	t
aigu	i
aigui	l
aiguil	l
aiguill	e
aiguille	t
aiguillet	t
aiguillett	e
aik	e
aike	n
ail	aeim
aila	n
ailan	t
ailant	h
ailanth	u
ailanthu	s
aile	er
ailee	n
ailer	o
ailero	n
aileron	s
aili	n
ailin	g
ailm	e
ailme	n
ailmen	t
ailment	s
aim	efils
aime	dr
aimer	s
aimf	u
aimfu	l
aimful	l
aimfull	y
aimi	n
aimin	g
aiml	e
aimle	s
aimles	s
aimless	ln
aimlessl	y
aimlessn	e
aimlessne	s
aimlessnes	s
aimlessness	e
aimlessnesse	s
ain	fgrsuv
ainu	s
aiq	ix
air	bcdefgilmopstwy
airb	aenoru
airba	gs
airbag	s
airbas	e
airbase	s
airbe	d
airbn	b
airbo	r
airbor	n
airborn	e
airbr	u
airbru	s
airbrus	h
airbrush	ei
airbrushe	ds
airbrushi	n
airbrushin	g
airbu	s
airc	r
aircr	ae
aircra	f
aircraf	t
aircraft	s
aircre	w
aircrew	s
aird	r
airdr	o
airdro	mp
airdrom	e
airdrome	s
airdrop	ps
airdropp	aei
airdroppa	b
airdroppab	l
airdroppabl	e
airdroppe	d
airdroppi	n
airdroppin	g
aire	drs
aired	a
aireda	l
airedal	e
airer	s
aires	t
airf	ailor
airfa	r
airfar	e
airfare	s
airfi	e
airfie	l
airfiel	d
airfield	s
airfl	o
airflo	w
airfo	ir
airfoi	l
airfoil	s
airfor	c
airforc	e
airfr	ae
airfra	m
airfram	e
airframe	s
airfre	i
airfrei	g
airfreig	h
airfreigh	t
airg	lr
airgl	o
airglo	w
airgr	a
airgra	p
airgrap	h
airi	efln
airie	rs
airies	t
airif	i
airifi	e
airifie	d
airil	y
airin	eg
airine	s
airines	s
airiness	e
airinesse	s
airing	s
airl	eio
airle	s
airles	s
airless	n
airlessn	e
airlessne	s
airlessnes	s
airlessness	e
airlessnesse	s
airli	fkn
airlif	t
airlift	eis
airlifte	d
airlifti	n
airliftin	g
airlik	e
airlin	e
airline	rs
airliner	s
airlo	c
airloc	k
airlock	s
airm	ae
airma	in
airmai	l
airmail	eis
airmaile	d
airmaili	n
airmailin	g
airme	n
airo	m
airom	e
airome	t
airomet	e
airomete	r
airp	alo
airpa	r
airpar	k
airpl	a
airpla	ny
airplan	e
airplane	s
airpo	dr
airpod	s
airpods	mp
airpodsm	a
airpodsma	x
airpodsp	r
airpodspr	o
airpor	t
airport	s
airs	chiopt
airsc	r
airscr	e
airscre	w
airsh	i
airshi	p
airship	s
airsi	c
airsic	k
airsick	n
airsickn	e
airsickne	s
airsicknes	s
airsickness	e
airsicknesse	s
airso	f
airsof	t
airsp	ae
airspa	c
airspac	e
airspace	s
airspe	e
airspee	d
airst	r
airstr	ei
airstre	a
airstrea	m
airstri	p
airstrip	s
airt	i
airti	gm
airtig	h
airtigh	t
airtight	ln
airtightl	y
airtightn	e
airtightne	s
airtightnes	s
airtightness	e
airtightnesse	s
airtim	e
airtime	s
airw	ao
airwa	vy
airwav	e
airwave	s
airway	s
airwo	mr
airwom	a
airwoma	n
airwor	t
airwort	h
airworth	iy
airworthi	en
airworthie	rs
airworthies	t
airworthin	e
airworthine	s
airworthines	s
airworthiness	e
airworthinesse	s
ais	l
aisl	ei
aisle	dls
aislel	e
aislele	s
aisleles	s
aisli	n
aislin	g
ait	ck
aitc	h
aitk	e
aitke	n
aiw	a
aix	v
aj	abcdegjmnoqruwx
aja	dkrx
ajb	v
ajc	is
aje	d
ajg	n
ajj	v
ajm	b
ajmb	v
ajn	abfhnpqsvwz
ajnf	rsv
ajnz	v
ajo	ru
ajq	abhsu
ajqs	v
ajr	b
ajw	fhkpw
ajwp	v
ajx	b
ak	abeijklmnopruvwxz
aka	v
akb	kl
ake	brv
aker	s
aki	mnv
akim	b
akimb	o
akin	e
akine	t
akinet	i
akineti	c
akj	v
akk	bdv
akl	brsv
akm	rv
ako	nos
akp	bkry
akr	lou
akro	n
akw	v
akx	rv
akz	v
al	abcdefghijklmnopqrstuvwxyz
ala	bcdimnrst
alab	a
alaba	ms
alabam	ai
alabama	n
alabaman	s
alabami	a
alabamia	n
alabas	t
alabast	e
alabaste	r
alac	ar
alaca	r
alacar	t
alacart	e
alacr	i
alacri	t
alacrit	y
alad	d
aladd	i
aladdi	n
alai	n
alam	eo
alame	d
alamed	a
alamo	ds
alamod	ae
alamoda	l
alamodal	i
alamodali	t
alamodalit	y
alar	muy
alarm	aeis
alarma	b
alarmab	l
alarmabl	e
alarme	d
alarmed	l
alarmedl	y
alarmi	ns
alarmin	g
alarming	l
alarmingl	y
alarmis	mt
alarmist	s
alaru	m
alarum	eis
alarume	d
alarumi	n
alarumin	g
alas	ekt
alase	s
alask	a
alaska	n
alast	a
alasta	i
alastai	r
alat	e
alate	c
alatec	h
alb	aefiru
alba	cnt
albac	o
albaco	r
albacor	e
alban	iy
albani	a
albania	n
albanian	s
albat	r
albatr	o
albatro	s
albatros	s
albatross	e
albatrosse	s
albe	dirs
albed	o
albei	t
alber	it
alberi	c
alberic	h
albert	ao
albes	c
albesc	e
albesce	n
albescen	t
albf	v
albi	no
albin	aeio
albina	l
albine	s
albines	s
albini	cs
albinis	mt
albinist	i
albinisti	c
albino	is
albinoi	d
albio	n
albr	ei
albre	c
albrec	h
albrech	t
albri	g
albrig	h
albrigh	t
albu	mq
album	eis
albume	n
albumen	s
albumi	n
albumin	ou
albumino	i
albuminoi	d
albuminu	r
albuminur	i
albuminuri	a
albuq	u
albuqu	e
albuque	r
albuquer	q
albuquerq	u
albuquerqu	e
alc	aehimo
alca	ltz
alcal	d
alcald	e
alcat	e
alcate	l
alcaz	a
alcaza	r
alce	s
alces	t
alcest	i
alcesti	s
alch	e
alche	m
alchem	iy
alchemi	ces
alchemic	a
alchemica	l
alchemical	l
alchemicall	y
alchemie	s
alchemis	t
alchemist	ers
alchemiste	r
alchemistr	y
alci	b
alcib	i
alcibi	a
alcibia	d
alcibiad	e
alcibiade	s
alcm	e
alcme	n
alcmen	a
alco	ahtv
alcoh	o
alcoho	l
alcohol	aimos
alcohola	t
alcoholat	e
alcoholi	csz
alcoholic	as
alcoholica	l
alcoholical	l
alcoholicall	y
alcoholis	emt
alcoholism	s
alcoholiz	e
alcoholm	e
alcoholme	t
alcoholmet	e
alcoholmete	r
alcoholo	m
alcoholom	e
alcoholome	t
alcoholomet	e
alcoholomete	r
alcot	t
alcov	e
alcove	ds
ald	ehijor
alde	bhnr
aldeb	a
aldeba	r
aldebar	a
aldebara	n
aldeh	y
aldehy	d
aldehyd	e
alder	m
alderm	ae
alderma	n
alderman	cils
aldermanc	iy
aldermanci	e
aldermancie	s
aldermani	ct
aldermanit	y
aldermanl	iy
aldermanli	k
aldermanlik	e
aldermans	h
aldermansh	i
aldermanshi	p
aldermanship	s
alderme	n
aldi	n
aldin	e
aldo	s
aldos	t
aldost	e
aldoste	r
aldoster	o
aldostero	n
aldosteron	e
aldr	i
aldri	c
aldric	h
ale	acegmopqrsuvwx
alea	t
aleat	o
aleato	r
aleator	y
alec	ko
aleco	n
alecon	n
aleconn	e
aleconne	r
aleg	a
alega	r
alem	b
alemb	i
alembi	c
alep	h
aler	t
alert	eilnos
alerte	drs
alerted	l
alertedl	y
alerter	s
alertes	t
alerti	n
alertin	g
alertl	y
alertn	e
alertne	s
alertnes	s
alertness	e
alertnesse	s
alerto	r
aleu	t
aleut	i
aleuti	a
aleutia	n
alev	e
aleve	l
alevel	s
alew	i
alewi	f
alewif	e
alex	aei
alexa	n
alexan	d
alexand	er
alexande	r
alexandr	aei
alexandri	an
alexandrin	e
alexe	i
alexi	as
alf	aor
alfa	l
alfal	f
alfalf	a
alfalfa	s
alfo	n
alfon	s
alfons	o
alfr	e
alfre	ds
alfred	o
alfres	c
alfresc	o
alg	aeio
alga	el
algae	c
algaec	i
algaeci	d
algaecid	e
alge	bnr
algeb	r
algebr	ai
algebra	is
algebrai	csz
algebraic	a
algebraica	l
algebraical	l
algebraicall	y
algebrais	t
algebraist	s
algebraiz	e
algebri	c
algebric	i
algebrici	a
algebricia	n
algen	i
algeni	b
alger	i
algeri	a
algeria	n
algi	den
algie	r
algier	s
algin	a
algina	t
alginat	e
algo	lnpr
algol	o
algolo	g
algolog	y
algon	q
algonq	u
algonqu	i
algonqui	an
algonquia	n
algop	h
algoph	o
algopho	b
algophob	i
algophobi	a
algor	i
algori	t
algorit	h
algorith	m
algorithm	is
algorithmi	c
algorithmic	a
algorithmica	l
algorithmical	l
algorithmicall	y
alh	aopz
alha	m
alham	b
alhamb	r
alhambr	a
ali	abcegkmnpqstvwyz
alia	s
alias	ei
aliase	ds
aliasi	n
aliasin	g
alib	air
aliba	b
alibab	a
alibaba	g
alibabag	r
alibabagr	o
alibabagro	u
alibabagrou	p
alibi	eis
alibie	ds
alibii	n
alibiin	g
alibr	i
alibri	s
alic	aei
alica	n
alican	t
alicant	e
alici	a
alie	n
alien	aeilnosw
aliena	bt
alienab	il
alienabi	l
alienabil	i
alienabili	t
alienabilit	y
alienabl	e
alienat	eio
alienate	ds
alienati	no
alienatin	g
alienatio	n
alienato	r
alienator	s
aliene	der
alieni	ns
alienin	g
alienis	t
alienl	y
alienn	e
alienne	s
aliennes	s
alienness	e
aliennesse	s
alieno	r
alienw	a
alienwa	r
alienwar	e
alig	hn
aligh	t
alight	eims
alighte	d
alighti	n
alightin	g
alightm	e
alightme	n
alightmen	t
alightment	s
align	eims
aligne	dr
aligner	s
aligni	n
alignin	g
alignm	e
alignme	n
alignmen	t
alignment	s
alik	e
alike	n
aliken	e
alikene	s
alikenes	s
alikeness	e
alikenesse	s
alim	eo
alime	n
alimen	t
aliment	as
alimenta	rt
alimentar	y
alimentat	i
alimentati	o
alimentatio	n
alimo	n
alimon	iy
alimoni	e
alimonie	ds
alin	ei
aline	dms
alinem	e
alineme	n
alinemen	t
alinement	s
alini	n
alinin	g
alip	aeh
alipa	y
alipe	d
aliph	a
alipha	t
aliphat	i
aliphati	c
aliq	u
aliqu	ao
aliqua	n
aliquan	t
aliquo	t
alis	ot
aliso	n
alist	a
alista	i
alistai	r
alit	ao
aliv	e
alive	n
aliven	e
alivene	s
alivenes	s
aliveness	e
alivenesse	s
aliw	o
aliwo	r
aliwor	k
aliwork	b
aliworkb	e
aliworkbe	n
aliworkben	c
aliworkbenc	h
aliy	u
aliyu	n
aliz	a
aliza	r
alizar	i
alizari	n
alk	aersvy
alka	ln
alkal	io
alkali	efnosz
alkalie	s
alkalif	y
alkalin	ei
alkalini	t
alkalinit	y
alkalio	u
alkaliou	s
alkaliz	ae
alkaliza	t
alkalizat	i
alkalizati	o
alkalizatio	n
alkalize	r
alkalo	i
alkaloi	d
alkaloid	as
alkaloida	l
alkan	e
alkane	s
alke	n
alken	e
alkene	s
alky	dl
all	aehinosuy
alla	hnry
allah	s
allar	g
allarg	a
allarga	n
allargan	d
allargand	o
allay	eims
allaye	dr
allayer	s
allayi	n
allayin	g
allaym	e
allayme	n
allaymen	t
alle	glmnrsvy
alleg	aehior
allega	t
allegat	i
allegati	o
allegatio	n
allegation	s
allege	admrs
allegea	bn
allegeab	l
allegeabl	e
allegean	c
allegeanc	e
alleged	l
allegedl	y
allegem	e
allegeme	n
allegemen	t
alleger	s
allegh	e
alleghe	n
alleghen	iy
allegheni	e
alleghenie	s
allegi	an
allegia	n
allegian	c
allegianc	ey
allegiance	s
allegin	g
allego	r
allegor	iy
allegori	ces
allegoric	a
allegorica	l
allegorical	l
allegoricall	y
allegorie	s
allegoris	t
allegr	aeo
allegre	t
allegret	t
allegrett	o
allegretto	s
allegro	s
allel	ei
allele	s
alleli	cs
allelis	m
allelism	s
allem	a
allema	n
alleman	d
allemand	e
allen	dt
allend	ae
allenda	l
allendal	e
allent	o
allento	w
allentow	n
aller	g
allerg	eiy
allerge	n
allergen	is
allergeni	c
allergenic	ai
allergenica	l
allergenical	l
allergenicall	y
allergenici	t
allergenicit	iy
allergeniciti	e
allergenicitie	s
allergi	ces
allergie	s
allergis	t
alles	t
allev	i
allevi	a
allevia	t
alleviat	eio
alleviate	ds
alleviati	nov
alleviatin	g
alleviatio	n
alleviation	s
alleviativ	e
alleviato	r
alleviator	s
alley	esw
alleye	d
alleyw	a
alleywa	y
alleyway	s
allh	a
allha	l
allhal	l
allhall	o
allhallo	w
allhallow	s
alli	aegnst
allia	bn
alliab	l
alliabl	e
allian	c
allianc	e
alliance	s
allie	ds
allig	a
alliga	t
alligat	o
alligato	r
alligator	eis
alligatore	d
alligatori	n
alligatorin	g
allis	o
alliso	n
allit	e
allite	r
alliter	a
allitera	lt
alliterat	ei
alliterati	ov
alliteratio	n
alliteration	as
alliterationa	l
alliterativ	e
alln	e
allne	s
allnes	s
allo	cgnptvwy
alloc	au
alloca	t
allocat	aeio
allocata	b
allocatab	l
allocatabl	e
allocate	ds
allocati	no
allocatin	g
allocatio	n
allocation	s
allocato	r
allocator	s
allocu	t
allocut	i
allocuti	o
allocutio	n
allog	r
allogr	a
allogra	p
allograp	h
allon	y
allony	m
allop	ah
allopa	t
allopat	h
allopath	y
alloph	o
allopho	n
allophon	ei
allophone	s
allophoni	c
allot	mrst
allotm	e
allotme	n
allotmen	t
allotment	s
allotr	o
allotro	p
allotrop	eiy
allotropi	c
allott	aei
allotta	b
allottab	l
allottabl	e
allotte	der
allotter	sy
allotti	n
allottin	g
allov	e
allove	r
allow	aeis
allowa	bn
allowab	l
allowabl	ey
allowable	ns
allowablen	e
allowablene	s
allowablenes	s
allowableness	e
allowablenesse	s
allowan	c
allowanc	ei
allowance	ds
allowanci	n
allowancin	g
allowe	dr
allowi	n
allowin	g
alloy	eis
alloye	d
alloyi	n
alloyin	g
alls	ept
allse	e
allsee	d
allsp	i
allspi	c
allspic	e
allspice	s
allst	a
allsta	t
allstat	e
allu	drsv
allud	ei
allude	ds
alludi	n
alludin	g
allur	aei
allura	n
alluran	c
alluranc	e
allure	dmrs
allurem	e
allureme	n
alluremen	t
allurement	s
allurer	s
alluri	n
allurin	g
alluring	ln
alluringl	y
alluringn	e
alluringne	s
alluringnes	s
alluringness	e
alluringnesse	s
allus	i
allusi	ov
allusio	n
allusion	s
allusiv	e
allusive	n
allusiven	e
allusivene	s
allusivenes	s
alluv	i
alluvi	aou
alluvia	lnt
alluvial	s
alluviat	ei
alluviati	o
alluviatio	n
alluvio	u
alluviou	s
alluviu	m
alluvium	s
ally	in
allyi	n
allyin	g
alm	aios
alma	dln
almad	e
almade	n
almal	i
almali	n
almalin	u
almalinu	x
alman	a
almana	c
almanac	s
almi	gr
almig	h
almigh	t
almight	iy
almighti	elns
almightie	s
almightil	y
almightin	e
almightine	s
almightines	s
almightiness	e
almightinesse	s
almightis	h
almightish	i
almightishi	p
almir	a
almira	h
almo	ns
almon	der
almond	lsy
almondl	i
almondli	k
almondlik	e
almone	r
almonr	y
almos	t
alms	hm
almsh	o
almsho	u
almshou	s
almshous	e
almsm	a
almsma	n
aln	finorsv
alni	c
alnic	o
alno	v
alo	efhknoprsuvz
aloe	s
alof	t
aloh	a
alok	v
alon	eg
alone	n
alonen	e
alonene	s
alonenes	s
aloneness	e
alonenesse	s
along	s
alongs	hi
alongsh	o
alongsho	r
alongshor	e
alongsi	d
alongsid	e
aloo	f
aloof	ln
aloofl	y
aloofn	e
aloofne	s
aloofnes	s
aloofness	e
aloofnesse	s
alop	e
alope	c
alopec	i
alopeci	a
alou	d
alp	aehiqrsv
alpa	c
alpac	a
alpaca	s
alpe	nr
alpen	hs
alpenh	o
alpenho	r
alpenhor	n
alpens	t
alpenst	o
alpensto	c
alpenstoc	k
alper	t
alph	aeos
alpha	bfgmns
alphab	e
alphabe	t
alphabet	ais
alphabeta	r
alphabetar	i
alphabetari	a
alphabetaria	n
alphabeti	cfz
alphabetic	as
alphabetica	l
alphabetical	l
alphabeticall	y
alphabetif	o
alphabetifo	r
alphabetifor	m
alphabetiz	ei
alphabetize	ds
alphabetizi	n
alphabetizin	g
alphaf	o
alphafo	l
alphafol	d
alphag	o
alpham	e
alphame	r
alphamer	i
alphameri	c
alphameric	a
alphamerica	l
alphamerical	l
alphamericall	y
alphan	u
alphanu	m
alphanum	e
alphanume	r
alphanumer	i
alphanumeri	c
alphanumeric	as
alphanumerica	l
alphanumerical	l
alphanumericall	y
alphe	ru
alpher	a
alphera	t
alpherat	z
alpheu	s
alpho	n
alphon	s
alphons	e
alphs	c
alphsc	o
alphsco	p
alphscop	e
alpi	n
alpin	ei
alpine	ls
alpinel	y
alpini	s
alpinis	t
alpr	a
alpra	z
alpraz	o
alprazo	l
alprazol	a
alprazola	m
alq	v
alr	befiu
alre	a
alrea	d
alread	y
alri	g
alrig	h
alrigh	t
als	ao
alsa	ct
alsac	e
alsat	i
alsati	a
alsatia	n
alsatian	s
also	p
alt	aehimor
alta	irv
altai	r
altar	ailsw
altara	g
altarag	e
altari	s
altaris	t
altarl	e
altarle	s
altarles	s
altarw	i
altarwi	s
altarwis	e
altav	i
altavi	s
altavis	t
altavist	a
alte	kr
alter	aceins
altera	bnt
alterab	il
alterabi	l
alterabil	i
alterabili	t
alterabilit	iy
alterabiliti	e
alterabilitie	s
alterabl	ey
alteran	t
alterat	ei
alterati	ov
alteratio	n
alteration	s
alterativ	e
alterc	a
alterca	t
altercat	i
altercati	o
altercatio	n
altercation	s
altere	dr
alterer	s
alteri	n
alterin	g
altern	a
alterna	t
alternat	eio
alternate	dhlns
alternateh	i
alternatehi	s
alternatehis	t
alternatehist	o
alternatehisto	r
alternatehistor	y
alternatel	y
alternaten	e
alternatene	s
alternatenes	s
alternateness	e
alternatenesse	s
alternati	nov
alternatin	g
alternatio	n
alternation	s
alternativ	ei
alternative	lns
alternativel	y
alternativen	e
alternativene	s
alternativenes	s
alternativeness	e
alternativenesse	s
alternativi	t
alternativit	iy
alternativiti	e
alternativitie	s
alternato	r
alternator	s
alth	aeo
altha	e
althae	a
althe	a
altho	ru
althor	n
althou	g
althoug	h
alti	mt
altim	e
altime	t
altimet	er
altimete	r
altimeter	s
altimetr	i
altimetri	e
altimetrie	s
altit	u
altitu	d
altitud	ei
altitude	s
altitudi	n
altitudin	ao
altitudina	l
altitudino	u
altitudinou	s
altm	a
altma	n
alto	gns
altog	e
altoge	t
altoget	h
altogeth	e
altogethe	r
altogether	ns
altogethern	e
altogetherne	s
altogethernes	s
altos	t
altost	r
altostr	a
altostra	t
altostrat	iu
altostratu	s
altr	u
altru	i
altrui	s
altruis	mt
altruism	s
altruist	is
altruisti	c
altruistic	a
altruistica	l
altruistical	l
altruisticall	y
alu	lmn
alum	inr
alumi	n
alumin	aiu
alumini	uz
aluminiu	m
aluminium	s
aluminiz	e
aluminu	m
aluminum	a
aluminuma	l
alumn	aiu
alumna	e
alumnu	s
alumnus	e
alumnuse	s
alumr	o
alumro	o
alumroo	t
alun	d
alund	u
alundu	m
alv	aei
alva	r
alvar	e
alvare	z
alve	o
alveo	l
alveol	aiu
alveola	rt
alveolat	e
alveolu	s
alvi	n
alw	asw
alwa	y
alway	s
aly	s
alys	s
alyss	a
alz	hp
alzh	e
alzhe	i
alzhei	m
alzheim	e
alzheime	r
am	abcdefghijklmnopqrstuwxy
ama	dhilnrstuz
amad	ae
amada	v
amadav	a
amadava	t
amade	u
amadeu	s
amai	n
amal	g
amalg	a
amalga	m
amalgam	as
amalgama	t
amalgamat	eio
amalgamate	drs
amalgamati	nov
amalgamatin	g
amalgamatio	n
amalgamativ	e
amalgamato	r
amalgamator	s
aman	diu
amand	a
amani	t
amanit	a
amanu	e
amanue	n
amanuen	s
amanuens	i
amanuensi	s
amar	aeiy
amara	n
amaran	t
amarant	h
amaranth	i
amaranthi	n
amaranthin	e
amare	lt
amarel	l
amarell	e
amaret	t
amarett	o
amari	l
amaril	l
amarill	o
amary	l
amaryl	l
amaryll	i
amarylli	s
amas	s
amass	aeim
amassa	b
amassab	l
amassabl	e
amasse	drs
amasser	s
amassi	n
amassin	g
amassm	e
amassme	n
amassmen	t
amassment	s
amat	eiou
amate	u
amateu	r
amateur	is
amateuri	s
amateuris	hm
amateurish	ln
amateurishl	y
amateurishn	e
amateurishne	s
amateurishnes	s
amateurishness	e
amateurishnesse	s
amateurism	s
amateurs	h
amateursh	i
amateurshi	p
amati	v
amativ	e
amato	r
amator	y
amatu	er
amatue	r
amatur	e
amau	r
amaur	o
amauro	s
amauros	i
amaurosi	s
amaz	eio
amaze	dfmrs
amazed	ln
amazedl	y
amazedn	e
amazedne	s
amazednes	s
amazedness	e
amazednesse	s
amazef	u
amazefu	l
amazem	e
amazeme	n
amazemen	t
amazement	s
amazer	s
amazi	n
amazin	g
amazing	ln
amazingl	y
amazingn	e
amazingne	s
amazingnes	s
amazo	n
amazon	sw
amazonw	e
amazonwe	b
amazonweb	s
amazonwebs	e
amazonwebse	r
amazonwebser	v
amazonwebserv	i
amazonwebservi	c
amazonwebservic	e
amazonwebservice	s
amb	aeilru
amba	s
ambas	s
ambass	a
ambassa	d
ambassad	or
ambassado	r
ambassador	is
ambassadori	a
ambassadoria	l
ambassadorial	l
ambassadoriall	y
ambassadors	h
ambassadorsh	i
ambassadorshi	p
ambassadorship	s
ambassadr	e
ambassadre	s
ambassadres	s
ambe	r
amber	glosy
amberg	r
ambergr	i
ambergri	s
amberl	i
amberli	k
amberlik	e
ambero	u
amberou	s
ambi	adegptv
ambia	n
ambian	c
ambianc	e
ambiance	s
ambid	e
ambide	x
ambidex	t
ambidext	er
ambidexte	r
ambidexter	i
ambidexteri	t
ambidexterit	y
ambidextr	o
ambidextro	u
ambidextrou	s
ambidextrous	ln
ambidextrousl	y
ambidextrousn	e
ambidextrousne	s
ambidextrousnes	s
ambidextrousness	e
ambidextrousnesse	s
ambie	n
ambien	ct
ambienc	e
ambience	s
ambient	s
ambig	u
ambigu	io
ambigui	t
ambiguit	iy
ambiguiti	e
ambiguitie	s
ambiguo	u
ambiguou	s
ambiguous	ln
ambiguousl	y
ambiguousn	e
ambiguousne	s
ambiguousnes	s
ambiguousness	e
ambiguousnesse	s
ambip	o
ambipo	l
ambipol	a
ambipola	r
ambit	i
ambiti	o
ambitio	nu
ambition	eils
ambitione	d
ambitioni	ns
ambitionin	g
ambitionis	t
ambitionl	e
ambitionle	s
ambitionles	s
ambitionless	l
ambitionlessl	y
ambitiou	s
ambitious	ln
ambitiousl	y
ambitiousn	e
ambitiousne	s
ambitiousnes	s
ambitiousness	e
ambitiousnesse	s
ambiv	ae
ambiva	l
ambival	e
ambivale	n
ambivalen	ct
ambivalenc	e
ambivalent	l
ambivalentl	y
ambive	r
ambiver	t
ambl	ei
amble	drs
ambler	s
ambli	n
amblin	g
ambling	l
amblingl	y
ambr	o
ambro	s
ambros	i
ambrosi	a
ambrosia	l
ambu	ls
ambul	a
ambula	nt
ambulan	ct
ambulanc	e
ambulance	s
ambulat	eio
ambulati	o
ambulatio	n
ambulato	r
ambulator	y
ambus	ch
ambusc	a
ambusca	d
ambuscad	e
ambush	eilm
ambushe	drs
ambusher	s
ambushi	n
ambushin	g
ambushl	i
ambushli	k
ambushlik	e
ambushm	e
ambushme	n
ambushmen	t
ambushment	s
amc	s
amcs	v
amd	agrv
amda	h
amdah	l
amdg	p
amdgp	u
ame	belnrstx
ameb	a
ameba	els
amebal	i
amebali	k
amebalik	e
amee	r
ameer	s
amel	i
ameli	ao
amelio	r
amelior	a
ameliora	bnt
ameliorab	l
ameliorabl	e
ameliorable	n
ameliorablen	e
ameliorablene	s
ameliorablenes	s
ameliorableness	e
ameliorablenesse	s
amelioran	t
ameliorant	s
ameliorat	eio
ameliorate	ds
ameliorati	nov
amelioratin	g
amelioratio	n
amelioration	s
ameliorativ	e
ameliorato	r
ameliorator	s
amen	adeiost
amena	b
amenab	il
amenabi	l
amenabil	i
amenabili	t
amenabilit	iy
amenabiliti	e
amenabilitie	s
amenabl	ey
amenable	n
amenablen	e
amenablene	s
amenablenes	s
amenableness	e
amenablenesse	s
amend	aeims
amenda	bt
amendab	l
amendabl	e
amendat	o
amendato	r
amendator	y
amende	dr
amender	s
amendi	n
amendin	g
amendm	e
amendme	n
amendmen	t
amendment	s
amends	e
amendse	s
amene	rs
amenes	t
ameni	t
amenit	iy
ameniti	e
amenitie	s
ameno	r
amenor	r
amenorr	h
amenorrh	e
amenorrhe	a
ament	i
amenti	a
amer	aci
amera	ds
amerad	a
ameras	i
amerasi	a
amerasia	n
amerasian	s
amerc	e
ameri	c
americ	ai
america	ns
american	afilns
americanf	o
americanfo	o
americanfoo	t
americanfoot	b
americanfootb	a
americanfootba	l
americanfootbal	l
americani	sz
americanis	aeim
americanisa	t
americanisat	i
americanisati	o
americanisatio	n
americanise	ds
americanisi	n
americanisin	g
americanism	s
americaniz	aei
americaniza	t
americanizat	i
americanizati	o
americanizatio	n
americanization	s
americanize	drs
americanizer	s
americanizi	n
americanizin	g
americanl	y
americann	e
americanne	s
americannes	s
americanness	e
americannesse	s
americi	u
americiu	m
amet	ah
ameta	b
ametab	o
ametabo	l
ametabol	i
ametaboli	s
ametabolis	m
ameth	y
amethy	s
amethys	t
amethyst	ls
amethystl	i
amethystli	k
amethystlik	e
amf	v
amh	ae
amha	r
amhar	i
amhari	c
amhe	r
amher	s
amhers	t
ami	acdgnrstz
amia	b
amiab	il
amiabi	l
amiabil	i
amiabili	t
amiabilit	iy
amiabiliti	e
amiabilitie	s
amiabl	ey
amiable	nrs
amiablen	e
amiablene	s
amiablenes	s
amiableness	e
amiablenesse	s
amiables	t
amic	ae
amica	b
amicab	il
amicabi	l
amicabil	i
amicabili	t
amicabilit	iy
amicabiliti	e
amicabilitie	s
amicabl	ey
amicable	n
amicablen	e
amicablene	s
amicablenes	s
amicableness	e
amicablenesse	s
amid	eos
amido	l
amids	ht
amidsh	i
amidshi	p
amidship	s
amig	ao
amin	eo
amir	as
amira	t
amirat	e
amis	s
amit	ay
amita	b
amitab	h
amitabh	a
amj	sv
amm	aeouv
amma	n
amme	rt
ammer	m
ammerm	a
ammerma	n
ammet	e
ammete	r
ammeter	s
ammo	n
ammon	i
ammoni	atu
ammonia	cst
ammoniat	e
ammoniate	d
ammonit	eio
ammonite	s
ammoniti	cfs
ammonitif	e
ammonitife	r
ammonitifer	o
ammonitifero	u
ammonitiferou	s
ammonitis	h
ammonito	i
ammonitoi	d
ammoniu	m
ammonium	s
ammu	n
ammun	i
ammuni	t
ammunit	i
ammuniti	o
ammunitio	n
ammunition	s
amn	eiov
amne	s
amnes	it
amnesi	ac
amnesia	cs
amnesiac	s
amnesic	s
amnest	iy
amnesti	e
amnestie	ds
amnesty	i
amnestyi	n
amnestyin	g
amni	o
amnio	ct
amnioc	e
amnioce	n
amniocen	t
amniocent	e
amniocente	s
amniocentes	ei
amniocentese	s
amniocentesi	s
amniot	ei
amnioti	c
amo	ceiknrsuy
amoc	o
amoe	b
amoeb	aeio
amoeba	es
amoebe	a
amoebea	n
amoebi	cf
amoebic	i
amoebici	d
amoebicid	e
amoebif	o
amoebifo	r
amoebifor	m
amoebo	i
amoeboi	d
amok	s
amon	gt
among	s
amongs	t
amont	i
amonti	l
amontil	l
amontill	a
amontilla	d
amontillad	o
amor	aiopt
amora	l
amoral	il
amorali	st
amoralis	mt
amoralism	s
amoralit	iy
amoraliti	e
amoralitie	s
amorall	y
amori	s
amoris	t
amoro	su
amoros	i
amorosi	t
amorosit	iy
amorositi	e
amorositie	s
amorou	s
amorous	ln
amorousl	y
amorousn	e
amorousne	s
amorousnes	s
amorousness	e
amorousnesse	s
amorp	h
amorph	o
amorpho	u
amorphou	s
amorphous	ln
amorphousl	y
amorphousn	e
amorphousne	s
amorphousnes	s
amorphousness	e
amorphousnesse	s
amort	i
amorti	z
amortiz	aei
amortiza	t
amortizat	i
amortizati	o
amortizatio	n
amortize	ds
amortizi	n
amortizin	g
amou	nr
amoun	t
amount	eis
amounte	dr
amounter	s
amounti	n
amountin	g
amp	ehilosu
ampe	lrx
ampel	o
ampelo	p
ampelop	s
ampelops	i
ampelopsi	s
amper	aeis
ampera	g
amperag	e
ampere	s
amperi	t
amperit	e
ampers	a
ampersa	n
ampersan	d
ampersand	s
amph	eio
amphe	t
amphet	a
ampheta	m
amphetam	i
amphetami	n
amphetamin	e
amphetamine	s
amphi	bt
amphib	io
amphibi	ao
amphibia	n
amphibian	s
amphibio	u
amphibiou	s
amphibious	lnt
amphibiousl	y
amphibiousn	e
amphibiousne	s
amphibiousnes	s
amphibiousness	e
amphibiousnesse	s
amphibioust	r
amphibioustr	o
amphibioustro	o
amphibioustroo	p
amphibioustroop	s
amphibo	l
amphibol	eo
amphibolo	g
amphibolog	y
amphit	hr
amphith	e
amphithe	a
amphithea	t
amphitheat	er
amphitheate	r
amphitheater	s
amphitheatr	e
amphitheatre	s
amphitr	y
amphitry	o
amphitryo	n
ampho	rt
amphor	a
amphot	e
amphote	r
amphoter	i
amphoteri	c
ampi	n
ampin	g
ampl	eiy
ample	nrs
amplen	e
amplene	s
amplenes	s
ampleness	e
amplenesse	s
amples	t
ampli	dft
amplid	y
amplidy	n
amplidyn	e
amplif	iy
amplifi	ace
amplifia	b
amplifiab	l
amplifiabl	e
amplific	a
amplifica	t
amplificat	i
amplificati	o
amplificatio	n
amplifie	drs
amplifier	s
amplify	i
amplifyi	n
amplifyin	g
amplit	u
amplitu	d
amplitud	ei
amplitude	s
amplitudi	n
amplitudin	o
amplitudino	u
amplitudinou	s
ampo	u
ampou	l
ampoul	e
ampoule	s
ampu	lt
ampul	els
ampule	s
ampull	a
amput	ae
amputa	t
amputat	eio
amputate	ds
amputati	nov
amputatin	g
amputatio	n
amputation	s
amputativ	e
amputato	r
amputator	s
ampute	e
amputee	s
amr	jv
ams	t
amst	e
amste	r
amster	d
amsterd	a
amsterda	m
amt	r
amtr	a
amtra	ck
amu	cls
amuc	k
amuck	s
amul	e
amule	t
amulet	is
amuleti	c
amus	aei
amusa	b
amusab	l
amusabl	e
amuse	demrs
amused	l
amusedl	y
amusem	e
amuseme	n
amusemen	t
amusement	s
amuser	s
amusi	nv
amusin	g
amusing	ln
amusingl	y
amusingn	e
amusingne	s
amusingnes	s
amusingness	e
amusingnesse	s
amusiv	e
amw	j
amy	lt
amyl	a
amyla	cs
amylac	e
amylace	o
amylaceo	u
amylaceou	s
amylas	e
amylase	s
amyt	e
amyte	l
amytel	e
amytele	c
amytelec	o
amyteleco	m
an	abcdefghijklmnopqrstuvwxyz
ana	bcdeghlnprstv
anab	aeo
anaba	p
anabap	t
anabapt	i
anabapti	s
anabaptis	t
anabaptist	s
anabe	l
anabo	l
anabol	i
anaboli	cs
anabolis	m
anac	hor
anach	r
anachr	o
anachro	n
anachron	io
anachroni	cs
anachronic	a
anachronica	l
anachronical	l
anachronicall	y
anachronis	mt
anachronism	s
anachronist	i
anachronisti	c
anachronistic	a
anachronistica	l
anachronistical	l
anachronisticall	y
anachrono	u
anachronou	s
anachronous	l
anachronousl	y
anaco	ln
anacol	u
anacolu	t
anacolut	h
anacoluth	o
anacolutho	n
anacon	d
anacond	a
anaconda	s
anacr	e
anacre	o
anacreo	n
anad	e
anade	m
anae	mrs
anaem	i
anaemi	ac
anaemia	s
anaer	o
anaero	b
anaerob	ei
anaerobi	c
anaerobic	a
anaerobica	l
anaerobical	l
anaerobicall	y
anaes	t
anaest	h
anaesth	e
anaesthe	st
anaesthes	i
anaesthesi	aos
anaesthesia	s
anaesthesio	l
anaesthesiol	o
anaesthesiolo	g
anaesthesiolog	iy
anaesthesiologi	s
anaesthesiologis	t
anaesthet	i
anaestheti	csz
anaesthetic	as
anaesthetica	l
anaesthetical	l
anaestheticall	y
anaesthetis	eit
anaesthetise	ds
anaesthetisi	n
anaesthetisin	g
anaesthetist	s
anaesthetiz	aei
anaesthetiza	t
anaesthetizat	i
anaesthetizati	o
anaesthetizatio	n
anaesthetization	s
anaesthetize	ds
anaesthetizi	n
anaesthetizin	g
anag	r
anagr	a
anagra	m
anagram	ms
anagramm	aei
anagramma	t
anagrammat	i
anagrammati	csz
anagrammatic	a
anagrammatica	l
anagrammatical	l
anagrammaticall	y
anagrammatis	mt
anagrammatiz	e
anagramme	d
anagrammi	n
anagrammin	g
anah	e
anahe	i
anahei	m
anal	egloy
anale	cp
analec	t
analect	s
analep	t
analept	i
analepti	c
analg	e
analge	s
analges	i
analgesi	ac
analgesia	s
analgesic	s
anall	y
analo	g
analog	iosuy
analogi	cez
analogic	a
analogica	l
analogie	s
analogiz	e
analogo	u
analogou	s
analogous	ln
analogousl	y
analogousn	e
analogousne	s
analogousnes	s
analogousness	e
analogousnesse	s
analogu	e
analogue	s
analy	stz
analys	aeit
analysa	bnt
analysab	i
analysabi	l
analysabil	i
analysabili	t
analysabilit	y
analysan	ds
analysand	u
analysandu	m
analysat	i
analysati	o
analysatio	n
analyse	drs
analysi	ns
analysin	g
analyst	s
analyt	i
analyti	c
analytic	ais
analytica	l
analytical	l
analyticall	y
analytici	t
analyticit	iy
analyticiti	e
analyticitie	s
analyz	aei
analyza	b
analyzab	l
analyzabl	e
analyze	drs
analyzer	s
analyzi	n
analyzin	g
anan	d
anand	r
anandr	o
anandro	u
anandrou	s
anap	hl
anaph	o
anapho	r
anaphor	ai
anaphori	c
anaphoric	a
anaphorica	l
anaphorical	l
anaphoricall	y
anapl	a
anapla	s
anaplas	mt
anaplasm	o
anaplasmo	s
anaplasmos	i
anaplasmosi	s
anaplast	y
anar	c
anarc	h
anarch	iy
anarchi	acesz
anarchia	l
anarchic	a
anarchica	l
anarchie	s
anarchis	mt
anarchism	s
anarchist	is
anarchisti	c
anarchiz	e
anas	t
anast	aio
anasta	s
anastas	i
anastasi	a
anasti	g
anastig	m
anastigm	a
anastigma	t
anastigmat	i
anastigmati	c
anasto	m
anastom	o
anastomo	st
anastomos	ei
anastomose	s
anastomosi	s
anastomot	i
anastomoti	c
anat	ho
anath	e
anathe	m
anathem	aei
anathema	st
anathemat	ai
anathemati	csz
anathematic	a
anathematica	l
anathematis	am
anathematisa	t
anathematisat	i
anathematisati	o
anathematisatio	n
anathematiz	ae
anathematiza	t
anathematizat	i
anathematizati	o
anathematizatio	n
anathemi	z
anathemiz	e
anato	lm
anatol	ei
anatoli	a
anatolia	n
anatom	iy
anatomi	cesz
anatomic	a
anatomica	l
anatomical	l
anatomicall	y
anatomie	s
anatomis	t
anatomiz	e
anb	ehorsv
anc	ehilpqrv
ance	s
ances	t
ancest	or
ancesto	r
ancestor	is
ancestori	a
ancestoria	l
ancestr	aeiy
ancestra	l
ancestre	s
ancestres	s
ancestri	ae
ancestria	l
ancestrie	s
anch	o
ancho	rv
anchor	aeilmsw
anchora	bg
anchorab	l
anchorabl	e
anchorag	e
anchorage	s
anchore	dst
anchores	s
anchoret	i
anchoreti	c
anchori	nt
anchorin	g
anchorit	ei
anchoriti	s
anchoritis	m
anchorl	i
anchorli	k
anchorlik	e
anchorm	ae
anchorma	n
anchorme	n
anchorw	o
anchorwo	m
anchorwom	ae
anchorwoma	n
anchorwome	n
anchov	iy
anchovi	e
anchovie	s
anci	el
ancie	n
ancien	t
ancient	elns
anciente	rs
ancientes	t
ancientl	y
ancientn	e
ancientne	s
ancientnes	s
ancientness	e
ancientnesse	s
ancil	l
ancill	a
ancilla	r
ancillar	iy
ancillari	e
ancillarie	s
and	aeiorsy
anda	ln
andal	eu
andalu	s
andalus	i
andalusi	a
andalusia	n
andalusian	s
andan	t
andant	e
andante	s
ande	ars
andea	n
ander	s
anders	eo
anderse	n
anderso	n
andes	i
andesi	t
andesit	e
andi	nr
andin	g
andir	o
andiro	n
ando	rv
andor	r
andorr	a
andov	e
andove	r
andr	eo
andre	aiw
andrea	s
andrew	s
andro	gims
androg	ey
androge	n
androgy	n
androgyn	io
androgyni	e
androgynie	s
androgyno	u
androgynou	s
androgynous	l
androgynousl	y
androi	d
android	s
androm	ae
androma	c
andromac	h
andromach	e
androme	d
andromed	a
andros	t
androst	e
androste	r
androster	o
androstero	n
androsteron	e
ane	bcelmnoqrsuvwz
anec	dh
anecd	o
anecdo	t
anecdot	aei
anecdota	l
anecdotal	l
anecdotall	y
anecdote	s
anecdoti	s
anecdotis	t
anech	o
anecho	i
anechoi	c
anee	s
anees	a
anel	e
anem	io
anemi	ac
anemo	mn
anemom	e
anemome	t
anemomet	er
anemomete	r
anemometer	s
anemometr	iy
anemometri	c
anemometric	a
anemometrica	l
anemometrical	l
anemometricall	y
anemon	e
anemone	s
anen	t
aner	o
anero	i
aneroi	d
anes	t
anest	h
anesth	e
anesthe	st
anesthes	i
anesthesi	ao
anesthesio	l
anesthesiol	o
anesthesiolo	g
anesthesiolog	iy
anesthesiologi	s
anesthesiologis	t
anesthet	i
anestheti	csz
anesthetic	as
anesthetica	l
anesthetical	l
anestheticall	y
anesthetis	t
anesthetiz	aei
anesthetiza	t
anesthetizat	i
anesthetizati	o
anesthetizatio	n
anesthetize	ds
anesthetizi	n
anesthetizin	g
aneu	r
aneur	iy
aneuri	s
aneuris	m
aneury	s
aneurys	m
anf	lorsv
anfr	a
anfra	c
anfrac	t
anfract	u
anfractu	o
anfractuo	s
anfractuos	i
anfractuosi	t
anfractuosit	y
ang	eilorsuv
ange	lr
angel	aehilosu
angele	dns
angelen	o
angeleno	s
angelh	o
angelho	o
angelhoo	d
angeli	cnz
angelic	ai
angelica	l
angelical	ln
angelicall	y
angelicaln	e
angelicalne	s
angelicalnes	s
angelicalness	e
angelicalnesse	s
angelici	z
angeliciz	e
angelin	aeg
angeliz	e
angell	ei
angelle	d
angelli	n
angellin	g
angelo	l
angelol	a
angelola	t
angelolat	r
angelolatr	y
angels	h
angelsh	i
angelshi	p
angelu	s
anger	efils
angere	d
angerf	u
angerfu	l
angeri	n
angerin	g
angerl	ey
angerle	s
angerles	s
angers	o
angerso	m
angersom	e
angi	eno
angin	ao
angina	ls
angino	i
anginoi	d
angio	gst
angiog	r
angiogr	a
angiogra	p
angiograp	h
angiograph	y
angios	p
angiosp	e
angiospe	r
angiosper	m
angiot	e
angiote	n
angioten	s
angiotens	i
angiotensi	n
angl	eio
angle	drsw
angled	o
angledo	z
angledoz	e
angledoze	r
angler	s
anglew	io
anglewi	s
anglewis	e
anglewo	r
anglewor	m
angli	acn
anglic	ai
anglica	n
anglican	ils
anglicani	sz
anglicanis	m
anglicanism	s
anglicaniz	e
anglicanize	s
anglicanl	y
anglici	sz
anglicis	eim
anglicise	ds
anglicisi	n
anglicisin	g
anglicism	s
angliciz	aei
angliciza	t
anglicizat	i
anglicizati	o
anglicizatio	n
anglicization	s
anglicize	ds
anglicizi	n
anglicizin	g
anglin	g
angling	s
anglo	ps
anglop	h
angloph	io
anglophi	l
anglophil	ei
anglophili	a
anglopho	bn
anglophob	ei
anglophobi	a
anglophon	e
anglophone	s
anglos	a
anglosa	x
anglosax	o
anglosaxo	n
ango	lrs
angol	a
angor	a
angora	s
angos	t
angost	u
angostu	r
angostur	a
angr	aiy
angra	m
angram	m
angramm	a
angramma	t
angrammat	i
angrammati	c
angri	eln
angrie	rs
angries	t
angril	y
angrin	e
angrine	s
angrines	s
angriness	e
angrinesse	s
angs	t
angst	eirs
angsti	e
angstie	rs
angsties	t
angstr	o
angstro	m
angu	ils
angui	ls
anguil	l
anguill	a
anguis	h
anguish	eimo
anguishe	ds
anguishi	n
anguishin	g
anguishm	e
anguishme	n
anguishmen	t
anguisho	u
anguishou	s
angul	ao
angula	rt
angular	iln
angulari	t
angularit	y
angularl	y
angularn	e
angularne	s
angularnes	s
angularness	e
angularnesse	s
angulat	e
angulo	s
angulos	e
anh	eotwy
anhe	u
anheu	s
anheus	e
anheuse	r
anhw	e
anhwe	i
anhy	d
anhyd	r
anhydr	io
anhydri	t
anhydrit	e
anhydro	u
anhydrou	s
anhydrous	l
anhydrousl	y
ani	elmostv
anie	rs
anies	t
anil	ei
anili	nt
anilin	e
anilit	y
anim	aeiou
anima	dlt
animad	v
animadv	e
animadve	r
animadver	st
animadvers	i
animadversi	o
animadversio	n
animal	cilns
animalc	u
animalcu	l
animalcul	e
animali	ac
animalia	n
animall	iy
animalli	k
animallik	e
animaln	e
animalne	s
animalnes	s
animat	eio
animate	dklns
animated	l
animatedl	y
animatel	y
animaten	e
animatene	s
animatenes	s
animateness	e
animatenesse	s
animati	no
animatin	g
animating	l
animatingl	y
animatio	n
animation	s
animato	r
animator	s
animi	sz
animis	mt
animist	i
animisti	c
animiz	e
animize	d
animo	s
animos	i
animosi	t
animosit	iy
animositi	e
animositie	s
animu	s
anio	n
anion	is
anioni	c
anionic	a
anionica	l
anionical	l
anionicall	y
anis	eot
anise	eit
anisee	d
aniseed	s
anisei	k
aniseik	o
aniseiko	n
aniseikon	i
aniseikoni	c
aniset	t
anisett	e
aniso	t
anisot	r
anisotr	o
anisotro	p
anisotrop	iy
anisotropi	c
anist	o
anisto	n
anit	a
anj	osz
anjo	u
ank	ahil
anka	r
ankar	a
ankl	ei
ankle	bdst
ankleb	o
anklebo	n
anklebon	e
anklet	s
ankli	n
anklin	g
anm	h
ann	aeiou
anna	lpt
annal	is
annali	s
annalis	t
annalist	i
annalisti	c
annap	o
annapo	l
annapol	i
annapoli	s
annat	t
annatt	o
anne	altx
annea	l
anneal	i
anneali	n
annealin	g
annel	i
anneli	d
annet	t
annett	e
annex	aei
annexa	bt
annexab	l
annexabl	e
annexat	i
annexati	o
annexatio	n
annexation	ais
annexationa	l
annexationi	s
annexationis	t
annexationist	s
annexe	ds
annexi	n
annexin	g
anni	ehv
annih	i
annihi	l
annihil	a
annihila	t
annihilat	eio
annihilate	ds
annihilati	nov
annihilatin	g
annihilatio	n
annihilation	s
annihilativ	e
annihilato	r
annihilator	sy
anniv	e
annive	r
anniver	s
annivers	a
anniversa	r
anniversar	iy
anniversari	el
anniversarie	s
anniversaril	y
anno	tuy
annot	a
annota	t
annotat	aeio
annotata	b
annotatab	l
annotatabl	e
annotate	ds
annotati	nov
annotatin	g
annotatio	n
annotation	s
annotativ	e
annotato	r
annotator	sy
annou	n
announ	c
announc	ei
announce	admrs
announcea	b
announceab	l
announceabl	e
announcem	e
announceme	n
announcemen	t
announcement	s
announcer	s
announci	n
announcin	g
annoy	aeimos
annoya	n
annoyan	c
annoyanc	e
annoyance	rs
annoye	dr
annoyer	s
annoyi	n
annoyin	g
annoying	ln
annoyingl	y
annoyingn	e
annoyingne	s
annoyingnes	s
annoyingness	e
annoyingnesse	s
annoym	e
annoyme	n
annoymen	t
annoyo	u
annoyou	s
annu	ailmn
annua	l
annual	ils
annuali	z
annualiz	e
annuall	y
annui	t
annuit	aiy
annuita	n
annuitan	t
annuiti	ez
annuitie	s
annuitiz	e
annul	aeilmosu
annula	rt
annulat	e
annulate	l
annulatel	y
annule	t
annull	aei
annulla	b
annullab	l
annullabl	e
annulle	dr
annulli	n
annullin	g
annulm	e
annulme	n
annulmen	t
annulment	s
annulo	s
annulos	e
annulu	s
annun	c
annunc	i
annunci	a
annuncia	t
annunciat	eio
annunciate	ds
annunciati	no
annunciatin	g
annunciatio	n
annunciato	r
annunciator	s
ano	adilmnrtvx
anod	aeiy
anoda	l
anodal	l
anodall	y
anode	s
anodi	cz
anodic	a
anodica	l
anodical	l
anodicall	y
anodiz	aei
anodiza	t
anodizat	i
anodizati	o
anodizatio	n
anodize	drs
anodizi	n
anodizin	g
anody	n
anodyn	e
anoi	an
anoin	t
anoint	eims
anointe	dr
anointer	s
anointi	n
anointin	g
anointm	e
anointme	n
anointmen	t
anointment	s
anom	ai
anoma	l
anomal	ioy
anomali	es
anomalie	s
anomalis	t
anomalist	i
anomalisti	c
anomalo	u
anomalou	s
anomalous	ln
anomalousl	y
anomalousn	e
anomalousne	s
anomalousnes	s
anomalousness	e
anomalousnesse	s
anomi	ce
anon	y
anony	m
anonym	io
anonymi	t
anonymit	iy
anonymiti	e
anonymitie	s
anonymo	u
anonymou	s
anonymous	ln
anonymousl	y
anonymousn	e
anonymousne	s
anonymousnes	s
anonymousness	e
anonymousnesse	s
anor	ae
anora	k
anorak	sy
anore	x
anorex	i
anorexi	a
anorexia	ns
anorexian	t
anot	h
anoth	e
anothe	r
anox	i
anoxi	a
anp	d
anq	h
anr	ahrs
anrs	v
ans	beivw
anse	l
ansel	m
anselm	o
ansi	b
ansib	l
ansibl	e
answ	e
answe	r
answer	aeils
answera	b
answerab	il
answerabi	l
answerabil	i
answerabili	t
answerabilit	iy
answerabiliti	e
answerabilitie	s
answerabl	ey
answerable	n
answerablen	e
answerablene	s
answerablenes	s
answerableness	e
answerablenesse	s
answere	dr
answerer	s
answeri	n
answerin	g
answering	l
answeringl	y
answerl	e
answerle	s
answerles	s
ant	adehilorsw
anta	cegr
antac	i
antaci	d
antae	u
antaeu	s
antag	o
antago	n
antagon	i
antagoni	sz
antagonis	eimt
antagonise	ds
antagonisi	n
antagonisin	g
antagonism	s
antagonist	is
antagonisti	c
antagonistic	a
antagonistica	l
antagonistical	l
antagonisticall	y
antagoniz	aei
antagoniza	bt
antagonizab	l
antagonizabl	e
antagonizat	i
antagonizati	o
antagonizatio	n
antagonization	s
antagonize	drs
antagonizer	s
antagonizi	n
antagonizin	g
antar	ce
antarc	t
antarct	i
antarcti	c
antarctic	a
antare	s
antd	e
antde	s
antdes	i
antdesi	g
antdesig	n
ante	abcdflmnpr
antea	t
anteat	e
anteate	r
anteater	s
anteb	er
antebe	l
antebel	l
antebell	u
antebellu	m
antebr	a
antebra	c
antebrac	h
antebrach	i
antebrachi	u
antebrachiu	m
antec	ehu
antece	d
anteced	e
antecede	n
anteceden	t
antecedent	als
antecedenta	l
antecedentl	y
antech	a
antecha	mp
antecham	b
antechamb	e
antechambe	r
antechap	e
antechape	l
antecu	b
antecub	i
antecubi	t
antecubit	a
antecubita	l
anted	ai
anteda	t
antedat	e
antedi	l
antedil	u
antedilu	v
antediluv	i
antediluvi	a
antediluvia	n
antef	i
antefi	x
antel	o
antelo	p
antelop	ei
antelope	s
antelopi	an
antelopia	n
antelopin	e
antem	eou
anteme	r
antemer	i
antemeri	d
antemerid	i
antemeridi	a
antemeridia	n
antemo	r
antemor	t
antemort	e
antemorte	m
antemu	n
antemun	d
antemund	a
antemunda	n
antemundan	e
anten	anu
antena	t
antenat	a
antenata	l
antenatal	ls
antenatall	y
antenn	ai
antenna	elmrs
antennam	i
antennami	t
antennamit	t
antennamitt	e
antennamitte	r
antennar	y
antenni	f
antennif	eo
antennife	r
antennifer	o
antennifero	u
antenniferou	s
antennifo	r
antennifor	m
antenu	p
antenup	t
antenupt	i
antenupti	a
antenuptia	l
antep	e
antepe	n
antepen	u
antepenu	l
antepenul	t
anter	io
anteri	o
anterio	r
anterior	ilmn
anteriori	t
anteriorit	i
anterioriti	e
anterioritie	s
anteriorl	y
anteriorm	o
anteriormo	s
anteriormos	t
anteriorn	e
anteriorne	s
anteriornes	s
antero	o
anteroo	m
anth	eior
anthe	mr
anthem	eis
antheme	d
anthemi	n
anthemin	g
anther	als
anthera	l
antherl	e
antherle	s
antherles	s
anthi	l
anthil	l
antho	cln
anthoc	y
anthocy	a
anthocya	n
anthocyan	i
anthocyani	n
anthol	o
antholo	g
antholog	iy
anthologi	cesz
anthologic	a
anthologica	l
anthological	l
anthologicall	y
anthologie	s
anthologis	t
anthologiz	ae
anthologiza	t
anthologizat	i
anthologizati	o
anthologizatio	n
anthon	y
anthr	ao
anthra	cx
anthrac	ei
anthrace	ns
anthracen	e
anthraci	t
anthracit	ei
anthracite	s
anthraciti	c
anthro	p
anthrop	io
anthropi	c
anthropo	cgilmnpst
anthropoc	e
anthropoce	n
anthropocen	t
anthropocent	r
anthropocentr	i
anthropocentri	c
anthropog	e
anthropoge	o
anthropogeo	g
anthropogeog	r
anthropogeogr	a
anthropogeogra	p
anthropogeograp	h
anthropogeograph	iy
anthropogeographi	c
anthropogeographic	a
anthropogeographica	l
anthropoi	d
anthropol	ao
anthropola	t
anthropolat	r
anthropolatr	y
anthropolo	g
anthropolog	iy
anthropologi	cesz
anthropologic	a
anthropologica	l
anthropological	l
anthropologicall	y
anthropologie	s
anthropologis	t
anthropologist	s
anthropologiz	e
anthropom	o
anthropomo	r
anthropomor	p
anthropomorp	h
anthropomorph	i
anthropomorphi	cs
anthropomorphic	a
anthropomorphica	l
anthropomorphical	l
anthropomorphicall	y
anthropomorphis	m
anthropon	y
anthropony	m
anthroponym	y
anthropop	hs
anthropoph	a
anthropopha	g
anthropophag	y
anthropops	y
anthropopsy	c
anthropopsyc	h
anthropopsych	i
anthropopsychi	s
anthropopsychis	m
anthropos	o
anthroposo	p
anthroposop	h
anthroposoph	y
anthropot	o
anthropoto	m
anthropotom	i
anthropotomi	cs
anthropotomic	a
anthropotomica	l
anthropotomis	t
anti	abcdefghjklmnopqrstuvw
antia	bcdgilnprstu
antiab	u
antiabu	s
antiabus	e
antiac	an
antiaca	d
antiacad	e
antiacade	m
antiacadem	i
antiacademi	c
antiacademic	s
antiacn	e
antiad	m
antiadm	i
antiadmi	n
antiadmin	i
antiadmini	s
antiadminis	t
antiadminist	r
antiadministr	a
antiadministra	t
antiadministrat	i
antiadministrati	o
antiadministratio	n
antiadministration	s
antiag	gi
antiagg	r
antiaggr	e
antiaggre	s
antiaggres	s
antiaggress	i
antiaggressi	ov
antiaggressio	n
antiaggressiv	e
antiaggressive	ln
antiaggressivel	y
antiaggressiven	e
antiaggressivene	s
antiaggressivenes	s
antiaggressiveness	e
antiaggressivenesse	s
antiagi	n
antiagin	g
antiai	r
antiair	c
antiairc	r
antiaircr	a
antiaircra	f
antiaircraf	t
antial	cil
antialc	o
antialco	h
antialcoh	o
antialcoho	l
antialcohol	i
antialcoholi	s
antialcoholis	m
antialcoholism	s
antiali	e
antialie	n
antiall	e
antialle	r
antialler	g
antiallerg	y
antian	e
antiane	m
antianem	i
antianemi	a
antiap	ah
antiapa	r
antiapar	t
antiapart	h
antiaparth	e
antiaparthe	i
antiaparthei	d
antiapartheid	s
antiaph	r
antiaphr	o
antiaphro	d
antiaphrod	i
antiaphrodi	s
antiaphrodis	i
antiaphrodisi	a
antiaphrodisia	c
antiaphrodisiac	s
antiar	aimt
antiara	b
antiari	s
antiaris	t
antiarist	o
antiaristo	c
antiaristoc	r
antiaristocr	a
antiaristocra	ct
antiaristocrac	iy
antiaristocraci	e
antiaristocracie	s
antiaristocrat	i
antiaristocrati	c
antiarm	o
antiarmo	r
antiart	h
antiarth	r
antiarthr	i
antiarthri	t
antiarthrit	i
antiarthriti	cs
antias	st
antiass	i
antiassi	m
antiassim	i
antiassimi	l
antiassimil	a
antiassimila	t
antiassimilat	i
antiassimilati	o
antiassimilatio	n
antiast	h
antiasth	m
antiasthm	a
antiasthma	t
antiasthmat	i
antiasthmati	c
antiasthmatic	s
antiat	h
antiath	e
antiathe	i
antiathei	s
antiatheis	m
antiatheism	s
antiau	t
antiaut	h
antiauth	o
antiautho	r
antiauthor	i
antiauthori	t
antiauthorit	a
antiauthorita	r
antiauthoritar	i
antiauthoritari	a
antiauthoritaria	n
antiauthoritarian	is
antiauthoritariani	s
antiauthoritarianis	m
antiauthoritarianism	s
antib	aiou
antiba	c
antibac	kt
antiback	l
antibackl	a
antibackla	s
antibacklas	h
antibact	e
antibacte	r
antibacter	i
antibacteri	a
antibacteria	l
antibi	alo
antibia	s
antibil	l
antibill	b
antibillb	o
antibillbo	a
antibillboa	r
antibillboar	d
antibio	t
antibiot	i
antibioti	c
antibiotic	as
antibiotica	l
antibiotical	l
antibioticall	y
antibo	dsuy
antibod	iy
antibodi	e
antibodie	s
antibos	s
antibou	r
antibour	g
antibourg	e
antibourge	o
antibourgeo	i
antibourgeoi	s
antiboy	c
antiboyc	o
antiboyco	t
antiboycot	t
antiboycott	s
antibu	gr
antibur	eg
antibure	a
antiburea	u
antibureau	c
antibureauc	r
antibureaucr	a
antibureaucra	t
antibureaucrat	i
antibureaucrati	c
antiburg	hl
antiburgh	e
antiburghe	r
antiburgl	a
antiburgla	r
antiburglar	y
antic	aehilorsuy
antica	kprst
anticak	i
anticaki	n
anticakin	g
anticap	i
anticapi	t
anticapit	a
anticapita	l
anticapital	i
anticapitali	s
anticapitalis	m
anticapitalism	s
anticar	c
anticarc	i
anticarci	n
anticarcin	o
anticarcino	g
anticarcinog	e
anticarcinoge	n
anticarcinogen	s
anticas	t
anticast	e
anticat	h
anticath	o
anticatho	dl
anticathod	e
anticathol	i
anticatholi	c
antice	lnr
anticel	l
anticell	u
anticellu	l
anticellul	i
anticelluli	t
anticellulit	e
anticen	s
anticens	o
anticenso	r
anticensor	is
anticensori	a
anticensoria	l
anticensors	h
anticensorsh	i
anticensorshi	p
anticer	e
anticere	m
anticerem	o
anticeremo	n
anticeremon	i
anticeremoni	a
anticeremonia	l
anticeremonial	il
anticeremoniali	s
anticeremonialis	mt
anticeremonialism	s
anticeremonialist	s
anticeremoniall	y
antich	oru
anticho	l
antichol	e
antichole	s
anticholes	t
anticholest	e
anticholeste	r
anticholester	o
anticholestero	l
antichr	i
antichri	s
antichris	t
antichu	r
antichur	c
antichurc	h
antici	gptv
anticig	a
anticiga	r
anticigar	e
anticigare	t
anticigaret	t
anticigarett	e
anticip	a
anticipa	t
anticipat	aeio
anticipata	b
anticipatab	l
anticipatabl	e
anticipate	ds
anticipati	no
anticipatin	g
anticipating	l
anticipatingl	y
anticipatio	n
anticipation	s
anticipato	r
anticipator	sy
anticit	y
anticiv	i
anticivi	cl
anticivil	i
anticivili	a
anticivilia	n
anticl	aeioy
anticla	s
anticlas	s
anticlass	i
anticlassi	c
anticlassic	a
anticlassica	l
anticlassical	ln
anticlassicall	y
anticlassicaln	e
anticlassicalne	s
anticlassicalnes	s
anticlassicalness	e
anticlassicalnesse	s
anticle	r
anticler	g
anticlerg	y
anticli	mn
anticlim	a
anticlima	cx
anticlimac	t
anticlimact	i
anticlimacti	c
anticlimax	e
anticlimaxe	s
anticlin	aeg
anticlina	l
anticline	s
anticlo	cgt
anticloc	k
anticlock	w
anticlockw	i
anticlockwi	s
anticlockwis	e
anticlog	g
anticlogg	i
anticloggi	n
anticloggin	g
anticlot	t
anticlott	i
anticlotti	n
anticlottin	g
antico	adilmnrsu
anticoa	g
anticoag	u
anticoagu	l
anticoagul	a
anticoagula	nt
anticoagulan	t
anticoagulant	s
anticoagulat	i
anticoagulati	nov
anticoagulatin	g
anticoagulatio	n
anticoagulation	s
anticoagulativ	e
anticod	o
anticodo	n
anticodon	i
anticodoni	c
anticoi	n
anticoin	c
anticoinc	i
anticoinci	d
anticoincid	e
anticoincide	n
anticoinciden	c
anticoincidenc	e
anticol	dlo
anticoll	i
anticolli	s
anticollis	i
anticollisi	o
anticollisio	n
anticolo	n
anticolon	i
anticoloni	a
anticolonia	l
anticolonial	i
anticoloniali	s
anticolonialis	mt
anticolonialism	s
anticom	mp
anticomm	eu
anticomme	r
anticommer	c
anticommerc	i
anticommerci	a
anticommercia	l
anticommercial	iln
anticommerciali	s
anticommercialis	mt
anticommercialism	s
anticommercialist	is
anticommercialisti	c
anticommerciall	y
anticommercialn	e
anticommercialne	s
anticommercialnes	s
anticommercialness	e
anticommercialnesse	s
anticommu	n
anticommun	i
anticommuni	s
anticommunis	mt
anticommunism	s
anticommunist	is
anticommunisti	c
anticommunistic	a
anticommunistica	l
anticommunistical	l
anticommunisticall	y
anticomp	e
anticompe	t
anticompet	i
anticompeti	t
anticompetit	i
anticompetiti	v
anticompetitiv	e
anticompetitive	ln
anticompetitivel	y
anticompetitiven	e
anticompetitivene	s
anticompetitivenes	s
anticompetitiveness	e
anticompetitivenesse	s
anticon	fgstv
anticonf	eo
anticonfe	d
anticonfed	e
anticonfede	r
anticonfeder	a
anticonfedera	t
anticonfederat	i
anticonfederati	o
anticonfederatio	n
anticonfederation	i
anticonfederationi	s
anticonfederationis	mt
anticonfederationism	s
anticonfederationist	s
anticonfo	r
anticonfor	m
anticonform	i
anticonformi	s
anticonformis	t
anticonformist	s
anticong	l
anticongl	o
anticonglo	m
anticonglom	e
anticonglome	r
anticonglomer	a
anticonglomera	t
anticonglomerat	e
anticons	etu
anticonse	r
anticonser	v
anticonserv	a
anticonserva	t
anticonservat	i
anticonservati	osv
anticonservatio	n
anticonservation	is
anticonservationi	s
anticonservationis	t
anticonservationist	s
anticonservatis	m
anticonservatism	s
anticonservativ	e
anticonservative	lns
anticonservativel	y
anticonservativen	e
anticonservativene	s
anticonservativenes	s
anticonservativeness	e
anticonservativenesse	s
anticonst	i
anticonsti	t
anticonstit	u
anticonstitu	t
anticonstitut	i
anticonstituti	o
anticonstitutio	n
anticonstitution	a
anticonstitutiona	l
anticonstitutional	l
anticonstitutionall	y
anticonsu	m
anticonsum	e
anticonsume	r
anticonsumer	s
anticont	a
anticonta	g
anticontag	i
anticontagi	o
anticontagio	u
anticontagiou	s
anticontagious	ln
anticontagiousl	y
anticontagiousn	e
anticontagiousne	s
anticontagiousnes	s
anticontagiousness	e
anticontagiousnesse	s
anticonv	e
anticonve	n
anticonven	t
anticonvent	i
anticonventi	o
anticonventio	n
anticonvention	a
anticonventiona	l
anticonventional	il
anticonventionali	s
anticonventionalis	t
anticonventionalist	s
anticonventionall	y
anticor	pr
anticorp	o
anticorpo	r
anticorpor	a
anticorpora	t
anticorporat	e
anticorporate	ln
anticorporatel	y
anticorporaten	e
anticorporatene	s
anticorporatenes	s
anticorporateness	e
anticorporatenesse	s
anticorr	ou
anticorro	s
anticorros	i
anticorrosi	v
anticorrosiv	e
anticorru	p
anticorrup	t
anticorrupt	i
anticorrupti	o
anticorruptio	n
anticorruption	s
anticos	m
anticosm	e
anticosme	t
anticosmet	i
anticosmeti	c
anticosmetic	s
anticou	n
anticoun	t
anticount	e
anticounte	r
anticounter	f
anticounterf	e
anticounterfe	i
anticounterfei	t
anticounterfeit	i
anticounterfeiti	n
anticounterfeitin	g
anticr	aeiu
anticra	c
anticrac	k
anticre	a
anticrea	t
anticreat	i
anticreati	ov
anticreatio	n
anticreation	a
anticreationa	l
anticreativ	e
anticreative	ln
anticreativel	y
anticreativen	e
anticreativene	s
anticreativenes	s
anticreativeness	e
anticreativenesse	s
anticri	mt
anticrim	e
anticrit	i
anticriti	c
anticritic	a
anticritica	l
anticritical	ln
anticriticall	y
anticriticaln	e
anticriticalne	s
anticriticalnes	s
anticriticalness	e
anticriticalnesse	s
anticru	e
anticrue	l
anticruel	t
anticruelt	y
anticu	l
anticul	t
anticult	su
anticultu	r
anticultur	ae
anticultura	l
anticultural	l
anticulturall	y
anticulture	s
anticy	cn
anticyc	l
anticycl	o
anticyclo	n
anticyclon	ei
anticyclone	s
anticycloni	c
anticyclonic	a
anticyclonica	l
anticyclonical	l
anticyclonicall	y
anticyn	i
anticyni	c
anticynic	s
antid	aeiory
antida	n
antidan	cd
antidanc	i
antidanci	n
antidancin	g
antidand	r
antidandr	u
antidandru	f
antidandruf	f
antide	fgmpsv
antidef	a
antidefa	m
antidefam	a
antidefama	t
antidefamat	i
antidefamati	o
antidefamatio	n
antideg	r
antidegr	a
antidegra	d
antidegrad	a
antidegrada	t
antidegradat	i
antidegradati	o
antidegradatio	n
antidem	o
antidemo	c
antidemoc	r
antidemocr	a
antidemocra	ct
antidemocrac	iy
antidemocraci	e
antidemocracie	s
antidemocrat	is
antidemocrati	c
antidemocratic	a
antidemocratica	l
antidemocratical	l
antidemocraticall	y
antidep	r
antidepr	e
antidepre	s
antidepres	s
antidepress	ai
antidepressa	n
antidepressan	t
antidepressant	s
antidepressi	ov
antidepressio	n
antidepression	s
antidepressiv	e
antidepressive	s
antides	ei
antidese	gr
antideseg	r
antidesegr	e
antidesegre	g
antidesegreg	a
antidesegrega	t
antidesegregat	i
antidesegregati	o
antidesegregatio	n
antideser	t
antidesert	i
antideserti	f
antidesertif	i
antidesertifi	c
antidesertific	a
antidesertifica	t
antidesertificat	i
antidesertificati	o
antidesertificatio	n
antidesi	c
antidesic	c
antidesicc	a
antidesicca	n
antidesiccan	t
antidev	e
antideve	l
antidevel	o
antidevelo	p
antidevelop	m
antidevelopm	e
antidevelopme	n
antidevelopmen	t
antidi	alsu
antidia	r
antidiar	r
antidiarr	h
antidiarrh	eo
antidiarrhe	a
antidiarrhea	l
antidiarrheal	s
antidiarrho	e
antidiarrhoe	a
antidiarrhoea	l
antidil	u
antidilu	t
antidilut	i
antidiluti	ov
antidilutio	n
antidilutiv	e
antidis	ces
antidisc	r
antidiscr	i
antidiscri	m
antidiscrim	i
antidiscrimi	n
antidiscrimin	a
antidiscrimina	t
antidiscriminat	i
antidiscriminati	o
antidiscriminatio	n
antidise	s
antidises	t
antidisest	a
antidisesta	b
antidisestab	l
antidisestabl	i
antidisestabli	s
antidisestablis	h
antidisestablish	m
antidisestablishm	e
antidisestablishme	n
antidisestablishmen	t
antidisestablishment	a
antidisestablishmenta	r
antidisestablishmentar	i
antidisestablishmentari	a
antidisestablishmentaria	n
antidisestablishmentarian	i
antidisestablishmentariani	s
antidisestablishmentarianis	m
antidiss	i
antidissi	d
antidissid	e
antidisside	n
antidissiden	t
antidissident	s
antidiu	r
antidiur	e
antidiure	t
antidiuret	i
antidiureti	c
antido	gmt
antidog	m
antidogm	a
antidogma	t
antidogmat	i
antidogmati	c
antidogmatic	a
antidogmatica	l
antidogmatical	l
antidogmaticall	y
antidom	e
antidome	s
antidomes	t
antidomest	i
antidomesti	c
antidomestic	a
antidomestica	l
antidomestical	l
antidomesticall	y
antidot	aei
antidota	l
antidote	ds
antidoti	cn
antidotic	a
antidotica	l
antidotical	l
antidoticall	y
antidotin	g
antidr	a
antidra	f
antidraf	t
antidy	n
antidyn	a
antidyna	s
antidynas	t
antidynast	iy
antidynasti	c
antidynastic	a
antidynastica	l
antidynastical	l
antidynasticall	y
antie	acdglmnprstvx
antiea	v
antieav	e
antieave	s
antieaves	d
antieavesd	r
antieavesdr	o
antieavesdro	p
antieavesdrop	p
antieavesdropp	i
antieavesdroppi	n
antieavesdroppin	g
antiec	co
antiecc	l
antieccl	e
antieccle	s
antieccles	i
antiecclesi	a
antiecclesia	s
antiecclesias	t
antiecclesiast	i
antiecclesiasti	c
antiecclesiastic	a
antiecclesiastica	l
antiecclesiastical	l
antiecclesiasticall	y
antieco	n
antiecon	o
antiecono	m
antieconom	i
antieconomi	c
antied	u
antiedu	c
antieduc	a
antieduca	t
antieducat	i
antieducati	o
antieducatio	n
antieducation	a
antieducationa	l
antieg	ao
antiega	l
antiegal	i
antiegali	t
antiegalit	a
antiegalita	r
antiegalitar	i
antiegalitari	a
antiegalitaria	n
antiego	i
antiegoi	s
antiegois	m
antiegoism	s
antiel	i
antieli	t
antielit	ei
antieliti	s
antielitis	mt
antielitism	s
antiem	ep
antieme	t
antiemet	i
antiemeti	c
antiemetic	s
antiemp	i
antiempi	r
antiempir	i
antiempiri	c
antiempiric	ai
antiempirica	l
antiempirical	l
antiempiricall	y
antiempirici	s
antiempiricis	mt
antiempiricism	s
antiempiricist	s
antien	tv
antient	hr
antienth	u
antienthu	s
antienthus	i
antienthusi	a
antienthusia	s
antienthusias	mt
antienthusiasm	s
antienthusiast	is
antienthusiasti	c
antienthusiastic	a
antienthusiastica	l
antienthusiastical	l
antienthusiasticall	y
antientr	o
antientro	p
antientrop	i
antientropi	c
antienv	i
antienvi	r
antienvir	o
antienviro	n
antienviron	m
antienvironm	e
antienvironme	n
antienvironmen	t
antienvironment	a
antienvironmenta	l
antienvironmental	i
antienvironmentali	s
antienvironmentalis	t
antienvironmentalist	s
antiep	i
antiepi	l
antiepil	e
antiepile	p
antiepilep	st
antiepileps	y
antiepilept	i
antiepilepti	c
antiepileptic	s
antier	o
antiero	t
antierot	i
antieroti	c
anties	st
antiess	e
antiesse	n
antiessen	t
antiessent	i
antiessenti	a
antiessentia	l
antiessential	i
antiessentiali	s
antiessentialis	t
antiest	r
antiestr	o
antiestro	g
antiestrog	e
antiestroge	n
antiestrogen	s
antiet	a
antieta	m
antiev	o
antievo	l
antievol	u
antievolu	t
antievolut	i
antievoluti	o
antievolutio	n
antievolution	ai
antievolutiona	lr
antievolutional	l
antievolutionall	y
antievolutionar	y
antievolutioni	s
antievolutionis	mt
antievolutionism	s
antievolutionist	s
antiex	p
antiexp	ar
antiexpa	n
antiexpan	s
antiexpans	i
antiexpansi	o
antiexpansio	n
antiexpr	e
antiexpre	s
antiexpres	s
antiexpress	i
antiexpressi	v
antiexpressiv	e
antiexpressive	ln
antiexpressivel	y
antiexpressiven	e
antiexpressivene	s
antiexpressivenes	s
antiexpressiveness	e
antiexpressivenesse	s
antif	aeiloru
antifa	mst
antifam	i
antifami	l
antifamil	y
antifas	ch
antifasc	i
antifasci	s
antifascis	mt
antifascism	s
antifascist	s
antifash	i
antifashi	o
antifashio	n
antifashion	as
antifashiona	b
antifashionab	l
antifashionabl	e
antifat	i
antifati	g
antifatig	u
antifatigu	e
antife	bmu
antifeb	r
antifebr	i
antifebri	fl
antifebrif	i
antifebrifi	c
antifebril	e
antifem	ai
antifema	l
antifemal	e
antifemi	n
antifemin	i
antifemini	ns
antifeminin	e
antifeminine	ln
antifemininel	y
antifemininen	e
antifemininene	s
antifemininenes	s
antifeminineness	e
antifemininenesse	s
antifeminis	mt
antifeminism	s
antifeminist	s
antifeu	d
antifeud	a
antifeuda	l
antifeudal	i
antifeudali	s
antifeudalis	mt
antifeudalism	s
antifeudalist	is
antifeudalisti	c
antifi	l
antifil	i
antifili	b
antifilib	u
antifilibu	s
antifilibus	t
antifilibust	e
antifilibuste	r
antifl	u
antifo	agr
antifoa	m
antifoam	i
antifoami	n
antifoamin	g
antifog	g
antifogg	i
antifoggi	n
antifoggin	g
antifor	em
antifore	i
antiforei	g
antiforeig	n
antiforeign	e
antiforeigne	r
antiform	a
antiforma	ln
antiformal	i
antiformali	s
antiformalis	t
antiforman	t
antifr	ae
antifra	u
antifrau	d
antifre	e
antifree	z
antifreez	e
antifreeze	s
antifu	nr
antifun	dg
antifund	a
antifunda	m
antifundam	e
antifundame	n
antifundamen	t
antifundament	a
antifundamenta	l
antifundamental	i
antifundamentali	s
antifundamentalis	t
antifung	a
antifunga	l
antig	aeoru
antiga	mny
antigam	b
antigamb	l
antigambl	i
antigambli	n
antigamblin	g
antigan	g
antigay	s
antige	n
antigen	is
antigeni	c
antigenic	ai
antigenica	l
antigenical	l
antigenicall	y
antigenici	t
antigenicit	i
antigeniciti	e
antigenicitie	s
antigo	nv
antigon	e
antigov	e
antigove	r
antigover	n
antigovern	m
antigovernm	e
antigovernme	n
antigovernmen	t
antigr	ao
antigra	mv
antigram	m
antigramm	a
antigramma	t
antigrammat	i
antigrammati	c
antigrammatic	a
antigrammatica	l
antigrammatical	ln
antigrammaticall	y
antigrammaticaln	e
antigrammaticalne	s
antigrammaticalnes	s
antigrammaticalness	e
antigrammaticalnesse	s
antigrav	i
antigravi	t
antigravit	y
antigro	w
antigrow	t
antigrowt	h
antigu	aen
antigue	r
antiguer	r
antiguerr	i
antiguerri	l
antiguerril	l
antiguerrill	a
antiguerrilla	s
antih	aeiouy
antiha	r
antihar	a
antihara	s
antiharas	s
antiharass	m
antiharassm	e
antiharassme	n
antiharassmen	t
antihe	glr
antiheg	e
antihege	m
antihegem	o
antihegemo	n
antihegemon	iy
antihegemoni	e
antihegemonie	s
antihel	i
antiheli	x
antiher	p
antiherp	e
antiherpe	s
antihi	ejs
antihie	r
antihier	a
antihiera	r
antihierar	c
antihierarc	h
antihierarch	iy
antihierarchi	ce
antihierarchic	a
antihierarchica	l
antihierarchie	s
antihij	a
antihija	c
antihijac	k
antihijack	i
antihijacki	n
antihijackin	g
antihis	t
antihist	ao
antihista	m
antihistam	i
antihistami	n
antihistamin	ei
antihistamine	s
antihistamini	c
antihistaminic	s
antihisto	r
antihistor	i
antihistori	c
antihistoric	a
antihistorica	l
antihistorical	ln
antihistoricall	y
antihistoricaln	e
antihistoricalne	s
antihistoricalnes	s
antihistoricalness	e
antihistoricalnesse	s
antiho	m
antihom	o
antihomo	s
antihomos	e
antihomose	x
antihomosex	u
antihomosexu	a
antihomosexua	l
antihu	mn
antihum	a
antihuma	n
antihuman	i
antihumani	st
antihumanis	mt
antihumanism	s
antihumanist	is
antihumanisti	c
antihumanit	aiy
antihumanita	r
antihumanitar	i
antihumanitari	a
antihumanitaria	n
antihumanitarian	s
antihumaniti	e
antihumanitie	s
antihun	gt
antihung	e
antihunge	r
antihunt	ei
antihunte	r
antihunti	n
antihuntin	g
antihunting	s
antihy	gs
antihyg	i
antihygi	e
antihygie	n
antihygien	i
antihygieni	c
antihygienic	a
antihygienica	l
antihygienical	l
antihygienicall	y
antihys	t
antihyst	e
antihyste	r
antihyster	i
antihysteri	c
antihysteric	a
antihysterica	l
antij	a
antija	m
antijam	m
antijamm	i
antijammi	n
antijammin	g
antik	in
antiki	c
antikic	k
antikick	b
antikickb	a
antikickba	c
antikickbac	k
antikn	o
antikno	c
antiknoc	k
antil	aeiloy
antila	b
antilab	o
antilabo	u
antilabou	r
antile	apv
antilea	k
antilep	r
antilepr	o
antilepro	s
antilepros	y
antilev	e
antileve	l
antilevel	il
antileveli	n
antilevelin	g
antilevell	i
antilevelli	n
antilevellin	g
antili	bqt
antilib	e
antilibe	r
antiliber	at
antilibera	l
antiliberal	ilns
antiliberali	s
antiliberalis	m
antiliberalism	s
antiliberall	y
antiliberaln	e
antiliberalne	s
antiliberalnes	s
antiliberalness	e
antiliberalnesse	s
antilibert	a
antiliberta	r
antilibertar	i
antilibertari	a
antilibertaria	n
antiliq	u
antiliqu	o
antiliquo	r
antilit	et
antilite	r
antiliter	a
antilitera	crt
antiliterac	y
antiliterar	y
antiliterat	e
antiliterate	ls
antiliteratel	y
antilitt	e
antilitte	r
antilitter	i
antilitteri	n
antilitterin	g
antill	e
antille	s
antilo	gt
antilog	aiy
antiloga	r
antilogar	i
antilogari	t
antilogarit	h
antilogarith	m
antilogi	c
antilogic	a
antilogica	l
antilot	t
antilott	e
antilotte	r
antilotter	y
antily	n
antilyn	c
antilync	h
antilynch	i
antilynchi	n
antilynchin	g
antim	aeiouy
antima	cglnrt
antimac	ah
antimaca	s
antimacas	s
antimacass	a
antimacassa	r
antimach	io
antimachi	n
antimachin	e
antimachine	r
antimachiner	y
antimag	n
antimagn	e
antimagne	t
antimagnet	i
antimagneti	c
antimal	ae
antimala	r
antimalar	i
antimalari	a
antimale	s
antiman	a
antimana	g
antimanag	e
antimanage	m
antimanagem	e
antimanageme	n
antimanagemen	t
antimanagement	s
antimar	ik
antimari	j
antimarij	u
antimariju	a
antimarijua	n
antimarijuan	a
antimark	e
antimarke	t
antimat	et
antimate	r
antimater	i
antimateri	a
antimateria	l
antimaterial	i
antimateriali	s
antimaterialis	mt
antimaterialism	s
antimaterialist	s
antimatt	e
antimatte	r
antime	cdrt
antimec	h
antimech	a
antimecha	n
antimechan	i
antimechani	sz
antimechanis	mt
antimechanism	s
antimechaniz	a
antimechaniza	t
antimechanizat	i
antimechanizati	o
antimechanizatio	n
antimed	i
antimedi	ace
antimedia	e
antimediae	v
antimediaev	a
antimediaeva	l
antimediaeval	l
antimediaevall	y
antimedic	ai
antimedica	lt
antimedical	l
antimedicall	y
antimedicat	i
antimedicati	o
antimedicatio	n
antimedici	n
antimedicin	e
antimedie	v
antimediev	a
antimedieva	l
antimedieval	l
antimedievall	y
antimer	g
antimerg	ei
antimerge	r
antimergi	n
antimergin	g
antimet	ah
antimeta	bp
antimetab	o
antimetabo	l
antimetabol	i
antimetaboli	c
antimetap	h
antimetaph	y
antimetaphy	s
antimetaphys	i
antimetaphysi	c
antimetaphysic	a
antimetaphysica	l
antimeth	o
antimetho	d
antimethod	i
antimethodi	c
antimethodic	a
antimethodica	l
antimethodical	ln
antimethodicall	y
antimethodicaln	e
antimethodicalne	s
antimethodicalnes	s
antimethodicalness	e
antimethodicalnesse	s
antimi	clns
antimic	r
antimicr	o
antimicro	b
antimicrob	i
antimicrobi	a
antimicrobia	l
antimil	i
antimili	t
antimilit	a
antimilita	r
antimilitar	iy
antimilitari	s
antimilitaris	mt
antimilitarism	s
antimilitarist	is
antimilitaristi	c
antimin	ei
antimini	s
antiminis	t
antiminist	e
antiministe	r
antiminister	i
antiministeri	a
antiministeria	l
antiministerial	l
antiministeriall	y
antimis	cs
antimisc	e
antimisce	g
antimisceg	e
antimiscege	n
antimiscegen	a
antimiscegena	t
antimiscegenat	i
antimiscegenati	o
antimiscegenatio	n
antimiss	i
antimissi	l
antimissil	e
antimissile	s
antimo	dnrs
antimod	e
antimode	r
antimoder	n
antimodern	ilns
antimoderni	sz
antimodernis	mt
antimodernist	s
antimoderniz	a
antimoderniza	t
antimodernizat	i
antimodernizati	o
antimodernizatio	n
antimodernl	y
antimodernn	e
antimodernne	s
antimodernnes	s
antimodernness	e
antimodernnesse	s
antimon	aiosy
antimona	r
antimonar	c
antimonarc	h
antimonarch	isy
antimonarchi	as
antimonarchia	l
antimonarchis	t
antimonarchist	s
antimoni	ae
antimonia	t
antimoniat	e
antimoniate	d
antimonie	s
antimono	p
antimonop	o
antimonopo	l
antimonopol	iy
antimonopoli	sz
antimonopolis	t
antimonopoliz	a
antimonopoliza	t
antimonopolizat	i
antimonopolizati	o
antimonopolizatio	n
antimons	o
antimonso	o
antimonsoo	n
antimor	a
antimora	l
antimoral	i
antimorali	t
antimoralit	y
antimos	q
antimosq	u
antimosqu	i
antimosqui	t
antimosquit	o
antimu	s
antimus	i
antimusi	c
antimusic	as
antimusica	l
antimusical	ln
antimusicall	y
antimusicaln	e
antimusicalne	s
antimusicalnes	s
antimusicalness	e
antimusicalnesse	s
antimy	s
antimys	t
antimyst	i
antimysti	c
antimystic	ais
antimystica	l
antimystical	ln
antimysticall	y
antimysticaln	e
antimysticalne	s
antimysticalnes	s
antimysticalness	e
antimysticalnesse	s
antimystici	s
antimysticis	m
antimysticism	s
antin	aeo
antina	rtu
antinar	cr
antinarc	o
antinarco	t
antinarcot	i
antinarcoti	c
antinarcotic	s
antinarr	a
antinarra	t
antinarrat	i
antinarrati	v
antinarrativ	e
antinat	iu
antinati	o
antinatio	n
antination	a
antinationa	l
antinational	il
antinationali	sz
antinationalis	mt
antinationalism	s
antinationalist	is
antinationalisti	c
antinationalistic	a
antinationalistica	l
antinationalistical	l
antinationalisticall	y
antinationaliz	a
antinationaliza	t
antinationalizat	i
antinationalizati	o
antinationalizatio	n
antinationall	y
antinatu	r
antinatur	ae
antinatura	l
antinatural	iln
antinaturali	s
antinaturalis	t
antinaturalist	s
antinaturall	y
antinaturaln	e
antinaturalne	s
antinaturalnes	s
antinaturalness	e
antinaturalnesse	s
antinature	s
antinau	s
antinaus	e
antinause	a
antine	pu
antinep	ho
antineph	r
antinephr	i
antinephri	t
antinephrit	i
antinephriti	c
antinephritic	a
antinephritica	l
antinepo	t
antinepot	i
antinepoti	s
antinepotis	m
antinepotism	s
antineu	t
antineut	r
antineutr	ao
antineutra	l
antineutral	ils
antineutrali	t
antineutralit	iy
antineutraliti	e
antineutralitie	s
antineutrall	y
antineutro	n
antino	dmr
antinod	e
antinode	s
antinom	iy
antinomi	a
antinomia	n
antinor	dm
antinord	i
antinordi	c
antinorm	a
antinorma	l
antinormal	in
antinormali	t
antinormalit	iy
antinormaliti	e
antinormalitie	s
antinormaln	e
antinormalne	s
antinormalnes	s
antinormalness	e
antinormalnesse	s
antio	bcprx
antiob	es
antiobe	s
antiobes	i
antiobesi	t
antiobesit	y
antiobs	c
antiobsc	e
antiobsce	n
antiobscen	i
antiobsceni	t
antiobscenit	i
antiobsceniti	e
antiobscenitie	s
antioc	h
antiop	t
antiopt	i
antiopti	m
antioptim	i
antioptimi	s
antioptimis	mt
antioptimism	s
antioptimist	i
antioptimisti	c
antioptimistic	a
antioptimistica	l
antioptimistical	l
antioptimisticall	y
antior	git
antiorg	a
antiorga	n
antiorgan	i
antiorgani	z
antiorganiz	a
antiorganiza	t
antiorganizat	i
antiorganizati	o
antiorganizatio	n
antiorganization	s
antiori	e
antiorie	n
antiorien	t
antiorient	a
antiorienta	l
antiort	h
antiorth	o
antiortho	d
antiorthod	o
antiorthodo	x
antiorthodox	l
antiorthodoxl	y
antiox	iy
antioxi	d
antioxid	ai
antioxida	nt
antioxidan	t
antioxidat	i
antioxidati	v
antioxidativ	e
antioxidi	z
antioxidiz	i
antioxidizi	n
antioxidizin	g
antioxy	g
antioxyg	e
antioxyge	n
antioxygen	a
antioxygena	t
antioxygenat	io
antioxygenati	no
antioxygenatin	g
antioxygenatio	n
antioxygenation	s
antioxygenato	r
antioxygenator	s
antip	aehiloruy
antipa	cprt
antipac	i
antipaci	f
antipacif	i
antipacifi	s
antipacifis	m
antipacifism	s
antipap	a
antipapa	l
antipar	lt
antiparl	i
antiparli	a
antiparlia	m
antiparliam	e
antiparliame	n
antiparliamen	t
antiparliament	a
antiparliamenta	r
antiparliamentar	y
antipart	iy
antiparti	c
antipartic	l
antiparticl	e
antipat	ehr
antipath	eioy
antipathe	t
antipathet	i
antipatheti	c
antipathi	esz
antipathie	s
antipathis	t
antipathist	s
antipathiz	e
antipatho	u
antipathou	s
antipatr	i
antipatri	ao
antipatria	r
antipatriar	c
antipatriarc	h
antipatriarch	aisy
antipatriarcha	l
antipatriarchal	l
antipatriarchall	y
antipatriarchi	e
antipatriarchie	s
antipatrio	t
antipatriot	is
antipatrioti	c
antipatriotic	a
antipatriotica	l
antipatriotical	l
antipatrioticall	y
antipe	rs
antiper	is
antiperi	s
antiperis	t
antiperist	a
antiperista	l
antiperistal	t
antiperistalt	i
antiperistalti	c
antipers	op
antiperso	n
antiperson	n
antipersonn	e
antipersonne	l
antipersp	i
antiperspi	r
antiperspir	a
antiperspira	n
antiperspiran	t
antiperspirant	s
antipes	t
antipest	i
antipesti	cl
antipestic	i
antipestici	d
antipesticid	e
antipestil	e
antipestile	n
antipestilen	t
antipestilent	i
antipestilenti	a
antipestilentia	l
antiph	ailory
antipha	s
antiphas	e
antiphi	l
antiphil	o
antiphilo	s
antiphilos	o
antiphiloso	p
antiphilosop	h
antiphilosoph	iy
antiphilosophi	ce
antiphilosophic	a
antiphilosophica	l
antiphilosophical	l
antiphilosophicall	y
antiphilosophie	s
antiphl	o
antiphlo	g
antiphlog	i
antiphlogi	s
antiphlogis	t
antiphlogist	i
antiphlogisti	c
antipho	n
antiphon	ay
antiphona	l
antiphr	a
antiphra	s
antiphras	i
antiphrasi	s
antiphy	s
antiphys	i
antiphysi	c
antiphysic	a
antiphysica	l
antiphysical	ln
antiphysicall	y
antiphysicaln	e
antiphysicalne	s
antiphysicalnes	s
antiphysicalness	e
antiphysicalnesse	s
antipi	r
antipir	a
antipira	c
antipirac	iy
antipiraci	e
antipiracie	s
antipl	ae
antipla	gqt
antiplag	u
antiplagu	e
antiplague	s
antiplaq	u
antiplaqu	e
antiplat	e
antiplate	l
antiplatel	e
antiplatele	t
antiple	a
antiplea	s
antipleas	u
antipleasu	r
antipleasur	e
antipleasure	s
antipo	adelprt
antipoa	c
antipoac	h
antipoach	i
antipoachi	n
antipoachin	g
antipod	ae
antipoda	l
antipode	as
antipodea	n
antipoe	t
antipoet	i
antipoeti	c
antipoetic	a
antipoetica	l
antipoetical	l
antipoeticall	y
antipol	aei
antipola	r
antipoli	ct
antipolic	e
antipolit	i
antipoliti	c
antipolitic	as
antipolitica	l
antipolitical	l
antipoliticall	y
antipop	eu
antipopu	l
antipopul	a
antipopula	r
antipopular	i
antipopulari	z
antipopulariz	a
antipopulariza	t
antipopularizat	i
antipopularizati	o
antipopularizatio	n
antipopularization	s
antipor	n
antiporn	o
antiporno	g
antipornog	r
antipornogr	a
antipornogra	p
antipornograp	h
antipornograph	iy
antipornographi	ce
antipornographie	s
antipr	aeio
antipra	g
antiprag	m
antipragm	a
antipragma	t
antipragmat	i
antipragmati	cs
antipragmatic	a
antipragmatica	l
antipragmatical	l
antipragmaticall	y
antipragmatis	m
antipragmatism	s
antipre	ds
antipred	a
antipreda	t
antipredat	o
antipredato	r
antipredator	s
antipres	s
antipri	e
antiprie	s
antipries	t
antipro	dfghst
antiprod	u
antiprodu	c
antiproduc	t
antiproduct	i
antiproducti	v
antiproductiv	e
antiproductive	ln
antiproductivel	y
antiproductiven	e
antiproductivene	s
antiproductivenes	s
antiproductiveness	e
antiproductivenesse	s
antiprof	i
antiprofi	t
antiprofit	e
antiprofite	e
antiprofitee	r
antiprofiteer	i
antiprofiteeri	n
antiprofiteerin	g
antiprog	r
antiprogr	e
antiprogre	s
antiprogres	s
antiprogress	i
antiprogressi	v
antiprogressiv	e
antiproh	i
antiprohi	b
antiprohib	i
antiprohibi	t
antiprohibit	i
antiprohibiti	o
antiprohibitio	n
antiprohibition	s
antipros	t
antiprost	i
antiprosti	t
antiprostit	u
antiprostitu	t
antiprostitut	i
antiprostituti	o
antiprostitutio	n
antiprostitution	s
antiprot	eo
antiprote	c
antiprotec	t
antiprotect	i
antiprotecti	o
antiprotectio	n
antiprotection	i
antiprotectioni	s
antiprotectionis	t
antiprotectionist	s
antiproto	n
antipu	r
antipur	i
antipuri	t
antipurit	a
antipurita	n
antipuritan	s
antipy	r
antipyr	e
antipyre	t
antipyret	i
antipyreti	c
antiq	u
antiqu	aei
antiqua	rt
antiquar	iy
antiquari	a
antiquaria	n
antiquarian	s
antiquat	e
antiquate	d
antiquated	n
antiquatedn	e
antiquatedne	s
antiquatednes	s
antiquatedness	e
antiquatednesse	s
antique	dhlnrs
antiqueh	o
antiqueho	o
antiquehoo	d
antiquel	y
antiquen	e
antiquene	s
antiquenes	s
antiqueness	e
antiquenesse	s
antiquer	s
antiqui	nt
antiquin	g
antiquit	aeiy
antiquita	r
antiquitar	i
antiquitari	a
antiquitaria	n
antiquite	s
antiquiti	e
antiquitie	s
antir	aeioru
antira	bcdpt
antirab	i
antirabi	e
antirabie	s
antirabies	e
antirabiese	s
antirac	ik
antiraci	ans
antiracia	l
antiracial	l
antiraciall	y
antiracin	g
antiracis	mt
antiracism	s
antiracist	s
antirack	e
antiracke	t
antiracket	e
antirackete	e
antiracketee	r
antiracketeer	i
antiracketeeri	n
antiracketeerin	g
antirad	ai
antirada	r
antiradar	s
antiradi	ac
antiradia	nt
antiradian	t
antiradiat	i
antiradiati	no
antiradiatin	g
antiradiatio	n
antiradic	a
antiradica	l
antiradical	i
antiradicali	s
antiradicalis	m
antirap	e
antirat	i
antirati	o
antiratio	n
antiration	a
antirationa	l
antirational	il
antirationali	st
antirationalis	mt
antirationalism	s
antirationalit	y
antirationall	y
antire	acdfglpsv
antirea	cl
antireac	t
antireact	i
antireacti	ov
antireactio	n
antireaction	as
antireactiona	r
antireactionar	iy
antireactionari	e
antireactionarie	s
antireactiv	e
antireal	i
antireali	st
antirealis	mt
antirealism	s
antirealist	is
antirealisti	c
antirealistic	a
antirealistica	l
antirealistical	l
antirealisticall	y
antirealit	y
antirec	e
antirece	s
antireces	s
antirecess	i
antirecessi	o
antirecessio	n
antirecession	a
antirecessiona	r
antirecessionar	y
antired	eu
antirede	p
antiredep	o
antiredepo	s
antiredepos	i
antiredeposi	t
antiredeposit	i
antiredepositi	o
antiredepositio	n
antiredu	c
antireduc	it
antireduci	n
antireducin	g
antireducing	s
antireduct	i
antireducti	o
antireductio	n
antireduction	i
antireductioni	s
antireductionis	mt
antireductionism	s
antiref	lo
antirefl	e
antirefle	c
antireflec	t
antireflect	i
antireflecti	ov
antireflectio	n
antireflectiv	e
antireflective	ln
antireflectivel	y
antireflectiven	e
antireflectivene	s
antireflectivenes	s
antireflectiveness	e
antireflectivenesse	s
antirefo	r
antirefor	m
antireform	e
antireforme	r
antireformer	s
antireg	u
antiregu	l
antiregul	a
antiregula	t
antiregulat	o
antiregulato	r
antiregulator	y
antirel	i
antireli	g
antirelig	i
antireligi	o
antireligio	nu
antireligiou	s
antireligious	l
antireligiousl	y
antirep	u
antirepu	b
antirepub	l
antirepubl	i
antirepubli	c
antirepublic	a
antirepublica	n
antirepublican	s
antires	iot
antiresi	s
antiresis	t
antiresist	a
antiresista	n
antiresistan	t
antiresistant	ls
antiresistantl	y
antireso	n
antireson	a
antiresona	nt
antiresonan	c
antiresonanc	e
antiresonat	o
antiresonato	r
antirest	o
antiresto	r
antirestor	a
antirestora	t
antirestorat	i
antirestorati	o
antirestoratio	n
antirev	o
antirevo	l
antirevol	u
antirevolu	t
antirevolut	i
antirevoluti	o
antirevolutio	n
antirevolution	a
antirevolutiona	r
antirevolutionar	iy
antirevolutionari	e
antirevolutionarie	s
antiri	ot
antirio	t
antiriot	s
antirit	u
antiritu	a
antiritua	l
antiritual	i
antirituali	s
antiritualis	m
antiritualism	s
antiro	bclmy
antirob	b
antirobb	e
antirobbe	r
antirobber	y
antiroc	k
antirol	l
antirom	a
antiroma	n
antiroman	t
antiromant	i
antiromanti	c
antiromantic	is
antiromantici	s
antiromanticis	m
antiromanticism	s
antiroy	a
antiroya	l
antiroyal	i
antiroyali	s
antiroyalis	t
antirr	h
antirrh	i
antirrhi	n
antirrhin	u
antirrhinu	m
antiru	s
antirus	t
antis	acehiklmnoptuy
antisa	gt
antisat	e
antisate	l
antisatel	l
antisatell	i
antisatelli	t
antisatellit	e
antisc	ehior
antisce	p
antiscep	t
antiscept	i
antiscepti	c
antisceptic	is
antisceptici	s
antiscepticis	m
antiscepticism	s
antisch	io
antischi	z
antischiz	o
antischizo	p
antischizop	h
antischizoph	r
antischizophr	e
antischizophre	n
antischizophren	i
antischizophreni	ac
antischo	l
antischol	a
antischola	s
antischolas	t
antischolast	i
antischolasti	c
antischolastic	as
antischolastica	l
antischolastical	l
antischolasticall	y
antisci	e
antiscie	n
antiscien	ct
antiscienc	e
antiscience	s
antiscient	i
antiscienti	f
antiscientif	i
antiscientifi	c
antisco	r
antiscor	b
antiscorb	u
antiscorbu	t
antiscorbut	i
antiscorbuti	c
antiscorbutic	a
antiscorbutica	l
antiscr	i
antiscri	p
antiscrip	t
antiscript	u
antiscriptu	r
antiscriptur	i
antiscripturi	s
antiscripturis	t
antise	cdgimnprx
antisec	r
antisecr	e
antisecre	c
antisecrec	y
antised	i
antisedi	t
antisedit	i
antisediti	o
antiseditio	n
antiseg	r
antisegr	e
antisegre	g
antisegreg	a
antisegrega	t
antisegregat	i
antisegregati	o
antisegregatio	n
antisei	z
antiseiz	u
antiseizu	r
antiseizur	e
antisem	i
antisemi	t
antisemit	i
antisemiti	cs
antisemitis	m
antisen	st
antisens	u
antisensu	o
antisensuo	u
antisensuou	s
antisensuous	ln
antisensuousl	y
antisensuousn	e
antisensuousne	s
antisensuousnes	s
antisensuousness	e
antisensuousnesse	s
antisent	i
antisenti	m
antisentim	e
antisentime	n
antisentimen	t
antisentiment	a
antisentimenta	l
antisentimental	l
antisentimentall	y
antisep	ast
antisepa	r
antisepar	a
antisepara	t
antiseparat	i
antiseparati	s
antiseparatis	t
antiseps	i
antisepsi	s
antisept	i
antisepti	c
antiseptic	as
antiseptica	l
antiseptical	l
antisepticall	y
antiser	au
antiseru	m
antisex	iu
antisexi	s
antisexis	mt
antisexism	s
antisexist	s
antisexu	a
antisexua	l
antisexual	il
antisexuali	t
antisexualit	iy
antisexualiti	e
antisexualitie	s
antisexuall	y
antish	aio
antisha	r
antishar	k
antishi	p
antisho	cp
antishoc	k
antishop	l
antishopl	i
antishopli	f
antishoplif	t
antishoplift	i
antishoplifti	n
antishopliftin	g
antisi	d
antisid	e
antiside	t
antisidet	o
antisideto	n
antisideton	e
antisk	i
antiski	d
antiskid	d
antiskidd	i
antiskiddi	n
antiskiddin	g
antisl	aei
antisla	v
antislav	e
antislave	r
antislaver	y
antisle	e
antislee	p
antisli	p
antism	ou
antismo	k
antismok	e
antismoke	rs
antismu	gt
antismug	g
antismugg	l
antismuggl	i
antismuggli	n
antismugglin	g
antisn	o
antisno	b
antisnob	s
antiso	cd
antisoc	i
antisoci	a
antisocia	l
antisocial	ils
antisociali	st
antisocialis	t
antisocialist	is
antisocialisti	c
antisocialit	i
antisocialiti	e
antisocialitie	s
antisociall	y
antisod	o
antisodo	m
antisodom	y
antisp	aeilr
antispa	ms
antispas	m
antispasm	o
antispasmo	d
antispasmod	i
antispasmodi	c
antispe	cn
antispec	u
antispecu	l
antispecul	a
antispecula	t
antispeculat	i
antispeculati	v
antispeculativ	e
antispeculative	ln
antispeculativel	y
antispeculativen	e
antispeculativene	s
antispeculativenes	s
antispeculativeness	e
antispeculativenesse	s
antispen	d
antispend	i
antispendi	n
antispendin	g
antispi	r
antispir	i
antispiri	t
antispirit	u
antispiritu	a
antispiritua	l
antispiritual	il
antispirituali	s
antispiritualis	mt
antispiritualism	s
antispiritualist	i
antispiritualisti	c
antispirituall	y
antispl	i
antispli	t
antisplit	t
antisplitt	i
antisplitti	n
antisplittin	g
antispr	e
antispre	a
antisprea	d
antispread	i
antispreadi	n
antispreadin	g
antist	aeiruy
antista	t
antistat	ei
antistati	s
antistatis	t
antiste	r
antister	i
antisteri	l
antisteril	i
antisterili	t
antisterilit	y
antisti	cm
antistic	k
antistim	u
antistimu	l
antistimul	a
antistimula	nt
antistimulan	t
antistimulant	s
antistimulat	i
antistimulati	o
antistimulatio	n
antistimulation	s
antistr	eiu
antistre	s
antistres	s
antistri	k
antistrik	e
antistrike	r
antistriker	s
antistru	c
antistruc	t
antistruct	u
antistructu	r
antistructur	a
antistructura	l
antistructural	i
antistructurali	s
antistructuralis	t
antistructuralist	s
antistu	d
antistud	e
antistude	n
antistuden	t
antistudent	s
antisty	l
antistyl	e
antistyle	s
antisu	bfip
antisub	msv
antisubm	a
antisubma	r
antisubmar	i
antisubmari	n
antisubmarin	e
antisubs	i
antisubsi	d
antisubsid	iy
antisubsidi	e
antisubsidie	s
antisubv	e
antisubve	r
antisubver	s
antisubvers	i
antisubversi	ov
antisubversio	n
antisubversiv	e
antisuf	f
antisuff	r
antisuffr	a
antisuffra	g
antisuffrag	e
antisui	c
antisuic	i
antisuici	d
antisuicid	e
antisup	e
antisupe	r
antisuper	n
antisupern	a
antisuperna	t
antisupernat	u
antisupernatu	r
antisupernatur	a
antisupernatura	l
antisupernatural	s
antisy	mnp
antisym	m
antisymm	e
antisymme	t
antisymmet	r
antisymmetr	iy
antisymmetri	ce
antisymmetrie	s
antisyn	d
antisynd	i
antisyndi	c
antisyndic	a
antisyndica	t
antisyndicat	i
antisyndicati	o
antisyndicatio	n
antisyp	h
antisyph	i
antisyphi	l
antisyphil	i
antisyphili	t
antisyphilit	i
antisyphiliti	c
antit	aehory
antita	knrx
antitak	e
antitake	o
antitakeo	v
antitakeov	e
antitakeove	r
antitakeover	s
antitan	k
antitar	n
antitarn	i
antitarni	s
antitarnis	h
antitarnish	i
antitarnishi	n
antitarnishin	g
antitax	a
antitaxa	t
antitaxat	i
antitaxati	o
antitaxatio	n
antite	crt
antitec	h
antitech	n
antitechn	o
antitechno	l
antitechnol	o
antitechnolo	g
antitechnolog	i
antitechnologi	ce
antitechnologic	a
antitechnologica	l
antitechnologie	s
antiter	r
antiterr	o
antiterro	r
antiterror	i
antiterrori	s
antiterroris	mt
antiterrorism	s
antiterrorist	s
antitet	a
antiteta	n
antitetan	i
antitetani	c
antith	ey
antithe	fiost
antithef	t
antithei	s
antitheis	t
antitheist	i
antitheisti	c
antitheo	lr
antitheol	o
antitheolo	g
antitheolog	y
antitheor	e
antitheore	t
antitheoret	i
antitheoreti	c
antitheoretic	a
antitheoretica	l
antitheoretical	l
antitheoreticall	y
antithes	ei
antithese	s
antithesi	s
antithet	i
antitheti	c
antithetic	a
antithetica	l
antithy	r
antithyr	o
antithyro	i
antithyroi	d
antithyroid	s
antito	bntx
antitob	a
antitoba	c
antitobac	c
antitobacc	o
antiton	i
antitoni	c
antitonic	s
antitot	a
antitota	l
antitotal	i
antitotali	t
antitotalit	a
antitotalita	r
antitotalitar	i
antitotalitari	a
antitotalitaria	n
antitox	i
antitoxi	n
antitoxin	s
antitr	au
antitra	d
antitrad	i
antitradi	t
antitradit	i
antitraditi	o
antitraditio	n
antitradition	a
antitraditiona	l
antitru	s
antitrus	t
antity	p
antityp	eh
antityph	o
antitypho	i
antityphoi	d
antiu	nrt
antiun	ei
antiune	m
antiunem	p
antiunemp	l
antiunempl	o
antiunemplo	y
antiunemploy	m
antiunemploym	e
antiunemployme	n
antiunemploymen	t
antiuni	ov
antiunio	n
antiuniv	e
antiunive	r
antiuniver	s
antiunivers	i
antiuniversi	t
antiuniversit	iy
antiuniversiti	e
antiuniversitie	s
antiur	b
antiurb	a
antiurba	n
antiut	i
antiuti	l
antiutil	i
antiutili	t
antiutilit	a
antiutilita	r
antiutilitar	i
antiutilitari	a
antiutilitaria	n
antiutilitarian	s
antiv	i
antivi	orv
antivio	l
antiviol	e
antiviole	n
antiviolen	c
antiviolenc	e
antivir	au
antivira	l
antiviral	s
antiviru	s
antiviv	i
antivivi	s
antivivis	e
antivivise	c
antivivisec	t
antivivisect	i
antivivisecti	o
antivivisectio	n
antivivisection	i
antivivisectioni	s
antivivisectionis	t
antivivisectionist	s
antiw	ehor
antiwe	al
antiwea	r
antiwel	f
antiwelf	a
antiwelfa	r
antiwelfar	e
antiwh	a
antiwha	l
antiwhal	i
antiwhali	n
antiwhalin	g
antiwo	m
antiwom	a
antiwoma	n
antiwr	i
antiwri	n
antiwrin	k
antiwrink	l
antiwrinkl	e
antl	ei
antle	r
antler	els
antlere	d
antlerl	ei
antlerle	s
antlerles	s
antlerli	k
antlerlik	e
antli	ko
antlik	e
antlio	n
anto	in
antoi	n
antoin	e
antoine	t
antoinet	t
antoinett	e
anton	ioy
antoni	o
antono	mv
antonom	a
antonoma	s
antonomas	i
antonomasi	a
antonov	i
antonovi	c
antonovic	s
antony	m
antonym	is
antonymi	e
antonymie	s
antr	u
antru	m
ants	iy
antsi	en
antsie	rs
antsies	t
antsin	e
antsine	s
antsines	s
antsiness	e
antsinesse	s
antw	e
antwe	r
antwer	p
anu	sv
anus	e
anuse	s
anv	i
anvi	l
anvil	s
anw	u
anx	iu
anxi	eo
anxie	t
anxiet	iy
anxieti	e
anxietie	s
anxio	u
anxiou	s
anxious	ln
anxiousl	y
anxiousn	e
anxiousne	s
anxiousnes	s
anxiousness	e
anxiousnesse	s
any	bhmoptw
anyb	o
anybo	d
anybod	iy
anybodi	e
anybodie	s
anyh	o
anyho	w
anym	o
anymo	r
anymor	e
anyo	n
anyon	e
anyp	l
anypl	a
anypla	c
anyplac	e
anyt	hi
anyth	i
anythi	n
anythin	g
anything	as
anythinga	r
anythingar	i
anythingari	a
anythingaria	n
anyti	m
anytim	e
anyw	ahi
anywa	y
anyway	s
anywh	e
anywhe	r
anywher	e
anywi	s
anywis	e
ao	abcdefghijklmnopqrstuvxz
aoa	rv
aob	fpv
aoc	l
aoe	defi
aoee	v
aof	u
aog	n
aoh	hv
aoj	o
aok	dv
aol	bl
aom	bv
aon	bfov
aoo	abdfhikmnprtvwx
aoob	rv
aood	rv
aooi	v
aoot	rv
aoox	rv
aop	o
aoq	rv
aor	tv
aort	ai
aorta	es
aorti	c
aos	p
aot	bo
aou	d
aoud	a
aouda	d
aox	bdv
aoz	ou
ap	abcdefghijklmnopqrstuwxz
apa	aclnrtv
apaa	s
apac	eh
apach	e
apache	dehjkstz
apached	u
apachedu	b
apachedub	b
apachedubb	o
apachee	c
apacheec	h
apacheech	a
apacheecha	r
apacheechar	t
apacheechart	s
apacheh	i
apachehi	v
apachehiv	e
apachej	m
apachejm	e
apachejme	t
apachejmet	e
apachejmete	r
apachek	a
apacheka	f
apachekaf	k
apachekafk	a
apaches	h
apachesh	a
apachesha	r
apacheshar	d
apacheshard	i
apacheshardi	n
apacheshardin	g
apachesharding	s
apacheshardings	p
apacheshardingsp	h
apacheshardingsph	e
apacheshardingsphe	r
apacheshardingspher	e
apachet	o
apacheto	m
apachetom	c
apachetomc	a
apachetomca	t
apachez	o
apachezo	o
apachezoo	k
apachezook	e
apachezooke	e
apachezookee	p
apachezookeep	e
apachezookeepe	r
apal	a
apala	c
apalac	h
apalach	i
apalachi	c
apalachic	o
apalachico	l
apalachicol	a
apan	a
apana	g
apanag	e
apar	t
apart	hmn
aparth	e
aparthe	i
aparthei	d
apartheid	s
apartm	e
apartme	n
apartmen	t
apartment	as
apartmenta	l
apartn	e
apartne	s
apartnes	s
apartness	e
apartnesse	s
apat	hi
apath	eiy
apathe	it
apathei	a
apatheia	s
apathet	i
apatheti	c
apathetic	a
apathetica	l
apathetical	l
apatheticall	y
apathi	aes
apathia	s
apathie	s
apathis	t
apati	t
apatit	e
apb	vw
apd	knotv
ape	adelprstx
apea	k
apel	i
apeli	kn
apelik	e
apelin	g
apep	s
apeps	i
apepsi	a
aper	isty
aperi	eot
aperie	n
aperien	t
aperio	d
aperiod	i
aperiodi	c
aperiodic	i
aperiodici	t
aperiodicit	y
aperit	i
aperiti	f
aperitif	s
apert	u
apertu	r
apertur	ae
apertura	l
aperture	ds
apet	a
apeta	l
apetal	o
apetalo	u
apetalou	s
apex	e
apexe	s
apf	dsvw
aph	aeior
apha	s
aphas	i
aphasi	ac
aphe	l
aphel	i
apheli	o
aphelio	n
aphi	ds
aphid	is
aphidi	aov
aphidia	n
aphidian	s
aphidio	u
aphidiou	s
aphidiv	o
aphidivo	r
aphidivor	o
aphidivoro	u
aphidivorou	s
apho	nr
aphon	i
aphoni	ac
aphor	i
aphori	s
aphoris	mt
aphorism	ais
aphorisma	t
aphorismat	i
aphorismati	c
aphorismi	c
aphorist	is
aphoristi	c
aphoristic	a
aphoristica	l
aphoristical	l
aphoristicall	y
aphr	o
aphro	d
aphrod	i
aphrodi	st
aphrodis	i
aphrodisi	a
aphrodisia	c
aphrodisiac	s
aphrodit	e
api	acemnsu
apia	nr
apiar	iy
apiari	aes
apiaria	n
apiarie	s
apiaris	t
apic	ae
apica	l
apice	s
apie	c
apiec	e
apin	g
apis	h
apj	rv
apk	mp
apkm	i
apkmi	r
apkmir	r
apkmirr	o
apkmirro	r
apkp	u
apkpu	r
apkpur	e
apl	eo
aple	n
aplen	t
aplent	y
aplo	m
aplom	b
apm	ht
apn	dfiop
apni	c
apo	bcdghlprst
apob	v
apoc	aor
apoca	lr
apocal	y
apocaly	p
apocalyp	st
apocalyps	et
apocalypse	s
apocalypt	i
apocalypti	c
apocar	p
apocarp	o
apocarpo	u
apocarpou	s
apoco	p
apocop	e
apocr	y
apocry	p
apocryp	h
apocryph	a
apocrypha	l
apocryphal	ln
apocryphall	y
apocryphaln	e
apocryphalne	s
apocryphalnes	s
apocryphalness	e
apocryphalnesse	s
apod	eo
apode	i
apodei	c
apodeic	t
apodeict	i
apodeicti	c
apodo	s
apodos	i
apodosi	s
apog	e
apoge	ae
apogea	n
apogee	s
apol	ilou
apoli	t
apolit	i
apoliti	c
apolitic	ai
apolitica	l
apolitical	l
apoliticall	y
apolitici	s
apoliticis	m
apoliticism	s
apoll	io
apolli	n
apollin	a
apollina	i
apollinai	r
apollinair	e
apollo	n
apollon	i
apolloni	a
apollonia	n
apolo	g
apolog	eiuy
apologe	t
apologet	i
apologeti	c
apologetic	a
apologetica	l
apologetical	l
apologeticall	y
apologi	aesz
apologie	s
apologis	eit
apologise	ds
apologisi	n
apologisin	g
apologist	s
apologiz	ei
apologize	drs
apologizer	s
apologizi	n
apologizin	g
apologu	e
apolu	n
apolun	e
apop	lt
apopl	e
apople	cx
apoplec	t
apoplect	i
apoplecti	c
apoplex	y
apopt	o
apopto	s
apoptos	i
apoptosi	s
apor	t
apos	it
aposi	o
aposio	p
aposiop	e
aposiope	s
aposiopes	i
aposiopesi	s
apost	alor
aposta	st
apostas	y
apostat	ei
apostati	z
apostatiz	e
apostl	e
apostle	hs
apostleh	o
apostleho	o
apostlehoo	d
apostlehood	s
apostles	h
apostlesh	i
apostleshi	p
apostleship	s
aposto	l
apostol	aei
apostola	t
apostolat	e
apostole	s
apostoles	s
apostoli	cz
apostoliz	e
apostr	o
apostro	p
apostrop	h
apostroph	ei
apostrophe	s
apostrophi	c
apot	h
apoth	e
apothe	cgmo
apothec	a
apotheca	r
apothecar	y
apotheg	m
apotheo	s
apotheos	ei
apotheose	s
apotheosi	s
app	acefilorsu
appa	lnr
appal	almos
appala	c
appalac	h
appalach	i
appalachi	a
appalachia	n
appalachian	s
appall	eis
appalle	d
appalli	n
appallin	g
appalling	l
appallingl	y
appalm	e
appalme	n
appalmen	t
appalo	o
appaloo	s
appaloos	a
appaloosa	s
appan	a
appana	g
appanag	e
appar	aei
appara	t
apparat	u
apparatu	s
apparatus	e
apparatuse	s
appare	ln
apparel	e
apparele	d
apparen	t
apparent	ln
apparentl	y
apparentn	e
apparentne	s
apparentnes	s
apparentness	e
apparentnesse	s
appari	t
apparit	i
appariti	o
apparitio	n
apparition	as
apparitiona	l
appc	lo
appcl	e
appcle	a
appclea	n
appclean	e
appcleane	r
appco	d
appcod	e
appe	alnrt
appea	lrs
appeal	aeis
appeala	b
appealab	il
appealabi	l
appealabil	i
appealabili	t
appealabilit	iy
appealabiliti	e
appealabilitie	s
appealabl	e
appeale	dr
appealer	s
appeali	n
appealin	g
appealing	ln
appealingl	y
appealingn	e
appealingne	s
appealingnes	s
appealingness	e
appealingnesse	s
appear	aeis
appeara	n
appearan	c
appearanc	e
appearance	s
appeare	dr
appearer	s
appeari	n
appearin	g
appearing	l
appearingl	y
appeas	aei
appeasa	b
appeasab	l
appeasabl	ey
appeasable	n
appeasablen	e
appeasablene	s
appeasablenes	s
appeasableness	e
appeasablenesse	s
appease	admrs
appeasea	b
appeaseab	l
appeaseabl	e
appeasem	e
appeaseme	n
appeasemen	t
appeasement	s
appeaser	s
appeasi	nv
appeasin	g
appeasing	l
appeasingl	y
appeasiv	e
appel	l
appell	aeo
appella	nt
appellan	t
appellant	s
appellat	ei
appellati	o
appellatio	n
appelle	e
appello	r
appen	d
append	aeis
appenda	g
appendag	e
appendage	ds
appende	cdr
appendec	t
appendect	o
appendecto	m
appendectom	y
appender	s
appendi	cnx
appendic	ei
appendice	s
appendici	t
appendicit	i
appendiciti	s
appendicitis	e
appendicitise	s
appendin	g
appendix	e
appendixe	s
apper	ct
apperc	e
apperce	p
appercep	t
appercept	i
appercepti	o
apperceptio	n
appert	a
apperta	i
appertai	n
appertain	aeis
appertaina	n
appertainan	c
appertainanc	e
appertaine	d
appertaini	n
appertainin	g
appet	ei
appete	n
appeten	t
appeti	stz
appetis	ei
appetise	r
appetisi	n
appetisin	g
appetit	ei
appetite	s
appetiti	o
appetitio	u
appetitiou	s
appetiz	ei
appetize	r
appetizer	s
appetizi	n
appetizin	g
appetizing	l
appetizingl	y
appf	l
appfl	o
appflo	w
appflow	y
appi	au
appia	n
appiu	m
appl	aeiy
appla	u
applau	ds
applaud	aeis
applauda	b
applaudab	l
applaudabl	ey
applaude	dr
applauder	s
applaudi	n
applaudin	g
applauding	l
applaudingl	y
applaus	ei
applause	s
applausi	v
applausiv	e
applausive	l
applausivel	y
apple	abcdfgijlmnopstvw
applea	r
applear	c
applearc	a
applearca	d
applearcad	e
appleb	oy
applebo	o
appleboo	k
applebook	s
applec	a
appleca	r
applecar	de
appled	e
applede	v
appledev	e
appledeve	l
appledevel	o
appledevelo	p
appledevelop	e
appledevelope	r
applef	i
applefi	l
applefil	e
applefile	s
applefiles	y
applefilesy	s
applefilesys	t
applefilesyst	e
applefilesyste	m
appleg	a
applega	t
applegat	e
applei	dn
applein	t
appleint	e
appleinte	l
appleintel	l
appleintell	i
appleintelli	g
appleintellig	e
appleintellige	n
appleintelligen	c
appleintelligenc	e
applej	a
appleja	c
applejac	k
applel	i
appleli	k
applelik	e
applem	u
applemu	s
applemus	i
applemusi	c
applen	e
applene	w
applenew	s
appleo	n
appleon	e
applep	ae
applepa	y
applepe	n
applepen	c
applepenc	i
applepenci	l
apples	at
applesa	u
applesau	c
applesauc	e
applest	o
applesto	r
applestor	e
applet	osv
appleto	n
applev	i
applevi	s
applevis	i
applevisi	o
applevisio	n
applevision	p
applevisionp	r
applevisionpr	o
applew	a
applewa	t
applewat	c
applewatc	h
appli	aceq
applia	bn
appliab	l
appliabl	ey
appliable	n
appliablen	e
appliablene	s
appliablenes	s
appliableness	e
appliablenesse	s
applian	c
applianc	ei
appliance	s
applianci	n
appliancin	g
applic	a
applica	bnt
applicab	il
applicabi	l
applicabil	i
applicabili	t
applicabilit	iy
applicabiliti	e
applicabilitie	s
applicabl	ey
applicable	n
applicablen	e
applicablene	s
applicablenes	s
applicableness	e
applicablenesse	s
applican	t
applicant	s
applicat	io
applicati	ov
applicatio	n
application	as
applicationa	l
applicativ	e
applicative	l
applicativel	y
applicato	r
applicator	s
applie	drs
applied	a
applieda	i
applier	s
appliq	u
appliqu	e
apply	i
applyi	n
applyin	g
appo	imrs
appoi	n
appoin	t
appoint	aeims
appointa	b
appointab	l
appointabl	e
appointe	der
appointee	s
appointer	s
appointi	nv
appointin	g
appointiv	e
appointm	e
appointme	n
appointmen	t
appointment	s
appom	a
appoma	t
appomat	t
appomatt	o
appomatto	x
appor	t
apport	i
apporti	o
apportio	n
apportion	aeims
apportiona	bt
apportionab	l
apportionabl	e
apportionat	e
apportione	dr
apportioner	s
apportioni	n
apportionin	g
apportionm	e
apportionme	n
apportionmen	t
apportionment	s
appos	ei
apposi	t
apposit	ei
appositi	ov
appositio	n
appositiv	e
appr	aeio
appra	i
apprai	s
apprais	aei
appraisa	bl
appraisab	l
appraisabl	e
appraisal	s
appraise	demrs
appraisee	s
appraisem	e
appraiseme	n
appraisemen	t
appraisement	s
appraiser	s
appraisi	n
appraisin	g
appraising	l
appraisingl	y
appre	chn
apprec	i
appreci	a
apprecia	bt
appreciab	l
appreciabl	ey
appreciat	eio
appreciate	ds
appreciati	nov
appreciatin	g
appreciating	l
appreciatingl	y
appreciatio	n
appreciation	as
appreciationa	l
appreciativ	e
appreciative	ln
appreciativel	y
appreciativen	e
appreciativene	s
appreciativenes	s
appreciativeness	e
appreciativenesse	s
appreciato	r
appreciator	s
appreh	e
apprehe	n
apprehen	ds
apprehend	eis
apprehende	dr
apprehender	s
apprehendi	n
apprehendin	g
apprehens	i
apprehensi	bov
apprehensib	l
apprehensibl	e
apprehensio	n
apprehension	s
apprehensiv	e
apprehensive	ln
apprehensivel	y
apprehensiven	e
apprehensivene	s
apprehensivenes	s
apprehensiveness	e
apprehensivenesse	s
appren	t
apprent	i
apprenti	c
apprentic	ei
apprentice	dhms
apprenticeh	o
apprenticeho	o
apprenticehoo	d
apprenticem	e
apprenticeme	n
apprenticemen	t
apprentices	h
apprenticesh	i
apprenticeshi	p
apprenticeship	s
apprentici	n
apprenticin	g
appri	s
appris	ei
apprise	ds
apprisi	n
apprisin	g
appro	abpvx
approa	c
approac	h
approach	aeilm
approacha	b
approachab	il
approachabi	l
approachabil	i
approachabili	t
approachabilit	iy
approachabiliti	e
approachabilitie	s
approachabl	e
approachable	n
approachablen	e
approachablene	s
approachablenes	s
approachableness	e
approachablenesse	s
approache	drs
approacher	s
approachi	n
approachin	g
approachl	e
approachle	s
approachles	s
approachm	e
approachme	n
approachmen	t
approb	a
approba	t
approbat	ei
approbati	o
approbatio	n
approp	r
appropr	i
appropri	ae
appropria	bt
appropriab	l
appropriabl	e
appropriat	eio
appropriate	dlns
appropriatel	y
appropriaten	e
appropriatene	s
appropriatenes	s
appropriateness	e
appropriatenesse	s
appropriates	t
appropriati	nov
appropriatin	g
appropriatio	n
appropriation	s
appropriativ	e
appropriative	n
appropriativen	e
appropriativene	s
appropriativenes	s
appropriativeness	e
appropriativenesse	s
appropriato	r
appropriator	s
approv	aei
approva	bl
approvab	l
approvabl	e
approvable	n
approvablen	e
approvablene	s
approvablenes	s
approval	s
approve	drs
approved	ln
approvedl	y
approvedn	e
approvedne	s
approvednes	s
approvedness	e
approvednesse	s
approver	s
approvi	n
approvin	g
approving	l
approvingl	y
approx	i
approxi	m
approxim	a
approxima	t
approximat	eio
approximate	dls
approximatel	y
approximati	no
approximatin	g
approximatio	n
approximation	s
approximato	r
apps	t
appst	o
appsto	r
appstor	e
appu	r
appur	t
appurt	e
appurte	n
appurten	a
appurtena	n
appurtenan	ct
appurtenanc	e
appurtenance	s
apq	g
apqg	v
apr	io
apri	cl
apric	o
aprico	t
apricot	s
april	s
apro	np
apron	efils
aprone	d
apronf	u
apronfu	l
aproni	n
apronin	g
apronl	i
apronli	k
apronlik	e
aprop	o
apropo	s
aps	ei
apsi	s
apt	beilnov
apte	rs
apter	aoy
aptera	l
aptero	u
apterou	s
aptery	x
aptes	t
apti	t
aptit	u
aptitu	d
aptitud	ei
aptitude	s
aptitudi	n
aptitudin	a
aptitudina	l
aptitudinal	l
aptitudinall	y
aptl	y
aptn	e
aptne	s
aptnes	s
aptness	e
aptnesse	s
apto	s
apx	v
apz	w
aq	abdeghijkmnopqrstuvx
aqa	bdfqrv
aqar	v
aqb	r
aqd	bgr
aqe	r
aqg	r
aqi	rsv
aqj	qrv
aqm	e
aqn	bdfruv
aqnb	v
aqo	cehkmrsvw
aqoe	v
aqp	abefghnostyz
aqpb	v
aqpf	v
aqph	v
aqpt	v
aqq	qy
aqr	jqrv
aqu	aceio
aqua	clmprt
aquac	u
aquacu	l
aquacul	t
aquacult	u
aquacultu	r
aquacultur	e
aqual	u
aqualu	n
aqualun	g
aquam	a
aquama	r
aquamar	i
aquamari	n
aquamarin	e
aquamarine	s
aquap	l
aquapl	a
aquapla	n
aquaplan	e
aquar	i
aquari	au
aquaria	ln
aquariu	ms
aquarium	s
aquarius	e
aquariuse	s
aquat	i
aquati	cn
aquatic	a
aquatica	l
aquatical	l
aquaticall	y
aquatin	t
aque	do
aqued	u
aquedu	c
aqueduc	t
aqueduct	s
aqueo	u
aqueou	s
aqueous	ln
aqueousl	y
aqueousn	e
aqueousne	s
aqueousnes	s
aqueousness	e
aqueousnesse	s
aqui	cfln
aquic	u
aquicu	l
aquicul	t
aquicult	u
aquicultu	r
aquicultur	e
aquif	e
aquife	r
aquifer	os
aquifero	u
aquiferou	s
aquil	ai
aquili	n
aquilin	e
aquin	a
aquina	s
aquo	s
aquos	i
aquosi	t
aquosit	y
aqv	bfghnot
aqx	v
ar	abcdefghijklmnopqrstuvwxyz
ara	bcfgmnoprtuv
arab	beilsy
arabb	e
arabbe	r
arabber	s
arabe	s
arabes	q
arabesq	u
arabesqu	e
arabi	acdls
arabia	n
arabian	is
arabiani	z
arabianiz	e
arabianize	s
arabic	ais
arabici	sz
arabicis	m
arabiciz	e
arabicize	s
arabid	o
arabido	p
arabidop	s
arabidops	i
arabidopsi	s
arabil	i
arabili	t
arabilit	i
arabiliti	e
arabilitie	s
arabis	t
arabl	e
arable	s
arac	h
arach	n
arachn	eio
arachni	d
arachnid	as
arachnida	n
arachnidan	s
arachno	i
arachnoi	d
araf	a
arafa	t
arag	o
arago	n
aragon	i
aragoni	t
aragonit	e
aram	ac
arama	i
aramai	c
aramc	o
aran	e
arane	i
aranei	d
arap	a
arapa	hi
arapah	o
arapai	m
arapaim	a
arat	o
arato	p
arau	c
arauc	a
arauca	r
araucar	i
araucari	a
arb	biouv
arbi	t
arbit	er
arbite	r
arbiter	s
arbitr	au
arbitra	bglmrt
arbitrab	l
arbitrabl	e
arbitrag	ei
arbitrage	dsu
arbitrageu	r
arbitragi	n
arbitragin	g
arbitram	e
arbitrame	n
arbitramen	t
arbitrar	iy
arbitrari	elno
arbitrarie	s
arbitraril	y
arbitrarin	e
arbitrarine	s
arbitrarines	s
arbitrariness	e
arbitrarinesse	s
arbitrario	u
arbitrariou	s
arbitrat	eior
arbitrate	ds
arbitrati	nov
arbitratin	g
arbitratio	n
arbitrativ	e
arbitrato	r
arbitrator	s
arbitrators	h
arbitratorsh	i
arbitratorshi	p
arbitratr	i
arbitratri	x
arbitru	m
arbo	ru
arbor	eisv
arbore	ast
arborea	l
arbores	c
arboresc	e
arboresce	n
arborescen	t
arboret	u
arboretu	m
arbori	csz
arboric	u
arboricu	l
arboricul	t
arboricult	u
arboricultu	r
arboricultur	ei
arboriculturi	s
arboriculturis	t
arboris	a
arborisa	t
arborisat	i
arborisati	o
arborisatio	n
arboriz	ae
arboriza	t
arborizat	i
arborizati	o
arborizatio	n
arborv	i
arborvi	t
arborvit	a
arborvita	e
arbou	r
arbu	t
arbut	u
arbutu	s
arc	aehiklostuv
arca	den
arcad	ei
arcade	ds
arcadi	a
arcadia	n
arcae	a
arcan	eu
arcane	ln
arcanel	y
arcanen	e
arcanene	s
arcanenes	s
arcanu	m
arce	d
arch	abcdefilnopswy
archa	ein
archae	o
archaeo	clp
archaeoc	y
archaeocy	t
archaeocyt	e
archaeol	o
archaeolo	g
archaeolog	iuy
archaeologi	aces
archaeologia	n
archaeologic	a
archaeologica	l
archaeological	l
archaeologicall	y
archaeologie	s
archaeologis	t
archaeologist	s
archaeologu	e
archaeop	t
archaeopt	e
archaeopte	r
archaeopter	y
archaeoptery	x
archai	csz
archaic	ain
archaica	l
archaical	l
archaicall	y
archaici	s
archaicis	mt
archaicn	e
archaicne	s
archaicnes	s
archais	mt
archaist	i
archaisti	c
archaiz	e
archan	g
archang	e
archange	l
archangel	s
archb	i
archbi	s
archbis	h
archbish	o
archbisho	p
archbishop	hrs
archbishoph	o
archbishopho	o
archbishophoo	d
archbishopr	i
archbishopri	c
archbishops	h
archbishopsh	i
archbishopshi	p
archc	o
archco	n
archcon	f
archconf	r
archconfr	a
archconfra	t
archconfrat	e
archconfrate	r
archconfrater	n
archconfratern	i
archconfraterni	t
archconfraternit	y
archd	eiu
archde	a
archdea	cn
archdeac	o
archdeaco	n
archdeacon	r
archdeaconr	y
archdean	e
archdeane	r
archdeaner	y
archdi	o
archdio	c
archdioc	e
archdioce	s
archdioces	e
archdiocese	s
archdu	ck
archduc	ah
archduca	l
archduch	ey
archduche	s
archduches	s
archduk	e
arche	dnorst
archen	e
archene	m
archenem	y
archeo	lz
archeol	o
archeolo	g
archeolog	iy
archeologi	ces
archeologic	a
archeologica	l
archeologie	s
archeologis	t
archeoz	o
archeozo	i
archeozoi	c
archer	eisy
archere	s
archeres	s
archeri	e
archerie	s
arches	t
archet	y
archety	p
archetyp	aei
archetypa	l
archetypal	l
archetypall	y
archetype	s
archetypi	c
archetypic	a
archetypica	l
archetypical	l
archetypicall	y
archf	o
archfo	o
archfoo	l
archi	belmnptv
archib	a
archiba	l
archibal	d
archim	ae
archima	n
archiman	d
archimand	r
archimandr	i
archimandri	t
archimandrit	e
archime	d
archimed	e
archimede	as
archimedea	n
archin	g
archip	e
archipe	l
archipel	a
archipela	g
archipelag	o
archipelago	es
archipelagoe	s
archit	er
archite	c
architec	t
architect	eiorsu
architecte	d
architecti	n
architectin	g
architecto	nr
architecton	i
architectoni	c
architectr	e
architectre	s
architectres	s
architectu	r
architectur	ae
architectura	l
architectural	il
architecturali	sz
architecturalis	t
architecturaliz	ae
architecturaliza	t
architecturalizat	i
architecturalizati	o
architecturalizatio	n
architecturall	y
architecture	s
architr	a
architra	v
architrav	e
archiv	aei
archiva	l
archive	drs
archiver	s
archivi	ns
archivin	g
archivis	t
archl	eiy
archle	t
archli	n
archlin	u
archlinu	x
archn	e
archne	s
archnes	s
archness	e
archnesse	s
archo	n
archp	r
archpr	i
archpri	e
archprie	s
archpries	t
archw	a
archwa	y
archway	s
arci	n
arcin	g
arck	ei
arcke	d
arcki	n
arckin	g
arcl	i
arcli	k
arclik	e
arco	ag
arcog	r
arcogr	a
arcogra	p
arcograp	h
arcs	i
arcsi	n
arcsin	e
arct	aiu
arcta	n
arctan	g
arctang	e
arctange	n
arctangen	t
arcti	c
arctic	asw
arctica	l
arctical	l
arcticall	y
arcticw	a
arcticwa	r
arcticwar	f
arcticwarf	a
arcticwarfa	r
arcticwarfar	e
arcticwarfare	p
arcticwarfarep	o
arcticwarfarepo	l
arcticwarfarepol	i
arcticwarfarepoli	c
arcticwarfarepolic	e
arctu	r
arctur	u
arcturu	s
arcu	a
arcua	t
arcuat	e
ard	deou
arde	n
arden	ct
ardenc	y
ardent	eln
ardente	rs
ardentes	t
ardentl	y
ardentn	e
ardentne	s
ardentnes	s
ardentness	e
ardentnesse	s
ardo	ru
ardou	r
ardu	io
ardui	n
arduin	o
arduo	u
arduou	s
arduous	ln
arduousl	y
arduousn	e
arduousne	s
arduousnes	s
arduousness	e
arduousnesse	s
are	abnoqs
area	ls
areal	l
areall	y
aren	ao
arena	s
areno	st
arenos	ei
arenosi	t
arenosit	y
areo	l
areol	a
areq	u
arequ	i
arequi	p
arequip	a
arf	abdv
arg	aeiosuvy
arga	l
argal	a
arge	n
argen	t
argent	iux
argenti	fnt
argentif	e
argentife	r
argentifer	o
argentifero	u
argentiferou	s
argentin	aegi
argentini	a
argentinia	n
argentit	e
argentu	m
argi	lv
argil	l
argill	ai
argilla	c
argillac	e
argillace	o
argillaceo	u
argillaceou	s
argilli	t
argillit	e
argiv	e
argo	lnst
argon	ans
argona	u
argonau	t
argonaut	is
argonauti	c
argonn	e
argos	y
argot	is
argoti	c
argu	aefimst
argua	b
arguab	l
arguabl	ey
argue	drs
arguer	s
arguf	y
argui	n
arguin	g
argum	e
argume	n
argumen	t
argument	as
argumenta	lt
argumentat	i
argumentati	ov
argumentatio	n
argumentativ	e
argumentative	ln
argumentativel	y
argumentativen	e
argumentativene	s
argumentativenes	s
argumentativeness	e
argumentativenesse	s
argut	e
argy	r
argyr	o
argyro	l
ari	adeglorstvz
aria	dlns
ariad	n
ariadn	e
arian	i
ariani	s
arianis	mt
arianist	s
arid	eiln
aride	rs
arides	t
aridi	ft
aridif	y
aridit	iy
ariditi	e
ariditie	s
aridl	y
aridn	e
aridne	s
aridnes	s
aridness	e
aridnesse	s
arie	ls
aries	e
ariese	s
arig	h
arigh	t
aril	l
arill	a
arilla	t
arillat	e
ario	s
arios	o
aris	eit
arise	nrs
arisi	n
arisin	g
arising	s
arist	o
aristo	ct
aristoc	r
aristocr	a
aristocra	ct
aristocrac	iy
aristocraci	e
aristocracie	s
aristocrat	is
aristocrati	cz
aristocratic	a
aristocratica	l
aristocratical	l
aristocraticall	y
aristocratiz	e
aristot	el
aristote	l
aristotel	i
aristoteli	a
aristotelia	n
aristotl	e
arit	h
arith	m
arithm	e
arithme	t
arithmet	i
arithmeti	cz
arithmetic	ais
arithmetica	l
arithmetical	l
arithmeticall	y
arithmetici	a
arithmeticia	n
arithmetician	s
arithmetiz	e
arithmetize	ds
ariz	o
arizo	n
arizon	a
arj	qrv
ark	av
arka	n
arkan	s
arkans	a
arkansa	ns
arl	eirv
arle	n
arlen	e
arli	n
arlin	g
arling	t
arlingt	o
arlingto	n
arm	abcefhiloprsy
arma	dgmnt
armad	ai
armadi	l
armadil	l
armadill	o
armadillo	es
armadilloe	s
armag	en
armage	d
armaged	d
armagedd	o
armageddo	n
armagn	a
armagna	c
armam	e
armame	n
armamen	t
armament	s
arman	i
armat	au
armatu	r
armatur	e
armb	a
armba	n
armban	d
armband	s
armc	ho
armch	a
armcha	i
armchai	r
armchair	s
arme	dnrt
armen	i
armeni	a
armenia	n
armer	s
armf	u
armfu	l
armful	s
armh	o
armho	l
armhol	e
armhole	s
armi	egns
armie	s
armig	e
armige	r
armin	g
armis	t
armist	i
armisti	c
armistic	e
armistice	s
arml	eio
armle	st
armles	s
armli	k
armlik	e
armlo	a
armloa	d
armo	inru
armoi	r
armoir	e
armon	k
armor	eiy
armore	dr
armori	a
armoria	l
armou	r
armour	eilsy
armoure	d
armouri	n
armourin	g
armourl	e
armourle	s
armourles	s
armp	i
armpi	t
armpit	s
armr	e
armre	s
armres	t
arms	ft
armsf	u
armsfu	l
armst	r
armstr	o
armstro	n
armstron	g
army	w
armyw	o
armywo	r
armywor	m
arn	biov
arni	c
arnic	a
arno	l
arnol	d
aro	abdmrsuv
aroa	d
arom	a
aroma	lst
aromat	hi
aromath	e
aromathe	r
aromather	a
aromathera	p
aromatherap	eiy
aromatherape	u
aromatherapeu	t
aromatherapeut	i
aromatherapeuti	c
aromatherapi	es
aromatherapie	s
aromatherapis	t
aromatherapist	s
aromati	cz
aromatic	ains
aromatica	l
aromatical	l
aromaticall	y
aromatici	t
aromaticit	iy
aromaticiti	e
aromaticitie	s
aromaticn	e
aromaticne	s
aromaticnes	s
aromaticness	e
aromaticnesse	s
aromatiz	e
aros	e
arou	ns
aroun	d
arous	aei
arousa	bl
arousab	il
arousabi	l
arousabil	i
arousabili	t
arousabilit	iy
arousabiliti	e
arousabilitie	s
arousabl	e
arousal	s
arouse	drs
arouser	s
arousi	n
arousin	g
arp	aefw
arpa	n
arpan	e
arpane	t
arpe	g
arpeg	g
arpegg	i
arpeggi	o
arpeggio	es
arpeggioe	d
arq	u
arqu	e
arque	b
arqueb	u
arquebu	s
arr	aehijloqr
arra	cginsy
arrac	k
arrag	o
arrago	n
arrai	g
arraig	n
arraign	eims
arraigne	dr
arraigner	s
arraigni	n
arraignin	g
arraignm	e
arraignme	n
arraignmen	t
arraignment	s
arran	gt
arrang	ei
arrange	admrs
arrangea	b
arrangeab	l
arrangeabl	e
arrangem	e
arrangeme	n
arrangemen	t
arrangement	s
arranger	s
arrangi	n
arrangin	g
array	aeis
arraya	l
arraye	dr
arrayer	s
arrayi	n
arrayin	g
arre	as
arrea	r
arrear	s
arres	t
arrest	aeimos
arresta	bt
arrestab	l
arrestabl	e
arrestat	i
arrestati	o
arrestatio	n
arreste	dr
arrester	s
arresti	n
arrestin	g
arresting	l
arrestingl	y
arrestm	e
arrestme	n
arrestmen	t
arrestment	s
arresto	r
arrestor	s
arrh	ey
arrhe	n
arrhen	i
arrheni	u
arrheniu	s
arrhy	t
arrhyt	h
arrhyth	m
arrhythm	i
arrhythmi	ac
arri	v
arriv	aei
arriva	ln
arrival	s
arrivan	c
arrivanc	e
arrive	drs
arriver	s
arrivi	n
arrivin	g
arro	gwy
arrog	a
arroga	nt
arrogan	ct
arroganc	e
arrogant	ln
arrogantl	y
arrogantn	e
arrogantne	s
arrogantnes	s
arrogat	ei
arrogate	ds
arrogati	no
arrogatin	g
arrogatio	n
arrow	ehilrsy
arrowe	d
arrowh	e
arrowhe	a
arrowhea	d
arrowhead	s
arrowi	n
arrowin	g
arrowl	ei
arrowle	s
arrowles	s
arrowli	k
arrowlik	e
arrowr	o
arrowro	o
arrowroo	t
arroy	o
arroyo	s
ars	eimot
arse	n
arsen	ai
arsena	l
arsenal	s
arseni	cu
arsenic	as
arsenica	t
arsenicat	e
arsenicate	d
arseniu	r
arseniur	e
arseniure	t
arsi	ns
arsin	e
arso	n
arson	is
arsoni	s
arsonis	t
arsonist	s
art	befhilsuwy
arte	fmrs
artef	a
artefa	c
artefac	t
artefact	su
artefactu	a
artefactua	l
artefactual	l
artefactuall	y
artem	i
artemi	as
arter	iy
arteri	aeot
arteria	l
arterie	s
arterio	gls
arteriog	r
arteriogr	a
arteriogra	p
arteriograp	h
arteriograph	y
arteriol	ae
arteriola	r
arteriole	s
arterios	c
arteriosc	l
arterioscl	e
arterioscle	r
arterioscler	o
arteriosclero	st
arterioscleros	ei
arteriosclerose	s
arteriosclerosi	s
arteriosclerot	i
arterioscleroti	c
arteriosclerotic	s
arterit	i
arteriti	s
artes	i
artesi	a
artesia	n
artf	u
artfu	l
artful	ln
artfull	ey
artfulle	rs
artfulles	t
artfuln	e
artfulne	s
artfulnes	s
artfulness	e
artfulnesse	s
arth	aru
artha	s
arthr	io
arthri	t
arthrit	i
arthriti	cds
arthritid	e
arthritide	s
arthritis	e
arthritise	s
arthro	p
arthrop	o
arthropo	d
arthropod	aos
arthropoda	ln
arthropodo	u
arthropodou	s
arthu	r
arthur	i
arthuri	a
arthuria	n
arti	ceflns
artic	hlu
artich	o
articho	k
artichok	e
artichoke	s
articl	ei
article	ds
articli	n
articlin	g
articu	l
articul	a
articula	t
articulat	eio
articulate	dlns
articulatel	y
articulaten	e
articulatene	s
articulatenes	s
articulateness	e
articulatenesse	s
articulati	nov
articulatin	g
articulatio	n
articulation	s
articulativ	e
articulato	r
articulator	sy
artie	rs
arties	t
artif	ai
artifa	c
artifac	t
artifact	s
artifi	c
artific	aei
artifica	l
artifice	rs
artifici	a
artificia	l
artificial	iln
artificiali	st
artificialis	m
artificialit	iy
artificialiti	e
artificialitie	s
artificiall	y
artificialn	e
artificialne	s
artificialnes	s
artificialness	e
artificialnesse	s
artil	ly
artill	e
artille	r
artiller	iy
artilleri	es
artillerie	s
artilleris	t
artillery	m
artillerym	ae
artilleryma	n
artilleryme	n
artin	e
artine	s
artines	s
artiness	e
artinesse	s
artis	at
artisa	n
artisan	as
artisana	l
artisans	h
artisansh	i
artisanshi	p
artisanship	s
artist	eilrs
artisti	c
artistic	a
artistica	l
artistical	l
artisticall	y
artistl	iy
artistli	k
artistlik	e
artistr	iy
artistri	e
artistrie	s
artl	e
artle	s
artles	s
artu	r
artur	o
artw	o
artwo	r
artwor	k
artwork	s
arty	s
aru	bmpuvy
arub	a
arv	fru
arw	aew
arwe	a
arwea	v
arweav	e
arx	iorsv
arxi	v
ary	adf
arya	n
aryan	s
arz	v
as	abcdefhijklmnopqrstuxy
asa	psv
asb	e
asbe	s
asbes	t
asbest	ou
asbesto	s
asbestos	ei
asbestose	s
asbestosi	s
asbestu	s
asbestus	e
asbestuse	s
asc	eilor
asce	nrt
ascen	cdst
ascenc	e
ascend	aeis
ascenda	bn
ascendab	l
ascendabl	e
ascendan	ct
ascendanc	y
ascende	dnr
ascenden	ct
ascendenc	y
ascender	s
ascendi	bn
ascendib	l
ascendibl	e
ascendin	g
ascens	i
ascensi	o
ascensio	n
ascension	ds
ascensiond	a
ascensionda	y
ascent	s
ascer	t
ascert	a
ascerta	i
ascertai	n
ascertain	aeims
ascertaina	b
ascertainab	l
ascertainabl	ey
ascertaine	dr
ascertainer	s
ascertaini	n
ascertainin	g
ascertainm	e
ascertainme	n
ascertainmen	t
ascertainment	s
ascet	i
asceti	cs
ascetic	ais
ascetica	l
ascetical	l
asceticall	y
ascetici	s
asceticis	m
asceticism	s
ascetis	m
asci	i
ascii	s
ascl	e
ascle	p
asclep	i
asclepi	u
asclepiu	s
asco	t
ascr	i
ascri	bp
ascrib	aei
ascriba	b
ascribab	l
ascribabl	e
ascribe	ds
ascribi	n
ascribin	g
ascrip	t
ascript	i
ascripti	o
ascriptio	n
asd	i
asdi	c
ase	adipqrsvx
asea	n
asei	s
aseis	m
aseism	a
aseisma	t
aseismat	i
aseismati	c
asep	st
aseps	i
asepsi	s
asept	i
asepti	c
aseptic	ais
aseptica	l
aseptical	l
asepticall	y
aseptici	s
asepticis	m
asepticism	s
aser	v
asex	u
asexu	a
asexua	l
asexual	il
asexuali	t
asexualit	iy
asexualiti	e
asexualitie	s
asexuall	y
asf	s
ash	acefilmoprty
asha	mn
asham	e
ashame	d
ashamed	ln
ashamedl	y
ashamedn	e
ashamedne	s
ashamednes	s
ashamedness	e
ashamednesse	s
ashan	t
ashant	i
ashc	ar
ashca	n
ashcr	o
ashcro	f
ashcrof	t
ashe	dnrsv
ashev	i
ashevi	l
ashevil	l
ashevill	e
ashf	o
ashfo	r
ashfor	d
ashi	n
ashin	eg
ashine	s
ashines	s
ashiness	e
ashinesse	s
ashl	aei
ashla	nr
ashlan	d
ashlar	i
ashlari	n
ashlarin	g
ashle	esy
ashles	s
ashli	n
ashlin	g
ashm	ao
ashma	n
ashmo	l
ashmol	e
ashmole	a
ashmolea	n
asho	r
ashor	e
ashp	a
ashpa	n
ashr	a
ashra	m
ashram	s
asht	or
ashto	n
ashtr	a
ashtra	y
ashtray	s
asi	acdlnv
asia	nt
asian	ins
asiani	z
asianiz	e
asiann	e
asianne	s
asiannes	s
asiat	i
asiati	c
asiatic	is
asiatici	z
asiaticiz	ae
asiaticiza	t
asiaticizat	i
asiaticizati	o
asiaticizatio	n
asiaticization	s
asiaticize	s
asic	s
asid	e
aside	s
asil	o
asilo	m
asilom	a
asiloma	r
asin	i
asini	n
asinin	ei
asinini	t
asininit	y
asj	v
ask	aeis
aska	nr
askan	c
askanc	e
askar	i
aske	drw
asker	s
askew	n
askewn	e
askewne	s
askewnes	s
askewness	e
askewnesse	s
aski	n
askin	g
asking	l
askingl	y
asl	aeov
asla	n
aslan	t
asle	e
aslee	p
aslo	p
aslop	e
asm	blr
asmb	v
asn	bfhnoqrstvy
aso	csv
asoc	i
asoci	a
asocia	l
asp	aehis
aspa	r
aspar	a
aspara	g
asparag	iu
asparagi	n
asparagin	o
asparagino	u
asparaginou	s
asparagu	s
asparagus	e
asparaguse	s
aspe	cnrs
aspec	t
aspect	aefs
aspecta	b
aspectab	l
aspectabl	e
aspecte	d
aspectf	u
aspectfu	l
asper	gis
asperg	e
asperge	s
asperi	t
asperit	iy
asperiti	e
asperitie	s
aspers	ei
aspersi	o
aspersio	n
aspersion	s
aspes	t
asph	aeoy
aspha	l
asphal	t
asphalt	eilsu
asphalte	dr
asphalti	cn
asphaltin	g
asphaltl	i
asphaltli	k
asphaltlik	e
asphaltu	m
asphaltum	s
asphe	r
aspher	i
aspheri	c
aspheric	a
aspherica	l
aspherical	l
asphericall	y
aspho	d
asphod	e
asphode	l
asphy	cx
asphyc	t
asphyct	i
asphycti	c
asphyx	i
asphyxi	a
asphyxia	lst
asphyxiat	eio
asphyxiate	ds
asphyxiati	no
asphyxiatin	g
asphyxiatio	n
asphyxiation	s
asphyxiato	r
asphyxiator	s
aspi	cdrs
aspic	s
aspid	i
aspidi	s
aspidis	t
aspidist	r
aspidistr	a
aspir	aei
aspira	nt
aspiran	t
aspirant	s
aspirat	eio
aspirate	ds
aspirati	no
aspiratin	g
aspiratio	n
aspiration	as
aspirationa	l
aspirato	r
aspirator	s
aspire	drs
aspirer	s
aspiri	n
aspirin	gs
aspiring	ln
aspiringl	y
aspiringn	e
aspiringne	s
aspiringnes	s
aspis	h
asq	tu
asqu	i
asqui	n
asquin	t
asr	b
ass	aehilotuy
assa	gimsuy
assag	a
assaga	i
assai	l
assail	aeis
assaila	n
assailan	t
assailant	s
assaile	d
assaili	n
assailin	g
assas	s
assass	i
assassi	n
assassin	as
assassina	t
assassinat	eio
assassinate	ds
assassinati	no
assassinatin	g
assassinatio	n
assassination	s
assassinato	r
assau	l
assaul	t
assault	aeis
assaulta	b
assaultab	l
assaultabl	e
assaulte	dr
assaulter	s
assaulti	n
assaultin	g
assay	eis
assaye	dr
assayi	n
assayin	g
asse	dmnrstv
assem	b
assemb	l
assembl	aeiy
assembla	g
assemblag	e
assemblage	s
assemble	drs
assembler	s
assembli	en
assemblie	s
assemblin	g
assembly	ms
assemblym	a
assemblyma	n
assemblys	c
assemblysc	r
assemblyscr	i
assemblyscri	p
assemblyscrip	t
assen	t
assent	aeimos
assenta	nt
assentan	t
assentat	i
assentati	o
assentatio	n
assente	dr
assenter	s
assenti	env
assentie	n
assentien	t
assentin	g
assenting	l
assentingl	y
assentiv	e
assentive	n
assentiven	e
assentivene	s
assentivenes	s
assentiveness	e
assentivenesse	s
assentm	e
assentme	n
assentmen	t
assento	r
assentor	s
asser	t
assert	aeios
asserta	b
assertab	l
assertabl	e
asserte	dr
asserter	s
asserti	bnov
assertib	il
assertibi	l
assertibil	i
assertibili	t
assertibilit	y
assertibl	e
assertin	g
assertio	n
assertion	as
assertiona	l
assertiv	e
assertive	ln
assertivel	y
assertiven	e
assertivene	s
assertivenes	s
assertiveness	e
assertivenesse	s
asserto	r
assertor	s
asses	s
assess	aeimo
assessa	b
assessab	l
assessabl	e
assesse	ds
assessi	n
assessin	g
assessm	e
assessme	n
assessmen	t
assessment	s
assesso	r
assessor	is
assessori	a
assessoria	l
assessors	h
assessorsh	i
assessorshi	p
assessorship	s
asset	ls
assetl	e
assetle	s
assetles	s
assev	e
asseve	r
assever	a
assevera	t
asseverat	ei
asseverati	no
asseveratin	g
asseverating	l
asseveratingl	y
asseveratio	n
assh	o
assho	l
asshol	e
assi	dfgmsz
assid	u
assidu	io
assidui	t
assiduit	y
assiduo	u
assiduou	s
assiduous	ln
assiduousl	y
assiduousn	e
assiduousne	s
assiduousnes	s
assiduousness	e
assiduousnesse	s
assif	iy
assifi	c
assific	a
assifica	t
assificat	i
assificati	o
assificatio	n
assig	n
assign	aeimos
assigna	b
assignab	il
assignabi	l
assignabil	i
assignabili	t
assignabilit	iy
assignabiliti	e
assignabilitie	s
assignabl	ey
assigne	der
assignee	s
assigner	s
assigni	n
assignin	g
assignm	e
assignme	n
assignmen	t
assignment	s
assigno	r
assignor	s
assim	i
assimi	l
assimil	a
assimila	bt
assimilab	l
assimilabl	e
assimilat	eio
assimilate	ds
assimilati	nov
assimilatin	g
assimilatio	n
assimilation	s
assimilativ	e
assimilative	n
assimilativen	e
assimilativene	s
assimilativenes	s
assimilato	r
assimilator	s
assis	ht
assish	n
assishn	e
assishne	s
assishnes	s
assist	aefios
assista	n
assistan	ct
assistanc	ey
assistance	s
assistant	s
assistants	h
assistantsh	i
assistantshi	p
assistantship	s
assiste	dr
assister	s
assistf	u
assistfu	l
assisti	nv
assistin	g
assistiv	e
assisto	r
assistor	s
assiz	e
assize	s
assl	i
assli	k
asslik	e
asso	cinr
assoc	i
associ	a
associa	bt
associab	l
associabl	e
associat	eio
associate	drs
associates	h
associatesh	i
associateshi	p
associateship	s
associati	nov
associatin	g
associatio	n
association	ais
associationa	l
associationi	s
associationis	t
associationist	i
associationisti	c
associativ	ei
associative	l
associativel	y
associativi	t
associativit	y
associato	r
associator	sy
assoi	l
asson	a
assona	nt
assonan	ct
assonanc	e
assonance	s
assonant	s
assonat	e
assor	t
assort	ems
assorte	d
assorted	n
assortedn	e
assortedne	s
assortednes	s
assortm	e
assortme	n
assortmen	t
assortment	s
assu	amr
assua	gs
assuag	ei
assuage	dmrs
assuagem	e
assuageme	n
assuagemen	t
assuagement	s
assuager	s
assuagi	n
assuagin	g
assuas	i
assuasi	v
assuasiv	e
assum	aeip
assuma	b
assumab	il
assumabi	l
assumabil	i
assumabili	t
assumabilit	iy
assumabiliti	e
assumabilitie	s
assumabl	ey
assume	drs
assumed	l
assumedl	y
assumer	s
assumi	n
assumin	g
assuming	s
assump	t
assumpt	i
assumpti	o
assumptio	n
assumption	s
assur	aei
assura	bn
assurab	l
assurabl	e
assuran	c
assuranc	e
assurance	s
assure	drs
assured	lns
assuredl	y
assuredn	e
assuredne	s
assurednes	s
assuredness	e
assurednesse	s
assurer	s
assuri	n
assurin	g
assuring	l
assuringl	y
assy	r
assyr	i
assyri	ao
assyria	n
assyrian	i
assyriani	z
assyrianiz	e
assyrianize	s
assyrio	l
assyriol	o
assyriolo	g
assyriolog	y
ast	aehioru
asta	irt
astai	r
astair	e
astaire	s
astar	t
astart	e
astat	i
astati	n
astatin	e
aste	r
aster	inos
asteri	s
asteris	km
asterisk	eils
asteriske	d
asteriski	n
asteriskin	g
asteriskl	e
asteriskle	s
asteriskles	s
astero	i
asteroi	d
asteroid	as
asteroida	l
asth	em
asthe	n
asthen	o
astheno	s
asthenos	p
asthenosp	h
asthenosph	e
asthenosphe	r
asthenospher	e
asthm	a
asthma	st
asthmat	i
asthmati	c
asthmatic	as
asthmatica	l
asthmatical	l
asthmaticall	y
asti	gr
astig	m
astigm	ai
astigma	t
astigmat	i
astigmati	s
astigmatis	m
astigmatism	s
astigmi	a
astigmia	s
asto	nru
aston	i
astoni	s
astonis	h
astonish	aeim
astonisha	b
astonishab	l
astonishabl	e
astonishe	drs
astonished	l
astonishedl	y
astonisher	s
astonishi	n
astonishin	g
astonishing	ln
astonishingl	y
astonishingn	e
astonishingne	s
astonishingnes	s
astonishingness	e
astonishingnesse	s
astonishm	e
astonishme	n
astonishmen	t
astonishment	s
astor	i
astori	a
astou	n
astoun	d
astound	eims
astounde	d
astoundi	n
astoundin	g
astounding	l
astoundingl	y
astoundm	e
astoundme	n
astoundmen	t
astoundment	s
astr	aio
astra	degkly
astrad	d
astradd	l
astraddl	e
astrae	a
astrag	a
astraga	l
astragal	u
astragalu	s
astrak	h
astrakh	a
astrakha	n
astri	dno
astrid	e
astrin	g
astring	e
astringe	n
astringen	ct
astringenc	y
astringent	ls
astringentl	y
astrio	n
astrion	i
astrioni	c
astrionic	s
astro	bcglnps
astrob	i
astrobi	o
astrobio	l
astrobiol	o
astrobiolo	g
astrobiolog	y
astroc	o
astroco	m
astrocom	p
astrocomp	a
astrocompa	s
astrocompas	s
astrog	a
astroga	t
astrogat	e
astrol	o
astrolo	g
astrolog	eioy
astrologe	r
astrologer	s
astrologi	aces
astrologia	n
astrologic	a
astrologica	l
astrological	l
astrologicall	y
astrologie	s
astrologis	t
astrologist	s
astrologo	u
astrologou	s
astron	ao
astrona	u
astronau	t
astronaut	is
astronauti	c
astronautic	as
astronautica	l
astrono	m
astronom	eiy
astronome	r
astronomer	s
astronomi	cez
astronomic	a
astronomica	l
astronomical	l
astronomicall	y
astronomie	s
astronomiz	e
astrop	h
astroph	y
astrophy	s
astrophys	i
astrophysi	c
astrophysic	ais
astrophysica	l
astrophysical	l
astrophysicall	y
astrophysici	s
astrophysicis	t
astrophysicist	s
astrophysics	e
astrophysicse	s
astu	t
astut	e
astute	lnrs
astutel	y
astuten	e
astutene	s
astutenes	s
astuteness	e
astutenesse	s
astutes	t
asu	ns
asun	cd
asunc	i
asunci	o
asuncio	n
asund	e
asunde	r
asy	lmno
asyl	u
asylu	m
asylum	s
asym	mp
asymm	e
asymme	t
asymmet	r
asymmetr	iy
asymmetri	c
asymmetric	a
asymmetrica	l
asymmetrical	l
asymmetricall	y
asymp	t
asympt	o
asympto	mt
asymptom	a
asymptoma	t
asymptomat	i
asymptomati	c
asymptomatic	a
asymptomatica	l
asymptomatical	l
asymptomaticall	y
asymptot	ei
asymptote	s
asymptoti	c
asymptotic	a
asymptotica	l
asymptotical	l
asymptoticall	y
asyn	cd
async	h
asynch	r
asynchr	o
asynchro	n
asynchron	ioy
asynchroni	s
asynchronis	m
asynchrono	u
asynchronou	s
asynchronous	l
asynchronousl	y
asynd	e
asynde	t
asyndet	o
asyndeto	n
at	abcdefhijklmnoprstuvwxyz
ata	lrvx
atal	a
atala	n
atalan	t
atalant	a
atar	i
atav	i
atavi	s
atavis	mt
atavist	i
atavisti	c
atax	i
ataxi	c
atc	h
atch	i
atchi	s
atchis	o
atchiso	n
atd	v
ate	elmsv
atel	i
ateli	e
atelie	r
atem	p
atemp	o
atempo	r
atempor	a
atempora	l
ath	aeilvw
atha	b
athab	a
athaba	s
athabas	c
athabasc	a
athabasca	n
athe	inr
athei	s
atheis	mt
atheism	s
atheist	is
atheisti	c
athen	aeis
atheni	a
athenia	n
athenian	s
ather	mo
atherm	a
atherma	n
atherman	c
athermanc	y
athero	s
atheros	c
atherosc	l
atheroscl	e
atheroscle	r
atheroscler	o
atherosclero	s
atheroscleros	i
atherosclerosi	s
athi	r
athir	s
athirs	t
athl	eo
athle	t
athlet	ei
athlete	s
athleti	c
athletic	ais
athletica	l
athletical	l
athleticall	y
athletici	s
athleticis	m
athleticism	s
athletics	e
athleticse	s
athlo	n
athw	a
athwa	r
athwar	t
ati	lnsv
atil	t
atin	g
ating	l
atingl	e
atis	h
atish	o
atisho	o
ativ	a
ativa	n
atk	i
atki	n
atkin	s
atkins	o
atkinso	n
atl	arv
atla	ns
atlan	t
atlant	ai
atlanti	cs
atlantic	a
atlas	e
atlase	s
atm	abos
atma	n
atmb	v
atmo	s
atmos	p
atmosp	h
atmosph	e
atmosphe	r
atmospher	ei
atmosphere	dls
atmospherel	e
atmospherele	s
atmosphereles	s
atmospheri	cn
atmospheric	a
atmospherica	l
atmospherical	l
atmosphericall	y
atmospherin	g
atn	bfqrsv
ato	elmnop
atol	l
atoll	s
atom	isy
atomi	csz
atomic	ais
atomica	l
atomical	l
atomicall	y
atomici	t
atomicit	y
atomis	mt
atomist	i
atomisti	c
atomiz	aei
atomiza	t
atomizat	i
atomizati	o
atomizatio	n
atomize	drs
atomizi	n
atomizin	g
aton	aeiy
atona	bl
atonab	l
atonabl	e
atonal	il
atonali	st
atonalis	mt
atonalism	s
atonalist	is
atonalisti	c
atonalit	iy
atonaliti	e
atonalitie	s
atonall	y
atone	dmrs
atonem	e
atoneme	n
atonemen	t
atoner	s
atoni	cn
atonin	g
atoning	l
atoningl	y
atp	v
atr	eiorv
atre	uy
atreu	s
atrey	u
atri	apu
atria	l
atriu	m
atrium	s
atro	cp
atroc	i
atroci	ot
atrocio	u
atrociou	s
atrocious	ln
atrociousl	y
atrociousn	e
atrociousne	s
atrociousnes	s
atrociousness	e
atrociousnesse	s
atrocit	iy
atrociti	e
atrocitie	s
atrop	ho
atroph	ioy
atrophi	ace
atrophia	st
atrophiat	e
atrophiate	d
atrophie	ds
atropho	u
atrophou	s
atrophy	i
atrophyi	n
atrophyin	g
atropo	s
att	abeilnoru
atta	cir
attac	hk
attach	aeim
attacha	b
attachab	l
attachabl	e
attache	drs
attacher	s
attachi	n
attachin	g
attachm	e
attachme	n
attachmen	t
attachment	s
attack	adeis
attacka	b
attackab	l
attackabl	e
attackd	a
attackda	m
attackdam	a
attackdama	g
attackdamag	e
attackdamage	c
attackdamagec	a
attackdamageca	r
attackdamagecar	r
attackdamagecarr	y
attacke	dr
attacker	s
attacki	n
attackin	g
attai	n
attain	adeimst
attaina	b
attainab	il
attainabi	l
attainabil	i
attainabili	t
attainabilit	iy
attainabiliti	e
attainabilitie	s
attainabl	ey
attainable	n
attainablen	e
attainablene	s
attainablenes	s
attainableness	e
attainablenesse	s
attaind	e
attainde	r
attaine	dr
attainer	s
attaini	n
attainin	g
attainm	e
attainme	n
attainmen	t
attainment	s
atte	mns
attem	p
attemp	et
attempe	r
attempt	aeils
attempta	bt
attemptab	il
attemptabi	l
attemptabil	i
attemptabili	t
attemptabilit	iy
attemptabiliti	e
attemptabilitie	s
attemptabl	e
attemptat	e
attempte	dr
attempter	s
attempti	bn
attemptib	l
attemptibl	e
attemptin	g
attemptl	e
attemptle	s
attemptles	s
atten	dtu
attend	aeis
attenda	n
attendan	ct
attendanc	e
attendance	s
attendant	ls
attendantl	y
attende	der
attendee	s
attender	s
attendi	n
attendin	g
attending	l
attendingl	y
attent	i
attenti	ov
attentio	n
attention	as
attentiona	l
attentional	i
attentionali	t
attentionalit	y
attentiv	e
attentive	ln
attentivel	y
attentiven	e
attentivene	s
attentivenes	s
attentiveness	e
attentivenesse	s
attenu	a
attenua	t
attenuat	eio
attenuate	ds
attenuati	no
attenuatin	g
attenuatio	n
attenuato	r
attenuator	s
attes	t
attest	aeios
attesta	bnt
attestab	l
attestabl	e
attestan	t
attestant	s
attestat	io
attestati	o
attestatio	n
attestation	s
attestato	r
attestator	s
atteste	dr
attester	s
attesti	nv
attestin	g
attestiv	e
attesto	r
attestor	s
atti	clrt
attic	ais
attici	s
atticis	t
attil	a
attir	ei
attire	dmrs
attirem	e
attireme	n
attiremen	t
attiri	n
attirin	g
attit	u
attitu	d
attitud	ei
attitude	s
attitudi	n
attitudin	ai
attitudina	l
attitudini	z
attitudiniz	e
attl	e
attle	e
atto	rs
attor	n
attorn	e
attorne	y
attorney	dis
attorneyd	o
attorneydo	m
attorneyi	s
attorneyis	m
attorneys	h
attorneysh	i
attorneyshi	p
attorneyship	s
attos	e
attose	c
attosec	o
attoseco	n
attosecon	d
attr	ai
attra	c
attrac	t
attract	aeios
attracta	b
attractab	il
attractabi	l
attractabil	i
attractabili	t
attractabilit	y
attractabl	e
attractable	n
attractablen	e
attractablene	s
attractablenes	s
attractableness	e
attractablenesse	s
attracte	dr
attracter	s
attracti	nov
attractin	g
attracting	l
attractingl	y
attractio	n
attraction	as
attractiona	l
attractional	l
attractionall	y
attractiv	ei
attractive	ln
attractivel	y
attractiven	e
attractivene	s
attractivenes	s
attractiveness	e
attractivenesse	s
attractivi	t
attractivit	y
attracto	r
attractor	s
attri	bt
attrib	u
attribu	t
attribut	aeio
attributa	b
attributab	l
attributabl	e
attribute	drs
attributer	s
attributi	nov
attributin	g
attributio	n
attribution	s
attributiv	e
attributive	lns
attributivel	y
attributiven	e
attributivene	s
attributivenes	s
attributiveness	e
attributivenesse	s
attributo	r
attributor	s
attrit	i
attriti	o
attritio	n
attrition	as
attritiona	l
attu	n
attun	ei
attune	ds
attuni	n
attunin	g
atu	rv
atv	s
atw	aforv
atwa	t
atwat	e
atwate	r
atwo	o
atwoo	d
atx	h
aty	p
atyp	i
atypi	c
atypic	a
atypica	l
atypical	il
atypicali	t
atypicalit	iy
atypicaliti	e
atypicalitie	s
atypicall	y
atz	u
atzu	v
au	abcdefgijkmnopqrstuvwxy
aua	v
aub	epru
aube	r
auber	g
auberg	ei
aubergi	n
aubergin	e
aubergine	s
aubr	e
aubre	y
aubu	r
aubur	n
auburn	s
auc	hkt
auck	l
auckl	a
auckla	n
aucklan	d
auct	i
aucti	o
auctio	n
auction	aeis
auctiona	br
auctionab	l
auctionabl	e
auctionar	y
auctione	de
auctionee	r
auctioneer	es
auctioneere	d
auctioni	n
auctionin	g
aud	aimru
auda	c
audac	i
audaci	ot
audacio	u
audaciou	s
audacious	ln
audaciousl	y
audaciousn	e
audaciousne	s
audaciousnes	s
audaciousness	e
audaciousnesse	s
audacit	iy
audaciti	e
audacitie	s
audi	beopt
audib	il
audibi	l
audibil	i
audibili	t
audibilit	iy
audibiliti	e
audibilitie	s
audibl	eiy
audible	dns
audiblen	e
audiblene	s
audiblenes	s
audibleness	e
audiblenesse	s
audibli	n
audiblin	g
audie	n
audien	c
audienc	e
audience	s
audio	bdfglmsv
audiob	o
audiobo	o
audioboo	k
audiobook	s
audiod	i
audiodi	s
audiodis	k
audiodisk	s
audiof	r
audiofr	e
audiofre	q
audiofreq	u
audiofrequ	e
audiofreque	n
audiofrequen	c
audiofrequenc	y
audiog	r
audiogr	a
audiogra	m
audiogram	s
audiol	o
audiolo	g
audiolog	iy
audiologi	cs
audiologic	a
audiologica	l
audiologis	t
audiologist	s
audiom	e
audiome	t
audiomet	er
audiomete	r
audiometer	s
audiometr	iy
audiometri	c
audios	l
audiosl	a
audiosla	v
audioslav	e
audiov	io
audiovi	s
audiovis	u
audiovisu	a
audiovisua	l
audiovo	x
audip	h
audiph	o
audipho	n
audiphon	e
audit	aeiors
audita	b
auditab	il
auditabi	l
auditabil	i
auditabili	t
auditabilit	iy
auditabiliti	e
auditabilitie	s
auditabl	e
audite	de
auditee	s
auditi	nov
auditin	g
auditio	n
audition	eis
auditione	der
auditioner	s
auditioni	n
auditionin	g
auditiv	e
audito	r
auditor	isy
auditori	au
auditoria	l
auditoriu	m
auditorium	s
auditors	h
auditorsh	i
auditorshi	p
auditorship	s
auditr	e
auditre	s
auditres	s
audr	e
audre	y
audu	b
audub	o
audubo	n
aue	rv
auer	b
auerb	a
auerba	c
auerbac	h
auf	d
aug	ehmu
auge	ar
augea	n
auger	s
augh	t
augm	e
augme	n
augmen	t
augment	aeios
augmenta	bt
augmentab	l
augmentabl	e
augmentat	i
augmentati	o
augmentatio	n
augmente	dr
augmenter	s
augmenti	nv
augmentin	g
augmentiv	e
augmento	r
augmentor	s
augu	rs
augur	aeiosy
augura	lt
augurat	e
augure	dr
auguri	n
augurin	g
auguro	u
augurou	s
augurs	h
augursh	i
augurshi	p
augus	t
august	aeilnsu
augusta	n
auguste	rs
augustes	t
augusti	n
augustin	e
augustl	y
augustn	e
augustne	s
augustnes	s
augustness	e
augustnesse	s
augustu	s
auk	l
aukl	e
aukle	t
aun	t
aunt	hilsy
aunth	o
auntho	o
aunthoo	d
aunti	e
auntl	iy
auntli	ek
auntlie	rs
auntlies	t
auntlik	e
aunts	h
auntsh	i
auntshi	p
auq	v
aur	abehimoprsuvw
aura	elst
aural	il
aurali	t
auralit	iy
auraliti	e
auralitie	s
aurall	y
aurat	i
aurati	c
aure	alo
aurea	t
aureat	e
aurel	i
aureli	au
aureliu	s
aureo	lm
aureol	ae
aureom	y
aureomy	c
aureomyc	i
aureomyci	n
auri	cfgs
auric	lu
auricl	e
auricle	ds
auricu	l
auricul	a
auricula	r
aurif	eo
aurife	r
aurifer	o
aurifero	u
auriferou	s
aurifo	r
aurifor	m
aurig	a
auris	t
auro	cru
auroc	h
auroch	s
auror	a
aurora	l
aurou	s
auru	m
aus	cpst
ausc	hu
ausch	w
auschw	i
auschwi	t
auschwit	z
auscu	l
auscul	t
auscult	a
ausculta	t
auscultat	ei
auscultate	ds
auscultati	no
auscultatin	g
auscultatio	n
auscultation	s
ausp	i
auspi	c
auspic	ei
auspice	s
auspici	o
auspicio	u
auspiciou	s
auspicious	ln
auspiciousl	y
auspiciousn	e
auspiciousne	s
auspiciousnes	s
auspiciousness	e
auspiciousnesse	s
auss	i
aussi	e
aust	eir
auste	r
auster	ei
austere	lnrs
austerel	y
austeren	e
austerene	s
austerenes	s
austereness	e
austerenesse	s
austeres	t
austeri	t
austerit	y
austi	n
austr	ai
austra	l
austral	ai
australa	s
australas	i
australasi	a
australasia	n
australi	as
australia	n
australian	is
australiani	z
australianiz	e
australianize	s
austri	a
austria	n
austrian	i
austriani	z
austrianiz	e
austrianize	s
aut	ahinoru
auta	r
autar	ck
autarc	h
autarch	y
autark	y
auth	eo
authe	n
authen	t
authent	i
authenti	c
authentic	ailns
authentica	lt
authentical	ln
authenticall	y
authenticaln	e
authenticalne	s
authenticalnes	s
authenticat	aeio
authenticata	b
authenticatab	l
authenticatabl	e
authenticate	ds
authenticati	no
authenticatin	g
authenticatio	n
authentication	s
authenticato	r
authenticator	s
authentici	t
authenticit	iy
authenticiti	e
authenticitie	s
authenticl	y
authenticn	e
authenticne	s
authenticnes	s
autho	r
author	eils
authore	ds
authores	s
authori	anstz
authoria	l
authorial	l
authoriall	y
authorin	g
authoris	aeim
authorisa	t
authorisat	i
authorisati	o
authorisatio	n
authorise	ds
authorisi	n
authorisin	g
authorit	aiy
authorita	rt
authoritar	i
authoritari	a
authoritaria	n
authoritarian	is
authoritariani	s
authoritarianis	m
authoritarianism	s
authoritat	i
authoritati	v
authoritativ	e
authoritative	ln
authoritativel	y
authoritativen	e
authoritativene	s
authoritativenes	s
authoritativeness	e
authoritativenesse	s
authoriti	e
authoritie	s
authoriz	aei
authoriza	bt
authorizab	l
authorizabl	e
authorizat	i
authorizati	o
authorizatio	n
authorization	s
authorize	drs
authorizer	s
authorizi	n
authorizin	g
authorl	iy
authorli	n
authorlin	g
authors	h
authorsh	i
authorshi	p
auti	s
autis	mt
autism	s
autist	is
autisti	c
autistic	a
autistica	l
autistical	l
autisticall	y
autn	u
autnu	m
autnum	b
autnumb	e
autnumbe	r
auto	abcdefghilmnprstxz
autoa	l
autoal	a
autoala	r
autoalar	m
autob	iru
autobi	o
autobio	g
autobiog	r
autobiogr	a
autobiogra	p
autobiograp	h
autobiograph	eiy
autobiographe	r
autobiographer	s
autobiographi	ces
autobiographic	a
autobiographica	l
autobiographical	l
autobiographicall	y
autobiographie	s
autobiographis	t
autobr	a
autobra	c
autobrac	k
autobrack	e
autobracke	t
autobracket	i
autobracketi	n
autobracketin	g
autobu	s
autoc	aehor
autoca	d
autocad	e
autoce	n
autocen	t
autocent	r
autocentr	i
autocentri	c
autoch	at
autocha	n
autochan	g
autochang	e
autocht	h
autochth	o
autochtho	n
autochthon	ai
autochthona	l
autochthoni	s
autochthonis	m
autoco	dlr
autocod	e
autocol	l
autocoll	i
autocolli	m
autocollim	a
autocollima	t
autocollimat	o
autocollimato	r
autocor	r
autocorr	e
autocorre	l
autocorrel	a
autocorrela	t
autocorrelat	ei
autocorrelati	o
autocorrelatio	n
autocr	ai
autocra	ct
autocrac	iy
autocraci	e
autocracie	s
autocrat	is
autocrati	cs
autocratic	a
autocratica	l
autocratical	l
autocraticall	y
autocratis	m
autocrats	h
autocratsh	i
autocratshi	p
autocri	m
autocrim	e
autod	eiy
autode	cs
autodec	r
autodecr	e
autodecre	m
autodecrem	e
autodecreme	n
autodecremen	t
autodecrement	es
autodecremente	d
autodes	k
autodi	adg
autodia	l
autodial	el
autodiale	r
autodiall	e
autodialle	r
autodid	a
autodida	c
autodidac	t
autodig	e
autodige	s
autodiges	t
autodigest	i
autodigesti	o
autodigestio	n
autody	n
autodyn	e
autoe	m
autoem	i
autoemi	s
autoemis	s
autoemiss	i
autoemissi	o
autoemissio	n
autof	lo
autofl	u
autoflu	o
autofluo	r
autofluor	e
autofluore	s
autofluores	c
autofluoresc	e
autofluoresce	n
autofluorescen	c
autofluorescenc	e
autofo	c
autofoc	u
autofocu	s
autofocus	i
autofocusi	n
autofocusin	g
autog	aeiry
autoga	m
autogam	o
autogamo	u
autogamou	s
autoge	n
autogen	e
autogene	st
autogenes	i
autogenesi	s
autogenet	i
autogeneti	c
autogi	r
autogir	o
autogr	a
autogra	p
autograp	h
autograph	eis
autographe	d
autographi	en
autographie	s
autographin	g
autogy	r
autogyr	o
autoh	oy
autoho	t
autohot	k
autohotk	e
autohotke	y
autohy	p
autohyp	n
autohypn	o
autohypno	s
autohypnos	i
autohypnosi	s
autoi	mn
autoim	m
autoimm	u
autoimmu	n
autoimmun	ei
autoimmuni	tz
autoimmunit	iy
autoimmuniti	e
autoimmunitie	s
autoimmuniz	a
autoimmuniza	t
autoimmunizat	i
autoimmunizati	o
autoimmunizatio	n
autoimmunization	s
autoin	acdfot
autoina	t
autoinat	i
autoinati	c
autoinc	r
autoincr	e
autoincre	m
autoincrem	e
autoincreme	n
autoincremen	t
autoincrement	es
autoincremente	d
autoind	e
autoinde	x
autoindex	i
autoindexi	n
autoindexin	g
autoinf	e
autoinfe	c
autoinfec	t
autoinfect	i
autoinfecti	o
autoinfectio	n
autoino	c
autoinoc	u
autoinocu	l
autoinocul	a
autoinocula	t
autoinoculat	i
autoinoculati	o
autoinoculatio	n
autoint	o
autointo	x
autointox	i
autointoxi	c
autointoxic	a
autointoxica	t
autointoxicat	i
autointoxicati	o
autointoxicatio	n
autol	ao
autola	t
autolat	r
autolatr	y
autolo	ag
autoloa	d
autolog	iy
autologi	c
autologic	a
autologica	l
autom	ao
automa	rt
automar	k
automat	aehio
automata	b
automatab	l
automatabl	e
automate	ds
automati	cnosz
automatic	ais
automatica	l
automatical	l
automaticall	y
automatici	t
automaticit	i
automaticiti	e
automaticitie	s
automatin	g
automatio	n
automation	s
automatis	m
automatiz	e
automato	n
automo	bt
automob	i
automobi	l
automobil	ei
automobile	ds
automobili	nst
automobilin	g
automobilis	t
automobilist	s
automobilit	y
automot	i
automoti	v
automotiv	e
auton	ao
autona	v
autonav	i
autonavi	g
autonavig	a
autonaviga	t
autonavigat	o
autonavigato	r
autonavigator	s
autono	m
autonom	ioy
autonomi	ces
autonomie	s
autonomis	m
autonomo	u
autonomou	s
autonomous	l
autonomousl	y
autop	ahils
autopa	y
autoph	a
autopha	g
autophag	i
autophagi	c
autopi	l
autopil	o
autopilo	t
autopilot	s
autopl	ao
autopla	t
autoplat	e
autoplo	t
autoplot	t
autoplott	e
autoplotte	r
autops	iy
autopsi	es
autopsie	ds
autopsis	t
autopsist	s
autopsy	ci
autopsyc	h
autopsych	o
autopsycho	g
autopsychog	r
autopsychogr	a
autopsychogra	p
autopsychograp	h
autopsychograph	y
autopsyi	n
autopsyin	g
autor	e
autore	g
autoreg	r
autoregr	e
autoregre	s
autoregres	s
autoregress	i
autoregressi	v
autoregressiv	e
autos	aotu
autosa	v
autosav	e
autoso	t
autosot	e
autosote	r
autosoter	i
autosoteri	c
autost	a
autosta	r
autostar	t
autostart	e
autostarte	r
autosu	g
autosug	g
autosugg	e
autosugge	s
autosugges	t
autosuggest	i
autosuggesti	bo
autosuggestib	i
autosuggestibi	l
autosuggestibil	i
autosuggestibili	t
autosuggestibilit	y
autosuggestio	n
autot	horu
autoth	e
autothe	r
autother	a
autothera	p
autotherap	y
autoto	m
autotom	y
autotr	aou
autotra	n
autotran	s
autotrans	fp
autotransf	o
autotransfo	r
autotransfor	m
autotransform	e
autotransforme	r
autotransp	l
autotranspl	a
autotranspla	n
autotransplan	t
autotransplant	a
autotransplanta	t
autotransplantat	i
autotransplantati	o
autotransplantatio	n
autotro	p
autotrop	h
autotru	c
autotruc	k
autotu	n
autotun	e
autox	i
autoxi	d
autoxid	a
autoxida	t
autoxidat	i
autoxidati	o
autoxidatio	n
autoz	ao
autoza	m
autozo	o
autozoo	i
autozooi	d
autu	m
autum	n
autumn	aisy
autumna	l
autumnal	l
autumnall	y
autumni	t
autumnit	y
auu	mtuv
auw	u
aux	i
auxi	ln
auxil	i
auxili	a
auxilia	r
auxiliar	iy
auxiliari	e
auxiliarie	s
auxin	is
auxini	c
auy	v
av	acdefgijlmnorstuxz
ava	ilnrty
avai	l
avail	aeims
availa	b
availab	il
availabi	l
availabil	i
availabili	t
availabilit	iy
availabiliti	e
availabilitie	s
availabl	ey
available	n
availablen	e
availablene	s
availablenes	s
availableness	e
availablenesse	s
availe	dr
availer	s
availi	n
availin	g
availing	l
availingl	y
availm	e
availme	n
availmen	t
aval	ao
avala	n
avalan	c
avalanc	h
avalanch	eiy
avalanche	ds
avalanchi	n
avalanchin	g
avalo	n
avan	t
avar	i
avari	c
avaric	ei
avarice	s
avarici	o
avaricio	u
avariciou	s
avaricious	l
avariciousl	y
avat	a
avata	r
avatar	s
avay	a
avd	p
ave	mnrsx
avem	u
avemu	j
avemuj	i
avemuji	c
avemujic	a
aven	gstu
aveng	ei
avenge	adfmrs
avengea	n
avengean	c
avengeanc	e
avengef	u
avengefu	l
avengem	e
avengeme	n
avengemen	t
avenger	es
avengere	s
avengeres	s
avengi	n
avengin	g
avenging	l
avengingl	y
avent	i
aventi	n
aventin	eo
avenu	e
avenue	s
aver	amnrsty
avera	g
averag	ei
average	adlns
averagea	b
averageab	l
averageabl	e
averagel	y
averagen	e
averagene	s
averagenes	s
averageness	e
averagenesse	s
averagi	n
averagin	g
averm	e
averme	n
avermen	t
avern	u
avernu	s
averr	ei
averre	dr
averri	n
averrin	g
avers	ei
averse	ln
aversel	y
aversen	e
aversene	s
aversenes	s
averseness	e
aversenesse	s
aversi	o
aversio	n
aversion	s
avert	eis
averte	dr
averted	l
avertedl	y
averter	s
averti	n
avertin	g
aves	t
avest	a
avf	v
avi	acdfgorstv
avia	nrt
aviar	iy
aviari	es
aviarie	s
aviaris	t
aviarist	s
aviat	eior
aviati	co
aviatio	n
aviation	s
aviato	r
aviator	s
aviatr	e
aviatre	s
aviatres	s
avic	u
avicu	l
avicul	t
avicult	u
avicultu	r
avicultur	e
avid	eiln
avide	rs
avides	t
avidi	t
avidit	y
avidl	y
avidn	e
avidne	s
avidnes	s
avidness	e
avidnesse	s
avif	a
avifa	u
avifau	n
avifaun	a
avig	n
avign	o
avigno	n
avio	n
avion	i
avioni	c
avionic	s
avir	au
aviru	l
avirul	e
avirule	n
avirulen	t
avis	o
avit	ar
avita	m
avitam	i
avitami	n
avitamin	o
avitamino	s
avitaminos	i
avitaminosi	s
avitr	i
avitri	c
avitric	e
avj	v
avm	b
avn	v
avo	cgimnuw
avoc	ae
avoca	dt
avocad	o
avocado	es
avocadoe	s
avocat	i
avocati	o
avocatio	n
avocation	as
avocationa	l
avoce	t
avog	a
avoga	d
avogad	r
avogadr	o
avoi	dr
avoid	aeils
avoida	bln
avoidab	l
avoidabl	ey
avoidan	c
avoidanc	e
avoide	dr
avoider	s
avoidi	n
avoidin	g
avoidl	e
avoidle	s
avoidles	s
avoir	d
avoird	u
avoirdu	p
avoirdup	o
avoirdupo	i
avoirdupoi	s
avou	c
avouc	h
avow	aeis
avowa	bln
avowab	l
avowabl	ey
avowable	n
avowablen	e
avowablene	s
avowablenes	s
avowan	t
avowe	dr
avowed	l
avowedl	y
avower	s
avowi	n
avowin	g
avr	i
avri	l
avs	i
avu	ln
avul	s
avuls	i
avulsi	o
avulsio	n
avun	c
avunc	u
avuncu	l
avuncul	a
avuncula	r
aw	abdefhijklnoprswxy
awa	ikrsy
awai	t
await	eis
awaite	dr
awaiter	s
awaiti	n
awaitin	g
awak	ei
awake	adnrs
awakea	b
awakeab	l
awakeabl	e
awaken	aeims
awakena	b
awakenab	l
awakenabl	e
awakene	dr
awakener	s
awakeni	n
awakenin	g
awakening	ls
awakeningl	y
awakenm	e
awakenme	n
awakenmen	t
awaki	n
awakin	g
awar	de
award	aeis
awarda	b
awardab	il
awardabi	l
awardabil	i
awardabili	t
awardabilit	iy
awardabiliti	e
awardabilitie	s
awardabl	e
awarde	der
awardee	s
awarder	s
awardi	n
awardin	g
aware	nrs
awaren	e
awarene	s
awarenes	s
awareness	e
awarenesse	s
awares	t
awas	h
away	eins
awaye	d
awayi	n
awayin	g
awayn	e
awayne	s
awaynes	s
awayness	e
awaynesse	s
awd	m
awe	adilst
awea	rt
awear	y
aweat	h
aweath	e
aweathe	r
awei	g
aweig	h
awel	e
awele	s
aweles	s
awes	o
aweso	m
awesom	e
awesome	lnrs
awesomel	y
awesomen	e
awesomene	s
awesomenes	s
awesomeness	e
awesomenesse	s
awesomes	t
awet	o
awf	u
awfu	l
awful	ln
awfull	ey
awfulle	rs
awfulles	t
awfuln	e
awfulne	s
awfulnes	s
awfulness	e
awfulnesse	s
awh	i
awhi	lr
awhil	e
awhir	l
awi	n
awin	g
awk	w
awkw	a
awkwa	r
awkwar	d
awkward	eiln
awkwarde	rs
awkwardes	t
awkwardi	s
awkwardis	h
awkwardl	y
awkwardn	e
awkwardne	s
awkwardnes	s
awkwardness	e
awkwardnesse	s
awl	ks
awn	cfilrsvw
awni	n
awnin	g
awning	es
awninge	d
awo	klsv
awok	e
awoke	n
awol	s
awp	t
awr	iy
awri	e
awrie	rs
awries	t
aww	b
awy	u
ax	abdefghijklmnopqrstuvx
axa	u
axe	dlrsv
axer	s
axf	p
axi	alnosz
axia	l
axial	l
axiall	y
axil	l
axill	a
axilla	r
axillar	y
axin	g
axio	lm
axiol	o
axiolo	g
axiolog	i
axiologi	c
axiologic	a
axiologica	l
axiom	as
axioma	t
axiomat	i
axiomati	cz
axiomatic	a
axiomatica	l
axiomatical	l
axiomaticall	y
axiomatiz	aei
axiomatiza	t
axiomatizat	i
axiomatizati	o
axiomatizatio	n
axiomatization	s
axiomatize	ds
axiomatizi	n
axiomatizin	g
axis	ey
axise	ds
axisy	m
axisym	m
axisymm	e
axisymme	t
axisymmet	r
axisymmetr	y
axl	e
axle	dst
axlet	r
axletr	e
axletre	e
axm	abe
axma	n
axn	f
axo	lnv
axol	o
axolo	t
axolot	l
axolotl	s
axon	os
axono	m
axonom	p
axonomp	e
axonompe	t
axonompet	r
axonompetr	y
axr	bv
axt	u
axu	fprsv
axur	e
axx	frsv
ay	abefhijlmnoprtuvwxy
aya	ht
ayat	o
ayato	l
ayatol	l
ayatoll	a
ayatolla	h
ayatollah	s
ayb	gpwy
aye	dforsv
ayer	s
ayf	bq
ayh	pv
ayl	ek
ayle	s
ayles	b
aylesb	u
aylesbu	r
aylesbur	y
aym	b
ayn	f
ayo	bkqtv
ayp	dfkz
ayr	py
ayu	f
ayy	arvy
az	adefhijlmnoqrtuxz
aza	ls
azal	e
azale	a
azalea	s
azd	j
aze	dqr
azer	b
azerb	a
azerba	i
azerbai	j
azerbaij	a
azerbaija	n
azh	v
azi	lm
azil	i
azili	a
azilia	n
azim	u
azimu	t
azimut	h
azimuth	as
azimutha	l
azj	sv
azm	b
azn	v
azo	finrtvx
azoi	c
azon	i
azoni	c
azor	e
azore	s
azot	ei
azoti	c
azq	dfh
azr	i
azri	a
azt	e
azte	c
aztec	a
azteca	n
azu	rv
azur	eiy
azure	s
azuri	t
azurit	e
