d	abcdefghijklmnopqrstuvwxyz
da	abcdefghijklmnopqrstuvwxyz
daa	frsv
dab	bs
dabb	eil
dabbe	dr
dabber	s
dabbi	n
dabbin	g
dabbl	ei
dabble	drs
dabbli	n
dabblin	g
dabbling	l
dabblingl	y
dac	cehort
dacc	a
dach	s
dachs	h
dachsh	u
dachshu	n
dachshun	d
dachshund	es
daco	i
dacoi	t
dacr	o
dacro	n
dact	y
dacty	l
dactyl	io
dactyli	c
dactylo	l
dactylol	o
dactylolo	g
dactylolog	y
dad	adeopsz
dada	i
dadai	s
dadais	mt
dadaist	i
dadaisti	c
dadd	iy
daddi	e
daddie	ds
daddy	i
daddyi	n
daddyin	g
dae	dmvw
daed	a
daeda	l
daedal	u
daedalu	s
daem	o
daemo	n
daemon	s
daew	o
daewo	o
daf	frtv
daff	oy
daffo	d
daffod	i
daffodi	l
daffodil	s
daft	eiln
dafte	rs
daftes	t
dafti	e
daftl	y
daftn	e
daftne	s
daftnes	s
daftness	e
daftnesse	s
dag	gou
dagg	el
dagge	r
dagger	eils
daggere	d
daggeri	n
daggerin	g
daggerl	i
daggerli	k
daggerlik	e
daggl	e
dagu	e
dague	r
daguer	r
daguerr	e
daguerre	o
daguerreo	t
daguerreot	y
daguerreoty	p
daguerreotyp	e
dah	lov
dahl	i
dahli	a
daho	m
dahom	e
dahome	y
dai	klmnqrs
daik	i
daiki	n
dail	eiy
daile	y
daili	en
dailie	rs
dailies	t
dailin	e
dailine	s
dailines	s
daim	l
daiml	e
daimle	r
dain	t
daint	iy
dainti	eln
daintie	rs
dainties	t
daintil	y
daintin	e
daintine	s
daintines	s
daintiness	e
daintinesse	s
daiq	u
daiqu	i
daiqui	r
daiquir	i
dair	iy
dairi	e
dairie	rs
dairies	t
dairy	lm
dairyl	e
dairyle	a
dairym	a
dairyma	i
dairymai	d
dais	iy
daisi	e
daisie	ds
daisy	ds
daisyd	i
daisydi	s
daisydis	k
daj	qvw
dak	ao
daka	r
dako	t
dakot	a
dal	ehilmtyz
dale	sy
dalh	o
dalho	u
dalhou	s
dalhous	i
dalhousi	e
dall	aiy
dalla	s
dalli	a
dallia	n
dallian	c
dallianc	e
dalm	a
dalma	t
dalmat	i
dalmati	a
dalmatia	n
dalt	o
dalto	n
dalz	e
dalze	l
dalzel	l
dam	aegimnops
dama	gs
damag	ei
damage	admrs
damagea	b
damageab	il
damageabi	l
damageabil	i
damageabili	t
damageabilit	iy
damageabiliti	e
damageabilitie	s
damageabl	e
damageable	n
damageablen	e
damageablene	s
damageablenes	s
damageableness	e
damageablenesse	s
damagem	e
damageme	n
damagemen	t
damager	s
damagi	n
damagin	g
damaging	l
damagingl	y
damas	ck
damasc	u
damascu	s
dame	s
damg	l
damgl	i
damgli	n
damglin	g
dami	e
damie	n
damm	ei
damme	d
dammi	n
dammin	g
damn	aeis
damna	bt
damnab	l
damnabl	ey
damnat	i
damnati	o
damnatio	n
damne	drs
damner	s
damnes	t
damni	fn
damnif	iy
damnifi	c
damnific	a
damnifica	t
damnificat	i
damnificati	o
damnificatio	n
damnin	g
damning	ln
damningl	y
damningn	e
damningne	s
damningnes	s
damningness	e
damningnesse	s
damo	cn
damoc	l
damocl	e
damocle	as
damoclea	n
damp	eilnsy
dampe	dnrs
dampen	eis
dampene	dr
dampener	s
dampeni	n
dampenin	g
dampes	t
dampi	ns
dampin	g
dampis	h
dampish	ln
dampishl	y
dampishn	e
dampishne	s
dampishnes	s
dampishness	e
dampishnesse	s
dampl	y
dampn	e
dampne	s
dampnes	s
dampness	e
dampnesse	s
dams	eo
damse	l
damsel	fs
damself	l
damselfl	y
damso	n
damson	s
dan	abcdegiknstuvz
danb	u
danbu	r
danbur	y
danc	ei
dance	adrsy
dancea	b
danceab	l
danceabl	e
dancer	esy
dancere	s
danceres	s
danci	n
dancin	g
dancing	s
dand	eilry
dande	lr
dandel	i
dandeli	o
dandelio	n
dandelion	s
dandi	f
dandif	iy
dandifi	e
dandifie	d
dandl	e
dandr	iu
dandri	f
dandrif	f
dandriff	sy
dandru	f
dandruf	f
dandruff	sy
dandy	i
dandyi	s
dandyis	m
dane	gls
daneg	e
danege	l
danegel	d
danel	a
danela	w
dang	del
dangd	a
dangda	n
dangdan	g
dange	r
danger	efilos
dangere	d
dangerf	u
dangerfu	l
dangeri	n
dangerin	g
dangerl	e
dangerle	s
dangerles	s
dangero	u
dangerou	s
dangerous	ln
dangerousl	y
dangerousn	e
dangerousne	s
dangerousnes	s
dangerousness	e
dangerousnesse	s
dangers	o
dangerso	m
dangersom	e
dangl	eiy
dangle	dmrs
danglem	e
dangleme	n
danglemen	t
dangler	s
dangli	n
danglin	g
dani	esz
danie	l
daniel	ls
daniell	e
daniels	o
danielso	n
danis	h
daniz	ae
daniza	t
danizat	i
danizati	o
danizatio	n
danization	s
danize	s
dank	eilny
danke	rs
dankes	t
danki	s
dankis	h
dankl	y
dankn	e
dankne	s
danknes	s
dankness	e
danknesse	s
dann	y
dans	ek
danse	u
danseu	s
danseus	e
dant	e
dante	a
dantea	n
danu	b
danub	ei
danubi	a
danubia	n
danv	i
danvi	l
danvil	l
danvill	e
danz	i
danzi	g
dao	b
dap	abhmpuz
daph	n
daphn	ei
daphni	a
dapp	els
dappe	r
dappl	e
dapple	d
daq	nqy
daqn	v
daqy	v
dar	bcefiklnprtuw
darb	y
darc	u
darcu	l
darcul	a
dare	drs
dared	e
darede	v
daredev	i
daredevi	l
daredevil	rst
daredevilr	i
daredevilri	e
daredevilrie	s
daredevilt	r
daredeviltr	i
daredeviltri	e
daredeviltrie	s
darer	s
dares	a
daresa	y
darf	u
darfu	r
dari	nu
darin	g
daring	lns
daringl	y
daringn	e
daringne	s
daringnes	s
daringness	e
daringnesse	s
dariu	s
dark	efilnrsy
darke	dnrs
darken	eis
darkene	dr
darkener	s
darkeni	n
darkenin	g
darkes	t
darkf	u
darkfu	l
darki	ns
darkin	g
darkis	h
darkl	eiy
darkli	en
darklie	rs
darklies	t
darklin	g
darkn	e
darkne	s
darknes	s
darkness	e
darknesse	s
darkr	o
darkro	o
darkroo	m
darkroom	s
darks	o
darkso	m
darksom	e
darl	ei
darle	n
darlen	e
darli	n
darlin	g
darling	elnst
darlinge	rs
darlinges	t
darlingl	y
darlingn	e
darlingne	s
darlingnes	s
darlingness	e
darlingnesse	s
darlingt	o
darlingto	n
darn	aeis
darna	t
darnat	i
darnati	o
darnatio	n
darne	dlrs
darner	s
darnes	t
darni	n
darnin	g
darp	a
darr	eoy
darre	ln
darrel	l
darro	w
dart	ehims
darte	dr
darti	n
dartin	g
darting	ln
dartingl	y
dartingn	e
dartingne	s
dartingnes	s
dartingness	e
dartingnesse	s
dartm	o
dartmo	u
dartmou	t
dartmout	h
daru	s
darus	s
daruss	a
darussa	l
darussal	a
darussala	m
darw	i
darwi	n
darwin	i
darwini	asz
darwinia	n
darwinis	mt
darwinist	i
darwinisti	c
darwiniz	e
darwinize	s
das	eht
dash	beip
dashb	o
dashbo	a
dashboa	r
dashboar	d
dashboard	s
dashe	drs
dasher	s
dashi	n
dashin	g
dashing	l
dashingl	y
dashp	o
dashpo	t
dast	a
dasta	r
dastar	d
dat	aeisu
data	beglmst
datab	ael
databa	s
databas	ei
database	ds
databasi	n
databasin	g
databe	n
databen	d
databl	e
datable	n
datablen	e
datablene	s
datablenes	s
datableness	e
datablenesse	s
datae	a
dataea	s
dataeas	e
datag	r
datagr	ai
datagra	mp
datagram	s
datagrap	h
datagri	p
datal	o
datalo	r
datalor	e
datam	ae
datama	t
datamat	i
datamati	o
datamatio	n
datame	d
datamed	i
datamedi	a
datas	ehp
datase	t
dataset	s
datash	e
datashe	e
datashee	t
datasp	e
dataspe	l
dataspel	l
datat	y
dataty	p
datatyp	e
date	abdlmrst
datea	b
dateab	l
dateabl	e
dateable	n
dateablen	e
dateablene	s
dateablenes	s
dateableness	e
dateablenesse	s
dateb	ao
dateba	s
datebas	e
datebo	o
dateboo	k
datebook	s
dated	ln
datedl	y
datedn	e
datedne	s
datednes	s
datedness	e
datednesse	s
datel	i
dateli	n
datelin	e
datem	a
datema	r
datemar	k
dater	s
datet	i
dateti	m
datetim	e
dati	nv
datin	g
dativ	ae
dativa	l
dative	ls
dativel	y
dats	u
datsu	n
datu	mr
datum	s
datur	a
dau	bgnp
daub	eisy
daube	dr
dauber	s
daubi	en
daubie	rs
daubies	t
daubin	g
daubing	l
daubingl	y
daug	h
daugh	et
daughe	r
daugher	t
daughert	y
daught	e
daughte	r
daughter	ls
daughterl	eiy
daughterle	s
daughterles	s
daughterli	k
daughterlik	e
daun	t
daunt	eilos
daunte	dr
daunti	n
dauntin	g
daunting	ln
dauntingl	y
dauntingn	e
dauntingne	s
dauntingnes	s
dauntingness	e
dauntingnesse	s
dauntl	e
dauntle	s
dauntles	s
daunto	n
daup	h
dauph	i
dauphi	n
dauphin	e
dauphine	s
dauphines	s
dav	eiy
dave	ny
daven	p
davenp	o
davenpo	r
davenpor	t
davi	denst
david	s
davids	o
davidso	n
davie	s
davin	i
davini	c
davinic	h
davis	o
daviso	n
daw	dnrsv
dawd	l
dawdl	ei
dawdle	drs
dawdler	s
dawdli	n
dawdlin	g
dawdling	l
dawdlingl	y
dawn	eils
dawne	d
dawni	n
dawnin	g
dawnl	i
dawnli	k
dawnlik	e
daws	o
dawso	n
day	bcdflorstv
dayb	eor
daybe	d
daybo	o
dayboo	k
daybr	e
daybre	a
daybrea	k
daybreak	s
dayc	a
dayca	r
daycar	e
dayd	r
daydr	e
daydre	a
daydrea	m
daydream	eilsty
daydreame	dr
daydreamer	s
daydreami	n
daydreamin	g
daydreaml	i
daydreamli	k
daydreamlik	e
dayf	l
dayfl	y
dayl	eio
dayle	s
dayles	s
dayli	gt
daylig	h
dayligh	t
daylight	es
daylighte	d
daylo	n
daylon	g
dayo	n
dayon	e
days	t
dayst	a
daysta	r
daystar	t
dayt	io
dayti	m
daytim	e
dayto	n
dayton	a
daz	eiyz
daze	ds
dazed	ln
dazedl	y
dazedn	e
dazedne	s
dazednes	s
dazedness	e
dazednesse	s
dazi	n
dazin	g
dazz	l
dazzl	ei
dazzle	dmrs
dazzlem	e
dazzleme	n
dazzlemen	t
dazzler	s
dazzli	n
dazzlin	g
dazzling	ls
dazzlingl	y
db	abdehiklmnquv
dba	rsv
dbas	e
dbb	e
dbd	fsvw
dbe	af
dbea	v
dbeav	e
dbeave	r
dbh	i
dbk	ikr
dbm	ersvx
dbme	s
dbmes	h
dbn	f
dbq	jp
dbu	e
dbv	v
dc	acdefjlnorsuvw
dca	r
dcar	d
dcd	j
dce	b
dcf	v
dcl	v
dcn	v
dcr	adfw
dcu	a
dcw	c
dd	abcdefgijlmnopqrstuvxy
dda	rv
ddb	s
ddc	r
ddcr	v
ddd	ghkmrsuv
dddm	v
dddu	v
dde	mv
ddf	v
ddi	l
ddil	v
ddl	s
ddm	b
ddmb	v
ddn	glmv
ddo	fkrsv
ddp	rv
ddq	flw
ddql	v
ddr	kw
ddt	s
ddu	mp
ddv	m
de	abcdefghijklmnopqrstuvwxz
dea	cdflnrstuw
deac	cot
deacc	e
deacce	n
deaccen	t
deaccent	u
deaccentu	a
deaccentua	t
deaccentuat	o
deaccentuato	r
deaco	n
deacon	aehis
deacona	t
deaconat	e
deacone	ds
deacones	s
deaconh	o
deaconho	o
deaconhoo	d
deaconi	n
deaconin	g
deacons	h
deaconsh	i
deaconshi	p
deaconship	s
deact	i
deacti	v
deactiv	a
deactiva	t
deactivat	ei
deactivati	o
deactivatio	n
dead	befhilnpsw
deadb	eo
deadbe	a
deadbea	t
deadbeat	s
deadbo	r
deadbor	n
deade	nrsy
deaden	eis
deadene	dr
deadener	s
deadeni	n
deadenin	g
deadening	l
deadeningl	y
deades	t
deadey	e
deadf	a
deadfa	l
deadfal	l
deadh	e
deadhe	a
deadhea	d
deadi	s
deadis	h
deadl	ioy
deadli	egln
deadlie	rs
deadlies	t
deadlig	h
deadligh	t
deadlil	y
deadlin	ei
deadline	ds
deadlines	s
deadliness	e
deadlinesse	s
deadlini	n
deadlinin	g
deadlo	c
deadloc	k
deadlock	eis
deadlocke	d
deadlocki	n
deadlockin	g
deadn	e
deadne	s
deadnes	s
deadness	e
deadnesse	s
deadp	a
deadpa	n
deadpan	ns
deadpann	ei
deadpanne	dr
deadpanner	s
deadpanni	n
deadpannin	g
deadw	eo
deadwe	i
deadwei	g
deadweig	h
deadweigh	t
deadwo	o
deadwoo	d
deaf	eiln
deafe	nrs
deafen	eis
deafene	d
deafeni	n
deafenin	g
deafening	s
deafes	t
deafi	s
deafis	h
deafl	y
deafn	e
deafne	s
deafnes	s
deafness	e
deafnesse	s
deal	aeilst
deala	b
dealab	l
dealabl	e
deale	r
dealer	s
dealers	h
dealersh	i
dealershi	p
deali	n
dealin	g
dealing	s
deall	o
deallo	c
dealloc	a
dealloca	t
deallocat	ei
deallocate	ds
deallocati	no
deallocatin	g
deallocatio	n
deallocation	s
dealt	i
dealti	m
dealtim	e
dean	eins
deane	drs
deaner	y
deanes	s
deani	n
deanin	g
deann	a
deans	h
deansh	i
deanshi	p
deanship	s
dear	belnsty
dearb	o
dearbo	r
dearbor	n
deare	rs
deares	t
dearl	y
dearn	e
dearne	s
dearnes	s
dearness	e
dearnesse	s
deart	h
dearth	s
deas	i
deasi	l
deat	h
death	bdflstw
deathb	el
deathbe	d
deathbl	o
deathblo	w
deathd	a
deathda	y
deathf	u
deathfu	l
deathl	iy
deathli	ekn
deathlie	rs
deathlies	t
deathlik	e
deathlin	eg
deathline	s
deathlines	s
deathliness	e
deathlinesse	s
deatht	r
deathtr	a
deathtra	p
deathw	a
deathwa	t
deathwat	c
deathwatc	h
deau	t
deaut	h
deauth	o
deautho	r
deauthor	i
deauthori	z
deauthoriz	ei
deauthorize	ds
deauthorizi	n
deauthorizin	g
deaw	o
deawo	o
deb	abeiortu
deba	crstu
debac	l
debacl	e
debar	k
debark	a
debarka	t
debarkat	i
debarkati	o
debarkatio	n
debas	ei
debase	dmrs
debased	n
debasedn	e
debasedne	s
debasednes	s
debasedness	e
debasednesse	s
debasem	e
debaseme	n
debasemen	t
debasement	s
debaser	s
debasi	n
debasin	g
debasing	l
debasingl	y
debat	aei
debata	b
debatab	l
debatabl	ey
debate	dmrs
debatem	e
debateme	n
debatemen	t
debatement	s
debater	s
debati	n
debatin	g
debating	l
debatingl	y
debau	c
debauc	h
debauch	e
debauche	der
debauched	ln
debauchedl	y
debauchedn	e
debauchedne	s
debauchednes	s
debauchedness	e
debauchednesse	s
debaucher	y
debb	iy
debbi	e
debe	n
deben	t
debent	u
debentu	r
debentur	e
debi	alt
debia	n
debil	i
debili	t
debilit	ay
debilita	nt
debilitan	t
debilitant	s
debilitat	ei
debilitate	ds
debilitati	nov
debilitatin	g
debilitating	l
debilitatingl	y
debilitatio	n
debilitation	s
debilitativ	e
debit	aeis
debita	b
debitab	l
debitabl	e
debite	d
debiti	n
debitin	g
debo	nru
debon	a
debona	i
debonai	r
debor	a
debora	h
debou	cn
debouc	h
debouch	u
debouchu	r
debouchur	e
deboun	c
debounc	ei
debounci	n
debouncin	g
debr	ai
debri	des
debrid	e
debrie	f
debris	e
debrise	s
debt	los
debtl	e
debtle	s
debtles	s
debto	r
debtor	s
debtors	h
debtorsh	i
debtorshi	p
debu	fgnst
debuf	f
debug	gis
debugg	ei
debugge	dr
debugger	s
debuggi	n
debuggin	g
debugi	n
debugin	f
debuginf	o
debun	ck
debunc	h
debunch	i
debunchi	n
debunchin	g
debus	s
debuss	y
debut	a
debuta	n
debutan	t
debutant	e
dec	acehiklnorst
deca	dfghlmnpsty
decad	aei
decada	l
decade	ns
decaden	ct
decadenc	e
decadence	s
decadent	l
decadentl	y
decadi	c
decaf	f
decaff	e
decaffe	i
decaffei	n
decaffein	a
decaffeina	t
decaffeinat	ei
decaffeinate	d
decaffeinati	o
decaffeinatio	n
decag	o
decago	n
decagon	a
decagona	l
decah	ey
decahe	d
decahed	r
decahedr	o
decahedro	n
decahy	d
decahyd	r
decahydr	o
decahydro	n
decahydron	a
decahydrona	p
decahydronap	h
decahydronaph	t
decahydronapht	h
decahydronaphth	a
decahydronaphtha	l
decahydronaphthal	e
decahydronaphthale	n
decahydronaphthalen	e
decal	cs
decalc	i
decalci	f
decalcif	y
decam	ep
decame	r
decamer	io
decameri	c
decamero	n
decan	dgt
decand	r
decandr	o
decandro	u
decandrou	s
decang	u
decangu	l
decangul	a
decangula	r
decant	aeis
decanta	t
decantat	i
decantati	o
decantatio	n
decantation	s
decante	d
decanti	n
decantin	g
decap	hilo
decaph	y
decaphy	l
decaphyl	l
decaphyll	o
decaphyllo	u
decaphyllou	s
decapi	t
decapit	a
decapita	t
decapitat	eio
decapitate	ds
decapitati	no
decapitatin	g
decapitatio	n
decapitation	s
decapitato	r
decapitator	s
decapl	o
decaplo	i
decaploi	d
decapo	d
decas	y
decasy	l
decasyl	l
decasyll	a
decasylla	b
decasyllab	il
decasyllabi	c
decasyllabl	e
decat	ehu
decate	g
decateg	o
decatego	r
decategor	i
decategori	z
decategoriz	aei
decategoriza	t
decategorizat	i
decategorizati	o
decategorizatio	n
decategorization	s
decategorize	ds
decategorizi	n
decategorizin	g
decath	l
decathl	o
decathlo	n
decathlon	s
decatu	r
decay	aeils
decaya	b
decayab	l
decayabl	e
decaye	dr
decayed	n
decayedn	e
decayedne	s
decayednes	s
decayer	s
decayi	n
decayin	g
decayl	e
decayle	s
decayles	s
decc	a
dece	adilmnpr
decea	s
deceas	ei
decease	ds
deceasi	n
deceasin	g
deced	e
decede	n
deceden	t
decei	tv
deceit	fs
deceitf	u
deceitfu	l
deceitful	ln
deceitfull	y
deceitfuln	e
deceitfulne	s
deceitfulnes	s
deceitfulness	e
deceitfulnesse	s
deceiv	aei
deceiva	b
deceivab	il
deceivabi	l
deceivabil	i
deceivabili	t
deceivabilit	i
deceivabiliti	e
deceivabilitie	s
deceivabl	ey
deceivable	n
deceivablen	e
deceivablene	s
deceivablenes	s
deceivableness	e
deceivablenesse	s
deceive	drs
deceiver	s
deceivi	n
deceivin	g
deceiving	l
deceivingl	y
decel	e
decele	r
deceler	a
decelera	t
decelerat	ei
decelerate	ds
decelerati	no
deceleratin	g
deceleratio	n
decem	bv
decemb	e
decembe	r
december	s
decemv	i
decemvi	r
decen	cnt
decenc	iy
decenci	e
decencie	s
decenn	i
decenni	a
decennia	l
decent	eilnr
decente	s
decentes	t
decenti	s
decentis	h
decentl	y
decentn	e
decentne	s
decentnes	s
decentness	e
decentnesse	s
decentr	a
decentra	l
decentral	i
decentrali	sz
decentralis	e
decentraliz	ae
decentraliza	t
decentralizat	i
decentralizati	o
decentralizatio	n
decentralize	d
decep	t
decept	i
decepti	ov
deceptio	n
deception	as
deceptiona	l
deceptiv	e
deceptive	ln
deceptivel	y
deceptiven	e
deceptivene	s
deceptivenes	s
deceptiveness	e
deceptivenesse	s
decer	t
decert	i
decerti	f
decertif	y
dech	a
decha	r
dechar	g
decharg	e
deci	bdlmpsv
decib	e
decibe	l
decibel	s
decid	aeiu
decida	b
decidab	il
decidabi	l
decidabil	i
decidabili	t
decidabilit	iy
decidabiliti	e
decidabilitie	s
decidabl	e
decide	drs
decided	ln
decidedl	y
decidedn	e
decidedne	s
decidednes	s
decidedness	e
decidednesse	s
decider	s
decidi	n
decidin	g
decidu	o
deciduo	u
deciduou	s
deciduous	ln
deciduousl	y
deciduousn	e
deciduousne	s
deciduousnes	s
deciduousness	e
deciduousnesse	s
decil	o
decilo	g
decim	ae
decima	lt
decimal	ils
decimali	sz
decimalis	e
decimaliz	ae
decimaliza	t
decimalizat	i
decimalizati	o
decimalizatio	n
decimall	y
decimat	eio
decimate	ds
decimati	no
decimatin	g
decimatio	n
decimation	s
decimato	r
decimator	s
decime	t
decimet	er
decimete	r
decimetr	ei
decimetre	s
decimetri	c
decip	h
deciph	e
deciphe	r
decipher	aeims
deciphera	b
decipherab	il
decipherabi	l
decipherabil	i
decipherabili	t
decipherabilit	iy
decipherabiliti	e
decipherabilitie	s
decipherabl	e
deciphere	dr
decipherer	s
decipheri	n
decipherin	g
decipherm	e
decipherme	n
deciphermen	t
decipherment	s
decis	it
decisi	ov
decisio	n
decision	aeis
decisiona	l
decisione	d
decisioni	n
decisionin	g
decisiv	e
decisive	ln
decisivel	y
decisiven	e
decisivene	s
decisivenes	s
decisiveness	e
decisivenesse	s
decist	e
deciste	r
decister	e
deciv	i
decivi	l
decivil	i
decivili	z
deciviliz	aei
deciviliza	t
decivilizat	i
decivilizati	o
decivilizatio	n
decivilization	s
decivilize	ds
decivilizi	n
decivilizin	g
deck	cehils
deckc	h
deckch	a
deckcha	i
deckchai	r
deckchair	s
decke	drs
deckes	t
deckh	ao
deckha	n
deckhan	d
deckho	u
deckhou	s
deckhous	e
decki	n
deckin	g
decking	s
deckl	e
decl	aeiou
decla	imrsw
declai	m
declaim	e
declaime	r
declam	a
declama	t
declamat	io
declamati	o
declamatio	n
declamato	r
declamator	y
declar	aei
declara	nt
declaran	t
declarat	io
declarati	ov
declaratio	n
declaration	s
declarativ	e
declarative	ls
declarativel	y
declarato	r
declarator	y
declare	drs
declarer	s
declari	n
declarin	g
declas	s
declass	i
declassi	f
declassif	iy
declassifi	c
declassific	a
declassifica	t
declassificat	i
declassificati	o
declassificatio	n
declaw	eis
declawe	d
declawi	n
declawin	g
decle	n
declen	s
declens	i
declensi	o
declensio	n
declension	s
decli	nv
declin	aei
declina	bt
declinab	l
declinabl	e
declinat	i
declinati	o
declinatio	n
declination	s
decline	drs
decliner	s
declini	n
declinin	g
decliv	i
declivi	t
declivit	y
declo	t
declot	st
declott	ei
declotte	d
declotti	n
declottin	g
declu	t
declut	c
declutc	h
decn	e
decne	t
deco	cdlmnruy
decoc	ot
decoco	o
decocoo	n
decoct	i
decocti	o
decoctio	n
decod	aei
decoda	b
decodab	l
decodabl	e
decode	drs
decoder	s
decodi	n
decodin	g
decoding	s
decol	lo
decoll	aei
decolla	t
decollat	eo
decollato	r
decolle	t
decollet	a
decolleta	g
decolletag	e
decolli	m
decollim	a
decollima	t
decollimat	e
decolo	n
decolon	i
decoloni	sz
decolonis	e
decoloniz	e
decom	emp
decome	t
decomet	e
decomete	r
decomm	eiu
decomme	r
decommer	c
decommerc	i
decommerci	a
decommercia	l
decommercial	i
decommerciali	z
decommercializ	aei
decommercializa	t
decommercializat	i
decommercializati	o
decommercializatio	n
decommercialization	s
decommercialize	ds
decommercializi	n
decommercializin	g
decommi	s
decommis	s
decommiss	i
decommissi	o
decommissio	n
decommu	t
decommut	a
decommuta	t
decommutat	o
decommutato	r
decomp	eior
decompe	n
decompen	s
decompens	a
decompensa	t
decompensat	ei
decompensati	o
decompensatio	n
decompi	l
decompil	ei
decompile	ds
decompili	n
decompilin	g
decompo	s
decompos	aei
decomposa	b
decomposab	il
decomposabi	l
decomposabil	i
decomposabili	t
decomposabilit	iy
decomposabiliti	e
decomposabilitie	s
decomposabl	e
decompose	drs
decomposi	nt
decomposin	g
decomposit	i
decompositi	o
decompositio	n
decomposition	s
decompr	e
decompre	s
decompres	s
decompress	ei
decompresse	drs
decompressi	nov
decompressin	g
decompressio	n
decompression	s
decompressiv	e
decon	cgt
deconc	e
deconce	n
deconcen	t
deconcent	r
deconcentr	a
deconcentra	t
deconcentrat	ei
deconcentrati	o
deconcentratio	n
decong	lr
decongl	o
deconglo	m
deconglom	e
deconglome	r
deconglomer	a
deconglomera	t
deconglomerat	ei
deconglomerate	ds
deconglomerati	n
deconglomeratin	g
decongr	e
decongre	g
decongreg	a
decongrega	t
decongregat	ei
decongregate	ds
decongregati	n
decongregatin	g
decont	ar
deconta	m
decontam	i
decontami	n
decontamin	a
decontamina	t
decontaminat	ei
decontaminati	o
decontaminatio	n
decontr	o
decontro	l
decor	aostu
decora	t
decorat	eio
decorate	ds
decorati	nov
decoratin	g
decoratio	n
decoration	s
decorativ	e
decorative	ln
decorativel	y
decorativen	e
decorativene	s
decorativenes	s
decorativeness	e
decorativenesse	s
decorato	r
decorator	s
decoro	u
decorou	s
decort	i
decorti	c
decortic	a
decortica	t
decorticat	e
decoru	m
decou	p
decoup	al
decoupa	g
decoupag	e
decoupl	ei
decouple	drs
decoupler	s
decoupli	n
decouplin	g
decoy	eis
decoye	dr
decoyer	s
decoyi	n
decoyin	g
decr	eiuy
decre	aemps
decrea	s
decreas	ei
decrease	ds
decreasi	n
decreasin	g
decreasing	l
decreasingl	y
decree	dirs
decreei	n
decreein	g
decreer	s
decrem	e
decreme	n
decremen	t
decrement	eis
decremente	d
decrementi	n
decrementin	g
decrep	i
decrepi	t
decrepit	alnu
decrepita	t
decrepitat	e
decrepitl	y
decrepitn	e
decrepitne	s
decrepitnes	s
decrepitness	e
decrepitnesse	s
decrepitu	d
decrepitud	e
decres	c
decresc	e
decresce	n
decrescen	t
decri	ae
decria	l
decrie	drs
decrier	s
decru	m
decrum	b
decrumb	eis
decrumbe	d
decrumbi	n
decrumbin	g
decry	ip
decryi	n
decryin	g
decryp	t
decrypt	eis
decrypte	d
decrypti	no
decryptin	g
decryptio	n
decs	ty
decst	a
decsta	t
decstat	i
decstati	o
decstatio	n
decsy	s
decsys	t
decsyst	e
decsyste	m
dect	a
decta	p
dectap	e
ded	eiuv
dede	s
dedes	i
dedesi	g
dedesig	n
dedesign	a
dedesigna	t
dedesignat	ei
dedesignate	ds
dedesignati	n
dedesignatin	g
dedi	c
dedic	a
dedica	t
dedicat	eio
dedicate	des
dedicated	l
dedicatedl	y
dedicati	no
dedicatin	g
dedicatio	n
dedication	as
dedicationa	l
dedicato	r
dedicator	sy
dedu	c
deduc	eit
deduce	dmrs
deducem	e
deduceme	n
deducemen	t
deduci	bn
deducib	il
deducibi	l
deducibil	i
deducibili	t
deducibilit	i
deducibiliti	e
deducibilitie	s
deducibl	ey
deducible	n
deduciblen	e
deduciblene	s
deduciblenes	s
deducibleness	e
deduciblenesse	s
deducin	g
deduct	aeis
deducta	b
deductab	l
deductabl	e
deducte	d
deducti	bnov
deductib	l
deductibl	e
deductin	g
deductio	n
deduction	s
deductiv	e
deductive	l
deductivel	y
dee	dejmnprsvw
deed	befis
deedb	o
deedbo	x
deede	d
deedf	u
deedfu	l
deedi	n
deedin	g
deej	a
deeja	y
deem	eips
deeme	dr
deemi	n
deemin	g
deemp	h
deemph	a
deempha	s
deemphas	i
deemphasi	sz
deemphasis	e
deemphasiz	ei
deemphasize	drs
deemphasizer	s
deemphasizi	n
deemphasizin	g
deen	s
deep	eilmnrst
deepe	nrs
deepen	eis
deepene	dr
deepener	s
deepeni	n
deepenin	g
deepening	l
deepeningl	y
deepes	t
deepi	n
deepl	y
deepm	i
deepmi	n
deepmin	d
deepn	e
deepne	s
deepnes	s
deepness	e
deepnesse	s
deepr	o
deepro	o
deeproo	t
deeproot	e
deeproote	d
deeprooted	n
deeprootedn	e
deeprootedne	s
deeprootednes	s
deeprootedness	e
deeprootednesse	s
deeps	e
deepse	e
deepsee	k
deept	h
deepth	r
deepthr	o
deepthro	a
deepthroa	t
deer	els
deerl	i
deerli	k
deerlik	e
deers	kt
deersk	i
deerski	n
deerst	a
deersta	l
deerstal	k
deerstalk	ei
deerstalke	r
deerstalki	n
deerstalkin	g
dees	c
deesc	a
deesca	l
deescal	a
deescala	t
deescalat	ei
deescalate	ds
deescalati	no
deescalatin	g
deescalatio	n
deescalation	s
deev	v
def	aefilortuy
defa	clmtu
defac	ei
deface	admrs
defacea	b
defaceab	l
defaceabl	e
defacem	e
defaceme	n
defacemen	t
defacement	s
defacer	s
defaci	n
defacin	g
defal	c
defalc	a
defalca	t
defalcat	ei
defalcati	o
defalcatio	n
defam	aei
defama	t
defamat	io
defamati	o
defamatio	n
defamato	r
defamator	y
defame	drs
defamer	s
defami	n
defamin	g
defaming	l
defamingl	y
defat	t
defatt	e
defatte	d
defau	l
defaul	t
default	efis
defaulte	dr
defaulter	s
defaultf	o
defaultfo	l
defaultfol	d
defaultfold	e
defaultfolde	r
defaultfolder	x
defaulti	n
defaultin	g
defe	acnr
defea	st
defeas	ai
defeasa	n
defeasan	c
defeasanc	e
defeasi	b
defeasib	l
defeasibl	e
defeat	aeims
defeata	b
defeatab	l
defeatabl	e
defeate	dr
defeater	s
defeati	ns
defeatin	g
defeatis	mt
defeatist	s
defeatm	e
defeatme	n
defeatmen	t
defec	at
defeca	t
defecat	eio
defecate	ds
defecati	no
defecatin	g
defecatio	n
defecation	s
defecato	r
defecator	y
defect	eilos
defecte	d
defecti	bnov
defectib	il
defectibi	l
defectibil	i
defectibili	t
defectibilit	iy
defectibiliti	e
defectibilitie	s
defectibl	e
defectin	g
defectio	n
defection	s
defectiv	e
defectl	e
defectle	s
defectles	s
defecto	r
defector	s
defen	cdes
defenc	ei
defence	adls
defencea	b
defenceab	l
defenceabl	e
defencel	e
defencele	s
defenceles	s
defenceless	ln
defencelessl	y
defencelessn	e
defencelessne	s
defencelessnes	s
defencelessness	e
defencelessnesse	s
defenci	n
defencin	g
defend	aeirs
defenda	n
defendan	t
defendant	s
defende	dr
defender	is
defenderi	s
defenderis	m
defendi	n
defendin	g
defendr	e
defendre	s
defendres	s
defene	s
defenes	t
defenest	r
defenestr	a
defenestra	t
defenestrat	ei
defenestrate	ds
defenestrati	no
defenestratin	g
defenestratio	n
defens	ei
defense	dls
defensel	e
defensele	s
defenseles	s
defenseless	ln
defenselessl	y
defenselessn	e
defenselessne	s
defenselessnes	s
defenselessness	e
defenselessnesse	s
defensi	bnv
defensib	il
defensibi	l
defensibil	i
defensibili	t
defensibilit	iy
defensibiliti	e
defensibilitie	s
defensibl	ey
defensible	n
defensiblen	e
defensiblene	s
defensiblenes	s
defensibleness	e
defensiblenesse	s
defensin	g
defensiv	e
defensive	lns
defensivel	y
defensiven	e
defensivene	s
defensivenes	s
defensiveness	e
defensivenesse	s
defer	emrs
defere	n
deferen	ct
deferenc	e
deference	s
deferent	i
deferenti	a
deferentia	l
deferential	l
deferentiall	y
deferm	e
deferme	n
defermen	t
deferment	s
deferr	aei
deferra	bl
deferrab	l
deferrabl	e
deferre	dr
deferrer	s
deferri	n
deferrin	g
deff	e
deffe	r
deffer	e
deffere	n
defferen	t
defi	abceln
defia	bn
defiab	l
defiabl	e
defian	ct
defianc	e
defiance	s
defiant	ln
defiantl	y
defiantn	e
defiantne	s
defiantnes	s
defiantness	e
defiantnesse	s
defib	r
defibr	i
defibri	l
defibril	l
defibrill	a
defibrilla	t
defibrillat	eio
defibrillate	ds
defibrillati	no
defibrillatin	g
defibrillatio	n
defibrillation	s
defibrillato	r
defibrillator	s
defic	i
defici	et
deficie	n
deficien	ct
deficienc	iy
deficienci	e
deficiencie	s
deficient	ls
deficientl	y
deficit	s
defie	ds
defil	aeil
defila	d
defilad	e
defile	m
defilem	e
defileme	n
defilemen	t
defili	n
defilin	g
defill	a
defilla	m
defillam	a
defin	aei
defina	bt
definab	il
definabi	l
definabil	i
definabili	t
definabilit	i
definabiliti	e
definabilitie	s
definabl	e
definat	e
definate	l
definatel	y
define	dmrs
definem	e
defineme	n
definemen	t
definement	s
definer	s
defini	nt
definin	g
definit	eiu
definite	lns
definitel	y
definiten	e
definitene	s
definitenes	s
definiteness	e
definitenesse	s
definiti	ov
definitio	n
definition	as
definitiona	l
definitional	l
definitionall	y
definitiv	e
definitive	lns
definitivel	y
definitiven	e
definitivene	s
definitivenes	s
definitiveness	e
definitivenesse	s
definitu	d
definitud	e
defl	aeou
defla	gt
deflag	r
deflagr	a
deflagra	t
deflagrat	e
deflat	aeio
deflata	b
deflatab	l
deflatabl	e
deflate	drs
deflater	s
deflati	no
deflatin	g
deflatio	n
deflation	ais
deflationa	r
deflationar	y
deflationi	s
deflationis	mt
deflationism	s
deflationist	s
deflato	r
deflator	s
defle	cx
deflec	t
deflect	aeios
deflecta	b
deflectab	l
deflectabl	e
deflecte	d
deflecti	nov
deflectin	g
deflectio	n
deflection	s
deflectiv	e
deflecto	r
deflector	s
deflex	i
deflexi	o
deflexio	n
deflexion	s
deflo	rw
deflor	a
deflora	t
deflorat	i
deflorati	o
defloratio	n
deflow	e
deflowe	r
deflu	e
deflue	n
defluen	t
defo	aceglr
defoa	m
defoam	eis
defoame	d
defoami	n
defoamin	g
defoc	u
defocu	s
defocus	i
defocusi	n
defocusin	g
defol	i
defoli	a
defolia	t
defoliat	eio
defoliate	ds
defoliati	no
defoliatin	g
defoliatio	n
defoliation	s
defoliato	r
defoliator	s
defor	em
defore	s
defores	t
deforest	aeis
deforesta	t
deforestat	i
deforestati	o
deforestatio	n
deforestation	s
deforeste	d
deforesti	n
deforestin	g
deform	aeils
deforma	bt
deformab	i
deformabi	l
deformabil	i
deformabili	t
deformabilit	i
deformabiliti	e
deformabilitie	s
deformat	i
deformati	o
deformatio	n
deformation	s
deforme	dr
deformed	ln
deformedl	y
deformedn	e
deformedne	s
deformednes	s
deformedness	e
deformednesse	s
deformer	s
deformi	nt
deformin	g
deformit	iy
deformiti	e
deformitie	s
deforml	y
defr	aeo
defra	muy
defram	ei
deframe	ds
deframi	n
deframin	g
defrau	d
defraud	aeims
defrauda	t
defraudat	i
defraudati	o
defraudatio	n
defraudation	s
defraude	dr
defrauder	s
defraudi	n
defraudin	g
defraudm	e
defraudme	n
defraudmen	t
defraudment	s
defre	e
defree	z
defreez	ei
defreeze	s
defreezi	n
defreezin	g
defro	sz
defros	t
defrost	eis
defroste	dr
defroster	s
defrosti	n
defrostin	g
defroz	e
defroze	n
deft	eln
defte	rs
deftes	t
deftl	y
deftn	e
deftne	s
deftnes	s
deftness	e
deftnesse	s
defu	ens
defue	l
defuel	eils
defuele	d
defueli	n
defuelin	g
defuell	ei
defuelle	d
defuelli	n
defuellin	g
defun	c
defunc	t
defunct	ins
defuncti	v
defunctiv	e
defunctn	e
defunctne	s
defunctnes	s
defunctness	e
defunctnesse	s
defus	ei
defuse	drs
defuser	s
defusi	n
defusin	g
defy	i
defyi	n
defyin	g
deg	aehlru
dega	su
degas	s
degass	i
degassi	n
degassin	g
degau	s
degaus	s
degauss	i
degaussi	n
degaussin	g
dege	ln
degel	eils
degele	d
degeli	n
degelin	g
degell	ei
degelle	d
degelli	n
degellin	g
degen	e
degene	r
degener	a
degenera	ct
degenerac	y
degenerat	ei
degenerate	dlmns
degeneratel	y
degeneratem	o
degeneratemo	d
degeneratemod	e
degeneratemode	s
degeneraten	e
degeneratene	s
degeneratenes	s
degenerateness	e
degeneratenesse	s
degenerati	nov
degeneratin	g
degeneratio	n
degenerativ	e
degenerative	l
degenerativel	y
degh	o
degho	s
deghos	t
deghost	eis
deghoste	d
deghosti	n
deghostin	g
degl	aou
degla	c
deglac	i
deglaci	a
deglacia	t
deglaciat	i
deglaciati	o
deglaciatio	n
deglo	r
deglor	i
deglori	f
deglorif	iy
deglorifi	e
deglorifie	ds
deglorify	i
deglorifyi	n
deglorifyin	g
deglu	t
deglut	i
degluti	t
deglutit	i
deglutiti	o
deglutitio	n
degr	ae
degra	d
degrad	aei
degrada	bt
degradab	l
degradabl	e
degradat	i
degradati	o
degradatio	n
degradation	as
degradationa	l
degrade	drs
degrader	s
degradi	n
degradin	g
degrading	l
degradingl	y
degre	aes
degrea	s
degreas	e
degree	dls
degreel	e
degreele	s
degreeles	s
degres	s
degress	i
degressi	ov
degressio	n
degressiv	e
deh	aiuy
deha	i
dehai	r
dehair	eis
dehaire	d
dehairi	n
dehairin	g
dehi	s
dehis	c
dehisc	e
dehisce	n
dehiscen	t
dehu	m
dehum	ai
dehuma	n
dehuman	i
dehumani	sz
dehumanis	ei
dehumanise	ds
dehumanisi	n
dehumanisin	g
dehumaniz	aei
dehumaniza	t
dehumanizat	i
dehumanizati	o
dehumanizatio	n
dehumanization	s
dehumanize	ds
dehumanizi	n
dehumanizin	g
dehumi	d
dehumid	i
dehumidi	f
dehumidif	iy
dehumidifi	ce
dehumidific	a
dehumidifica	t
dehumidificat	i
dehumidificati	o
dehumidificatio	n
dehumidifie	r
dehy	dp
dehyd	r
dehydr	ao
dehydra	t
dehydrat	eio
dehydrate	ds
dehydrati	no
dehydratin	g
dehydratio	n
dehydrato	r
dehydrator	s
dehydro	g
dehydrog	e
dehydroge	n
dehydrogen	a
dehydrogena	s
dehydrogenas	e
dehyp	hn
dehyph	e
dehyphe	n
dehyphen	eis
dehyphene	d
dehypheni	n
dehyphenin	g
dehypn	o
dehypno	t
dehypnot	i
dehypnoti	sz
dehypnotis	e
dehypnotiz	e
dei	cfgmorst
deic	ei
deice	r
deici	d
deicid	e
deif	ioy
deifi	c
deific	a
deifica	t
deificat	i
deificati	o
deificatio	n
deifo	r
deifor	m
deig	n
deign	eis
deigne	d
deigni	n
deignin	g
deim	o
deimo	s
deio	n
deion	i
deioni	z
deioniz	a
deioniza	t
deionizat	i
deionizati	o
deionizatio	n
deir	d
deird	r
deirdr	e
deirdre	s
deis	mt
deist	i
deisti	c
deit	iy
deiti	e
deitie	s
deity	s
deitys	h
deitysh	i
deityshi	p
dej	e
deje	c
dejec	t
deject	ei
dejecte	d
dejected	ln
dejectedl	y
dejectedn	e
dejectedne	s
dejectednes	s
dejectedness	e
dejectednesse	s
dejecti	o
dejectio	n
dek	a
deka	ls
dekal	b
dekas	t
dekast	e
dekaste	r
dekaster	e
del	aefhilmoprstuv
dela	nwy
delan	eo
delane	y
delaw	ay
delawa	r
delawar	e
delawy	e
delawye	r
delawyer	eis
delawyere	d
delawyeri	n
delawyerin	g
delay	aeis
delaya	b
delayab	l
delayabl	e
delaye	dr
delayer	s
delayi	n
delayin	g
delaying	l
delayingl	y
dele	cgt
delec	t
delect	a
delecta	bt
delectab	l
delectabl	e
delectat	i
delectati	o
delectatio	n
deleg	a
delega	ct
delegac	y
delegat	eio
delegate	des
delegatee	s
delegates	h
delegatesh	i
delegateshi	p
delegati	no
delegatin	g
delegatio	n
delegation	s
delegato	r
delegator	s
delet	aei
deleta	b
deletab	l
deletabl	e
delete	drs
deleter	i
deleteri	o
deleterio	u
deleteriou	s
deleti	no
deletin	g
deletio	n
deletion	s
delf	t
delh	i
deli	abcglmnqrv
delib	e
delibe	r
deliber	a
delibera	t
deliberat	eio
deliberate	dlns
deliberatel	y
deliberaten	e
deliberatene	s
deliberatenes	s
deliberateness	e
deliberatenesse	s
deliberati	nov
deliberatin	g
deliberatio	n
deliberation	s
deliberativ	e
deliberative	ln
deliberativel	y
deliberativen	e
deliberativene	s
deliberativenes	s
deliberativeness	e
deliberativenesse	s
deliberato	r
deliberator	s
delic	ait
delica	ct
delicac	iy
delicaci	e
delicacie	s
delicat	e
delicate	lnrs
delicatel	y
delicaten	e
delicatene	s
delicatenes	s
delicateness	e
delicatenesse	s
delicates	st
delicatess	e
delicatesse	n
delicatessen	s
delici	o
delicio	u
deliciou	s
delicious	eln
deliciouse	s
deliciousl	y
deliciousn	e
deliciousne	s
deliciousnes	s
deliciousness	e
deliciousnesse	s
delig	h
deligh	t
delight	efils
delighte	dr
delighted	ln
delightedl	y
delightedn	e
delightedne	s
delightednes	s
delightedness	e
delightednesse	s
delighter	s
delightf	u
delightfu	l
delightful	l
delightfull	y
delighti	n
delightin	g
delighting	l
delightingl	y
delightl	e
delightle	s
delightles	s
delil	a
delila	h
delim	i
delimi	t
delimit	aeis
delimita	t
delimitat	i
delimitati	o
delimitatio	n
delimite	dr
delimiter	s
delimiti	n
delimitin	g
delin	eqt
deline	a
delinea	mt
delineam	e
delineame	n
delineamen	t
delineat	ei
delineate	ds
delineati	no
delineatin	g
delineatio	n
delinq	u
delinqu	e
delinque	n
delinquen	ct
delinquenc	iy
delinquenci	e
delinquencie	s
delinquent	ls
delinquentl	y
delint	eis
delinte	d
delinti	n
delintin	g
deliq	u
deliqu	e
delique	s
deliques	c
deliquesc	e
deliquesce	n
deliquescen	ct
deliquescenc	e
delir	i
deliri	aou
deliria	n
delirian	t
delirio	u
deliriou	s
delirious	ln
deliriousl	y
deliriousn	e
deliriousne	s
deliriousnes	s
deliriousness	e
deliriousnesse	s
deliriu	m
deliv	e
delive	r
deliver	aeilnsy
delivera	bn
deliverab	il
deliverabi	l
deliverabil	i
deliverabili	t
deliverabilit	iy
deliverabiliti	e
deliverabilitie	s
deliverabl	e
deliverable	s
deliveran	c
deliveranc	e
delivere	dr
deliverer	s
deliveri	en
deliverie	s
deliverin	g
deliverl	y
delivern	e
deliverne	s
delivernes	s
dell	aesw
dellw	o
dellwo	o
dellwoo	d
delm	a
delma	r
delmar	v
delmarv	a
delo	clu
deloc	a
deloca	l
delocal	i
delocali	sz
delocalis	e
delocaliz	e
delol	d
delold	o
deloldo	s
delou	s
delous	e
delp	h
delph	i
delphi	cn
delphic	a
delphica	l
delphical	l
delphicall	y
delphin	iu
delphini	u
delphiniu	m
delphinu	s
delt	ao
delta	s
delto	i
deltoi	d
delu	dgsx
delud	ei
delude	drs
deluded	l
deludedl	y
deluder	s
deludi	n
deludin	g
delug	ei
deluge	ds
delugi	n
delugin	go
delugino	u
deluginou	s
delus	i
delusi	ov
delusio	n
delusion	ais
delusiona	lr
delusionar	y
delusioni	s
delusionis	t
delusiv	e
delux	e
delv	ei
delve	drs
delver	s
delvi	n
delvin	g
dem	aeiopuy
dema	gnr
demag	no
demagn	ei
demagne	t
demagnet	i
demagneti	sz
demagnetis	e
demagnetiz	ae
demagnetiza	t
demagnetizat	i
demagnetizati	o
demagnetizatio	n
demagni	f
demagnif	y
demago	g
demagog	ou
demagogo	g
demagogu	e
demagogue	r
demagoguer	y
deman	d
demand	aeis
demanda	b
demandab	l
demandabl	e
demande	dr
demander	s
demandi	n
demandin	g
demanding	ln
demandingl	y
demandingn	e
demandingne	s
demandingnes	s
demandingness	e
demandingnesse	s
demar	ck
demarc	a
demarca	t
demarcat	ei
demarcati	o
demarcatio	n
demark	a
demarka	t
demarkat	i
demarkati	o
demarkatio	n
demarkation	s
deme	anrst
demea	n
demean	o
demeano	ru
demeanou	r
demen	t
dement	ei
demente	d
dementi	a
dementia	ls
demer	i
demeri	t
demerit	ei
demerite	d
demeriti	n
demeritin	g
demes	n
demesn	e
demet	e
demete	r
demi	cgjlnstu
demic	a
demica	s
demicas	t
demicast	o
demicasto	r
demig	o
demigo	d
demij	o
demijo	h
demijoh	n
demil	iu
demili	t
demilit	a
demilita	r
demilitar	i
demilitari	sz
demilitaris	e
demilitariz	ae
demilitariza	t
demilitarizat	i
demilitarizati	o
demilitarizatio	n
demilu	n
demilun	e
demin	e
demine	r
deminer	a
deminera	l
demineral	i
deminerali	sz
demineralis	e
demineralise	dr
demineraliz	e
demineralize	d
demis	acei
demisa	b
demisab	i
demisabi	l
demisabil	i
demisabili	t
demisabilit	iy
demisabiliti	e
demisabilitie	s
demisc	i
demisci	b
demiscib	l
demiscibl	e
demise	ds
demisi	n
demisin	g
demit	i
demiti	n
demitin	t
demiu	r
demiur	g
demiurg	ei
demiurgi	c
demo	bcdegilnrstu
demob	i
demobi	l
demobil	i
demobili	sz
demobilis	e
demobiliz	ae
demobiliza	t
demobilizat	i
demobilizati	o
demobilizatio	n
democ	r
democr	a
democra	ct
democrac	iy
democraci	e
democracie	s
democrat	is
democrati	csz
democratic	a
democratica	l
democratical	l
democraticall	y
democratis	em
democratiz	ae
democratiza	t
democratizat	i
democratizati	o
democratizatio	n
demod	u
demodu	l
demodul	a
demodula	t
demodulat	eio
demodulati	o
demodulatio	n
demodulato	r
demoe	d
demog	r
demogr	a
demogra	p
demograp	h
demograph	eiy
demographe	r
demographer	s
demographi	ces
demographic	s
demographie	s
demographis	t
demographist	s
demoi	ns
demoin	g
demois	t
demoist	u
demoistu	r
demoistur	i
demoisturi	z
demoisturiz	ei
demoisturize	drs
demoisturizer	s
demoisturizi	n
demoisturizin	g
demol	i
demoli	st
demolis	h
demolish	aeim
demolisha	b
demolishab	l
demolishabl	e
demolishe	drs
demolisher	s
demolishi	n
demolishin	g
demolishm	e
demolishme	n
demolishmen	t
demolishment	s
demolit	i
demoliti	o
demolitio	n
demon	eilos
demone	t
demonet	i
demoneti	sz
demonetis	e
demonetiz	ae
demonetiza	t
demonetizat	i
demonetizati	o
demonetizatio	n
demoni	acsz
demonia	cn
demonic	a
demonica	l
demonical	l
demonicall	y
demonis	ehm
demoniz	aei
demoniza	t
demonizat	i
demonizati	o
demonizatio	n
demonization	s
demonize	ds
demonizi	n
demonizin	g
demonl	i
demonli	k
demonlik	e
demono	p
demonop	o
demonopo	l
demonopol	i
demonopoli	sz
demonopolis	e
demonopoliz	e
demons	t
demonst	r
demonstr	a
demonstra	bt
demonstrab	l
demonstrabl	ey
demonstrat	eio
demonstrate	ds
demonstrated	l
demonstratedl	y
demonstrati	nov
demonstratin	g
demonstratio	n
demonstration	ais
demonstrationa	l
demonstrationi	s
demonstrationis	t
demonstrationist	s
demonstrativ	e
demonstrative	lns
demonstrativel	y
demonstrativen	e
demonstrativene	s
demonstrativenes	s
demonstrativeness	e
demonstrativenesse	s
demonstrato	r
demonstrator	sy
demonstrators	h
demonstratorsh	i
demonstratorshi	p
demor	ag
demora	l
demoral	i
demorali	sz
demoralis	ei
demoralise	ds
demoralisi	n
demoralisin	g
demoraliz	aei
demoraliza	t
demoralizat	i
demoralizati	o
demoralizatio	n
demoralization	s
demoralize	drs
demoralizer	s
demoralizi	n
demoralizin	g
demoralizing	l
demoralizingl	y
demorg	a
demorga	n
demot	ehi
demote	ds
demoth	eis
demothe	d
demothi	n
demothin	g
demoti	cnosv
demotin	g
demotio	n
demotion	s
demotis	t
demotiv	a
demotiva	t
demotivat	o
demotivato	r
demotivator	s
demou	n
demoun	t
demount	a
demounta	b
demountab	l
demountabl	e
demp	s
demps	e
dempse	y
demu	lrx
demul	ct
demulc	e
demulce	n
demulcen	t
demult	i
demulti	p
demultip	l
demultipl	e
demultiple	x
demultiplex	ei
demultiplexe	dr
demultiplexer	s
demultiplexi	n
demultiplexin	g
demur	eir
demure	lnrs
demurel	y
demuren	e
demurene	s
demurenes	s
demureness	e
demurenesse	s
demures	t
demuri	t
demurit	y
demurr	ae
demurra	g
demurrag	e
demurre	r
demy	st
demys	t
demyst	i
demysti	f
demystif	y
demyt	h
demyth	o
demytho	l
demythol	o
demytholo	g
demytholog	i
demythologi	z
demythologiz	e
den	abdefghilmnopstuvwy
dena	rtz
denar	y
denat	iu
denati	o
denatio	n
denation	a
denationa	l
denational	i
denationali	sz
denationalis	e
denationaliz	ae
denationaliza	t
denationalizat	i
denationalizati	o
denationalizatio	n
denatu	r
denatur	ae
denatura	nt
denaturan	t
denaturat	i
denaturati	o
denaturatio	n
denaz	i
denazi	f
denazif	y
denb	v
dend	er
dende	e
dendr	io
dendri	t
dendrit	ei
dendriti	c
dendro	cilm
dendroc	l
dendrocl	i
dendrocli	m
dendroclim	a
dendroclima	t
dendroclimat	o
dendroclimato	l
dendroclimatol	o
dendroclimatolo	g
dendroclimatolog	i
dendroclimatologi	s
dendroclimatologis	t
dendroi	d
dendrol	io
dendroli	t
dendrolit	e
dendrolo	g
dendrolog	y
dendrom	e
dendrome	t
dendromet	e
dendromete	r
dene	ber
deneb	o
denebo	l
denebol	a
denee	n
dener	g
denerg	i
denergi	sz
denergis	e
denergiz	e
deng	u
dengu	e
deni	acegmstz
denia	bl
deniab	l
deniabl	e
denial	s
denic	o
denico	t
denicot	i
denicoti	n
denicotin	i
denicotini	sz
denicotinis	e
denicotiniz	e
denie	drs
denig	r
denigr	a
denigra	t
denigrat	ei
denigrate	ds
denigrati	n
denigratin	g
denim	s
denis	eh
denit	r
denitr	i
denitri	f
denitrif	y
deniz	e
denize	n
denl	i
denli	k
denlik	e
denm	a
denma	r
denmar	k
denn	eiy
denne	d
denni	ns
dennin	g
deno	mrtu
denom	i
denomi	n
denomin	a
denomina	t
denominat	eio
denominati	o
denominatio	n
denomination	as
denominationa	l
denominational	l
denominationall	y
denominato	r
denominator	s
denor	m
denorm	a
denorma	l
denormal	i
denormali	z
denormaliz	a
denormaliza	t
denormalizat	i
denormalizati	o
denormalizatio	n
denormalization	s
denot	aei
denota	bt
denotab	l
denotabl	e
denotat	i
denotati	ov
denotatio	n
denotation	as
denotationa	l
denotational	l
denotationall	y
denotativ	e
denote	dms
denotem	e
denoteme	n
denotemen	t
denotement	s
denoti	nv
denotin	g
denotiv	e
denou	en
denoue	m
denouem	e
denoueme	n
denouemen	t
denouement	s
denoun	c
denounc	ei
denounce	dmrs
denouncem	e
denounceme	n
denouncemen	t
denouncement	s
denouncer	s
denounci	n
denouncin	g
denp	v
dens	ei
dense	lnrs
densel	y
densen	e
densene	s
densenes	s
denseness	e
densenesse	s
denses	t
densi	t
densit	ioy
densiti	e
densitie	s
densito	m
densitom	e
densitome	t
densitomet	e
densitomete	r
dent	aeiosu
denta	lpt
dental	ils
dentali	tz
dentalit	iy
dentaliti	e
dentalitie	s
dentaliz	a
dentaliza	t
dentalizat	i
dentalizati	o
dentalizatio	n
dentall	y
dentap	h
dentaph	o
dentapho	n
dentaphon	e
dentat	e
dente	d
denti	flnst
dentif	r
dentifr	i
dentifri	c
dentifric	e
dentin	g
dentis	t
dentist	rs
dentistr	iy
dentistri	e
dentistrie	s
dentit	i
dentiti	o
dentitio	n
dento	n
dentu	r
dentur	ei
denture	s
denturi	s
denturis	m
denu	dmn
denud	ae
denuda	t
denudat	i
denudati	o
denudatio	n
denum	be
denumb	e
denumbe	r
denumber	eis
denumbere	d
denumberi	n
denumberin	g
denume	r
denumer	a
denumera	b
denumerab	l
denumerabl	e
denun	c
denunc	i
denunci	a
denuncia	t
denunciat	ei
denunciati	o
denunciatio	n
denunciation	s
denv	e
denve	r
denver	b
denverb	o
denverbo	o
denverboo	t
deny	i
denyi	n
denyin	g
deo	cdnx
deod	ao
deoda	r
deodo	r
deodor	ai
deodora	n
deodoran	t
deodorant	s
deodori	sz
deodoris	e
deodoriz	ae
deodoriza	t
deodorizat	i
deodorizati	o
deodorizatio	n
deon	t
deont	o
deonto	l
deontol	o
deontolo	g
deontolog	y
deox	iy
deoxi	d
deoxid	i
deoxidi	sz
deoxidis	e
deoxidise	r
deoxidiz	e
deoxidize	r
deoxy	gr
deoxyg	e
deoxyge	n
deoxygen	a
deoxygena	t
deoxygenat	e
deoxyr	i
deoxyri	b
deoxyrib	o
deoxyribo	n
deoxyribon	eu
deoxyribone	u
deoxyriboneu	c
deoxyriboneuc	l
deoxyriboneucl	e
deoxyriboneucle	i
deoxyriboneuclei	c
deoxyribonu	c
deoxyribonuc	l
deoxyribonucl	e
deoxyribonucle	i
deoxyribonuclei	c
dep	aehilortuv
depa	ry
depar	t
depart	aeimsu
departa	b
departab	l
departabl	e
departe	d
departi	n
departin	g
departm	e
departme	n
departmen	t
department	as
departmenta	l
departmental	il
departmentali	sz
departmentalis	m
departmentaliz	a
departmentaliza	t
departmentalizat	i
departmentalizati	o
departmentalizatio	n
departmentall	y
departu	r
departur	e
departure	s
depe	cnr
depec	h
depech	e
depen	d
depend	aeis
dependa	bn
dependab	il
dependabi	l
dependabil	i
dependabili	t
dependabilit	iy
dependabiliti	e
dependabilitie	s
dependabl	ey
dependable	n
dependablen	e
dependablene	s
dependablenes	s
dependableness	e
dependablenesse	s
dependan	ct
dependanc	eiy
dependance	s
dependanci	e
dependancie	s
dependant	ls
dependantl	y
depende	dnr
dependen	ct
dependenc	eiy
dependence	s
dependenci	e
dependencie	s
dependent	ls
dependentl	y
dependi	n
dependin	g
deper	m
deph	l
dephl	e
dephle	g
dephleg	m
dephlegm	a
dephlegma	t
dephlegmat	e
depi	cl
depic	t
depict	eios
depicte	dr
depicter	s
depicti	nov
depictin	g
depictio	n
depiction	s
depictiv	e
depicto	r
depictor	s
depil	a
depila	t
depilat	eio
depilati	o
depilatio	n
depilato	r
depilator	y
depl	aeou
depla	n
deplan	e
deple	t
deplet	aeio
depleta	b
depletab	l
depletabl	e
deplete	drs
depleter	s
depleti	nov
depletin	g
depletio	n
depletion	s
depletiv	e
depleto	r
depletor	y
deplo	ry
deplor	aei
deplora	bt
deplorab	il
deplorabi	l
deplorabil	i
deplorabili	t
deplorabilit	iy
deplorabiliti	e
deplorabilitie	s
deplorabl	ey
deplorable	n
deplorablen	e
deplorablene	s
deplorablenes	s
deplorableness	e
deplorablenesse	s
deplorat	i
deplorati	o
deploratio	n
deploration	s
deplore	drs
deplorer	s
deplori	n
deplorin	g
deploring	l
deploringl	y
deploy	aeims
deploya	b
deployab	il
deployabi	l
deployabil	i
deployabili	t
deployabilit	iy
deployabiliti	e
deployabilitie	s
deployabl	e
deploye	d
deployi	n
deployin	g
deploym	e
deployme	n
deploymen	t
deployment	s
deplu	m
deplum	e
depo	lnprst
depol	ai
depola	r
depolar	iz
depolari	sz
depolaris	e
depolariz	ae
depolariza	t
depolarizat	i
depolarizati	o
depolarizatio	n
depolarize	r
depolarz	e
depolarze	r
depoli	s
depolis	h
depolish	ei
depolishe	ds
depolishi	n
depolishin	g
depon	e
depop	u
depopu	l
depopul	a
depopula	rt
depopular	i
depopulari	z
depopulariz	ei
depopularize	ds
depopularizi	n
depopularizin	g
depopulat	eio
depopulate	ds
depopulati	nov
depopulatin	g
depopulatio	n
depopulation	s
depopulativ	e
depopulato	r
depopulator	s
depor	t
deport	aeims
deporta	t
deportat	i
deportati	o
deportatio	n
deporte	der
deporter	s
deporti	n
deportin	g
deportm	e
deportme	n
deportmen	t
depos	aei
deposa	bl
deposab	l
deposabl	e
depose	drs
deposer	s
deposi	nt
deposin	g
deposit	aeios
deposita	br
depositab	l
depositabl	e
depositar	y
deposite	de
depositi	no
depositin	g
depositio	n
deposition	s
deposito	r
depositor	sy
depot	s
depr	aei
depra	v
deprav	aei
deprava	t
depravat	i
depravati	o
depravatio	n
deprave	d
depraved	n
depravedn	e
depravedne	s
depravednes	s
depravedness	e
depravednesse	s
depravi	t
depravit	iy
depraviti	e
depravitie	s
depre	cds
deprec	ai
depreca	t
deprecat	eio
deprecate	d
deprecati	no
deprecatin	g
deprecating	l
deprecatingl	y
deprecatio	n
deprecato	r
deprecator	y
depreci	a
deprecia	t
depreciat	eio
depreciate	ds
depreciati	no
depreciatin	g
depreciating	l
depreciatingl	y
depreciatio	n
depreciation	s
depreciato	r
depreciator	s
depred	a
depreda	t
depredat	ei
depredati	o
depredatio	n
depres	s
depress	aeiou
depressa	n
depressan	t
depresse	ds
depressed	l
depressedl	y
depressi	bnov
depressib	il
depressibi	l
depressibil	i
depressibili	t
depressibilit	iy
depressibiliti	e
depressibilitie	s
depressibl	e
depressin	g
depressing	n
depressingn	e
depressingne	s
depressingnes	s
depressio	n
depression	s
depressiv	e
depresso	r
depressu	r
depressur	i
depressuri	z
depressuriz	a
depressuriza	t
depressurizat	i
depressurizati	o
depressurizatio	n
depri	v
depriv	aei
depriva	blt
deprivab	l
deprivabl	e
deprival	s
deprivat	i
deprivati	o
deprivatio	n
deprivation	s
deprive	dmrs
deprivem	e
depriveme	n
deprivemen	t
depriver	s
deprivi	n
deprivin	g
dept	hs
depth	es
depthe	n
depu	lt
depul	p
depulp	eis
depulpe	d
depulpi	n
depulpin	g
deput	aeiy
deputa	t
deputat	i
deputati	o
deputatio	n
deputation	as
deputationa	l
deputi	esz
deputie	s
deputis	ei
deputise	ds
deputisi	n
deputisin	g
deputiz	aei
deputiza	t
deputizat	i
deputizati	o
deputizatio	n
deputization	s
deputize	ds
deputizi	n
deputizin	g
deputy	s
deputys	h
deputysh	i
deputyshi	p
deputyship	s
deq	eu
dequ	e
deque	u
dequeu	ei
dequeue	ds
dequeui	n
dequeuin	g
der	abeimoruv
dera	int
derai	l
derail	eims
deraile	dr
deraili	n
derailin	g
derailm	e
derailme	n
derailmen	t
derailment	s
deran	g
derang	e
derange	dm
derangem	e
derangeme	n
derangemen	t
derat	ei
derati	o
deratio	n
derb	iy
derbi	e
derbie	s
derby	s
derbys	h
derbysh	i
derbyshi	r
derbyshir	e
dere	fgklqs
deref	e
derefe	r
derefer	e
derefere	n
dereferen	c
dereferenc	ei
dereference	drs
dereferenci	n
dereferencin	g
dereg	u
deregu	l
deregul	a
deregula	t
deregulat	eio
deregulate	ds
deregulati	no
deregulatin	g
deregulatio	n
deregulato	r
deregulator	sy
derel	i
dereli	c
derelic	t
derelict	ilns
derelicti	o
derelictio	n
derelictl	y
derelictn	e
derelictne	s
derelictnes	s
derelictness	e
derelictnesse	s
dereq	u
derequ	i
derequi	s
derequis	i
derequisi	t
derequisit	i
derequisiti	o
derequisitio	n
deres	t
derest	r
derestr	i
derestri	c
derestric	t
derestrict	is
derestricti	n
derestrictin	g
deri	dosv
derid	ei
deride	drs
derider	s
deridi	n
deridin	g
deriding	l
deridingl	y
derio	u
deriou	s
deris	io
derisi	ov
derisio	n
derisiv	e
deriso	r
derisor	y
deriv	aei
deriva	bt
derivab	l
derivabl	e
derivat	i
derivati	ov
derivatio	n
derivation	ais
derivationa	l
derivational	l
derivationall	y
derivationi	s
derivationis	t
derivativ	e
derivative	lns
derivativel	y
derivativen	e
derivativene	s
derivativenes	s
derivativeness	e
derivativenesse	s
derive	drs
deriver	s
derivi	n
derivin	g
derm	a
derma	lt
dermat	io
dermati	t
dermatit	i
dermatiti	ds
dermatitid	e
dermatitide	s
dermatitis	e
dermatitise	s
dermato	ls
dermatol	o
dermatolo	g
dermatolog	iy
dermatologi	ces
dermatologic	a
dermatologica	l
dermatological	l
dermatologicall	y
dermatologie	s
dermatologis	t
dermatologist	s
dermatos	i
dermatosi	s
dero	g
derog	a
deroga	t
derogat	eio
derogati	o
derogatio	n
derogato	r
derogator	iy
derogatori	ln
derogatoril	y
derogatorin	e
derogatorine	s
derogatorines	s
derogatoriness	e
derogatorinesse	s
derr	i
derri	ces
derric	k
derrie	r
derrier	e
deru	s
derus	t
derust	eis
deruste	d
derusti	n
derustin	g
derv	i
dervi	s
dervis	h
des	aceiklmopstuy
desa	lnt
desal	it
desali	n
desalin	a
desalina	t
desalinat	i
desalinati	o
desalinatio	n
desan	c
desanc	t
desanct	i
desancti	f
desanctif	y
desat	u
desatu	r
desatur	a
desatura	t
desaturat	ei
desaturate	ds
desaturati	n
desaturatin	g
desc	aer
desca	nr
descan	t
descant	eis
descante	drs
descanter	s
descantes	t
descanti	n
descantin	g
descar	t
descart	e
descarte	s
desce	n
descen	dt
descend	aeis
descenda	n
descendan	t
descendant	s
descende	dnr
descenden	t
descendent	s
descender	s
descendi	n
descendin	g
descending	l
descendingl	y
descent	s
descr	iy
descri	bp
describ	aei
describa	b
describab	il
describabi	l
describabil	i
describabili	t
describabilit	iy
describabiliti	e
describabilitie	s
describabl	ey
describe	drs
describer	s
describi	n
describin	g
descrip	t
descript	io
descripti	ov
descriptio	n
description	is
descriptioni	s
descriptionis	t
descriptiv	e
descriptive	lns
descriptivel	y
descriptiven	e
descriptivene	s
descriptivenes	s
descriptiveness	e
descriptivenesse	s
descripto	r
descriptor	s
dese	ceglnrx
desec	r
desecr	a
desecra	t
desecrat	eio
desecrate	drs
desecrater	s
desecrati	nov
desecratin	g
desecratio	n
desecrativ	e
desecrato	r
desecrator	s
desee	d
deseed	eis
deseede	d
deseedi	n
deseedin	g
deseg	r
desegr	e
desegre	g
desegreg	a
desegrega	t
desegregat	ei
desegregati	o
desegregatio	n
desel	e
desele	c
deselec	t
desen	s
desens	ai
desensa	t
desensat	i
desensati	o
desensatio	n
desensation	a
desensationa	l
desensational	i
desensationali	z
desensationaliz	ei
desensationalize	ds
desensationalizi	n
desensationalizin	g
desensi	t
desensit	i
desensiti	sz
desensitis	e
desensitiz	e
deser	tv
desert	eilns
deserte	dr
deserted	ln
desertedl	y
desertedn	e
desertedne	s
desertednes	s
desertedness	e
desertednesse	s
deserter	s
deserti	fnoz
desertif	iy
desertifi	ce
desertific	a
desertifica	t
desertificat	i
desertificati	o
desertificatio	n
desertification	s
desertifie	ds
desertify	i
desertifyi	n
desertifyin	g
desertin	g
desertio	n
desertion	s
desertiz	a
desertiza	t
desertizat	i
desertizati	o
desertizatio	n
desertization	s
desertl	i
desertli	k
desertlik	e
desertn	e
desertne	s
desertnes	s
deserv	ei
deserve	drs
deserved	l
deservedl	y
deserver	s
deservi	n
deservin	g
deserving	lns
deservingl	y
deservingn	e
deservingne	s
deservingnes	s
deservingness	e
deservingnesse	s
desi	cdglrs
desic	c
desicc	a
desicca	nt
desiccan	t
desiccat	aeio
desiccata	n
desiccatan	t
desiccate	d
desiccati	ov
desiccatio	n
desiccativ	e
desiccato	r
desid	e
deside	r
desider	a
desidera	t
desiderat	aeu
desideratu	m
desig	n
design	aefils
designa	t
designat	eio
designate	ds
designati	nov
designatin	g
designatio	n
designation	s
designativ	e
designato	r
designator	sy
designe	dr
designed	l
designedl	y
designer	s
designf	u
designfu	l
designi	n
designin	g
designl	e
designle	s
designles	s
desil	t
desilt	eis
desilte	d
desilti	n
desiltin	g
desir	aeio
desira	b
desirab	il
desirabi	l
desirabil	i
desirabili	t
desirabilit	y
desirabl	ey
desirable	ns
desirablen	e
desirablene	s
desirablenes	s
desirableness	e
desirablenesse	s
desire	dflrs
desired	ln
desiredl	y
desiredn	e
desiredne	s
desirednes	s
desiredness	e
desirednesse	s
desiref	u
desirefu	l
desirel	e
desirele	s
desireles	s
desireless	n
desirelessn	e
desirelessne	s
desirelessnes	s
desirer	s
desiri	n
desirin	g
desiring	l
desiringl	y
desiro	u
desirou	s
desis	t
desk	ejst
deske	rs
deskes	t
deskj	e
deskje	t
deskt	o
deskto	p
desktop	s
desl	u
deslu	m
deslum	ms
deslumm	ei
deslumme	d
deslummi	n
deslummin	g
desm	o
desmo	gn
desmog	gs
desmogg	ei
desmogge	d
desmoggi	n
desmoggin	g
desmon	d
deso	lr
desol	ad
desola	t
desolat	ei
desolate	l
desolatel	y
desolati	o
desolatio	n
desolation	s
desold	e
desolde	r
desolder	eis
desoldere	d
desolderi	n
desolderin	g
desor	p
desorp	t
desorpt	i
desorpti	o
desorptio	n
desp	aeio
despa	it
despai	r
despair	efis
despaire	dr
despairer	s
despairf	u
despairfu	l
despairful	l
despairfull	y
despairi	n
despairin	g
despairing	ln
despairingl	y
despairingn	e
despairingne	s
despairingnes	s
despat	c
despatc	h
despatch	ei
despatche	drs
despatchi	n
despatchin	g
despe	r
desper	a
despera	dt
desperad	o
desperat	ei
desperate	lns
desperatel	y
desperaten	e
desperatene	s
desperatenes	s
desperateness	e
desperatenesse	s
desperati	o
desperatio	n
despi	cst
despic	a
despica	b
despicab	il
despicabi	l
despicabil	i
despicabili	t
despicabilit	iy
despicabiliti	e
despicabilitie	s
despicabl	ey
despicable	n
despicablen	e
despicablene	s
despicablenes	s
despicableness	e
despicablenesse	s
despis	aei
despisa	bl
despisab	l
despisabl	e
despisable	n
despisablen	e
despisablene	s
despisablenes	s
despisableness	e
despisablenesse	s
despise	dmrs
despisem	e
despiseme	n
despisemen	t
despisement	s
despiser	s
despisi	n
despisin	g
despising	l
despisingl	y
despit	ei
despite	dfs
despitef	u
despitefu	l
despiti	n
despitin	g
despo	ilnt
despoi	l
despol	i
despoli	a
despolia	t
despoliat	i
despoliati	o
despoliatio	n
despon	d
despond	e
desponde	n
desponden	ct
despondenc	y
despondent	l
despondentl	y
despot	ais
despota	t
despoti	csz
despotic	a
despotica	l
despotical	ln
despoticall	y
despoticaln	e
despoticalne	s
despoticalnes	s
despotis	m
despotiz	e
dess	ei
desse	r
desser	t
dessert	s
desserts	p
dessertsp	o
dessertspo	o
dessertspoo	n
dessertspoon	s
dessi	c
dessic	a
dessica	t
dessicat	e
dest	aeiru
desta	bi
destab	i
destabi	l
destabil	i
destabili	sz
destabilis	ei
destabilise	ds
destabilisi	n
destabilisin	g
destabiliz	aei
destabiliza	t
destabilizat	i
destabilizati	o
destabilizatio	n
destabilization	s
destabilize	ds
destabilizi	n
destabilizin	g
destai	n
destain	e
destaine	r
destainer	s
deste	r
dester	i
desteri	l
desteril	i
desterili	sz
desterilis	e
desteriliz	e
desti	nt
destin	aeiy
destina	t
destinat	i
destinati	o
destinatio	n
destination	s
destine	d
destini	e
destinie	s
destit	u
destitu	t
destitut	ei
destitute	dlns
destitutel	y
destituten	e
destitutene	s
destitutenes	s
destituteness	e
destitutenesse	s
destituti	no
destitutin	g
destitutio	n
destr	iou
destri	e
destrie	r
destro	y
destroy	aeis
destroya	b
destroyab	l
destroyabl	e
destroye	dr
destroyer	s
destroyi	n
destroyin	g
destroying	l
destroyingl	y
destru	c
destruc	t
destruct	iou
destructi	bov
destructib	il
destructibi	l
destructibil	i
destructibili	t
destructibilit	y
destructibl	e
destructio	n
destruction	s
destructiv	e
destructive	ln
destructivel	y
destructiven	e
destructivene	s
destructivenes	s
destructiveness	e
destructivenesse	s
destructo	r
destructu	r
destructur	ei
destructure	ds
destructuri	n
destructurin	g
destu	f
destuf	f
destuff	is
destuffi	n
destuffin	g
desu	bel
desub	s
desubs	i
desubsi	d
desubsid	i
desubsidi	z
desubsidiz	aei
desubsidiza	t
desubsidizat	i
desubsidizati	o
desubsidizatio	n
desubsidization	s
desubsidize	ds
desubsidizi	n
desubsidizin	g
desue	t
desuet	u
desuetu	d
desuetud	e
desul	t
desult	o
desulto	r
desultor	iy
desultori	l
desultoril	y
desy	n
desyn	c
desync	h
desynch	r
desynchr	o
desynchro	n
desynchron	i
desynchroni	z
desynchroniz	aei
desynchroniza	t
desynchronizat	i
desynchronizati	o
desynchronizatio	n
desynchronization	s
desynchronize	ds
desynchronizi	n
desynchronizin	g
det	aehioru
deta	cis
detac	h
detach	aeim
detacha	b
detachab	il
detachabi	l
detachabil	i
detachabili	t
detachabilit	iy
detachabiliti	e
detachabilitie	s
detachabl	ey
detache	drs
detached	ln
detachedl	y
detachedn	e
detachedne	s
detachednes	s
detachedness	e
detachednesse	s
detacher	s
detachi	n
detachin	g
detachm	e
detachme	n
detachmen	t
detachment	s
detai	ln
detail	eis
detaile	dr
detailer	s
detaili	n
detailin	g
detain	aeims
detaina	b
detainab	l
detainabl	e
detaine	der
detainee	s
detaini	n
detainin	g
detaining	l
detainingl	y
detainm	e
detainme	n
detainmen	t
detainment	s
detas	s
detass	e
detasse	l
detassel	eils
detassele	d
detasseli	n
detasselin	g
detassell	ei
detasselle	d
detasselli	n
detassellin	g
dete	cnrs
detec	t
detect	aeios
detecta	bp
detectab	il
detectabi	l
detectabil	i
detectabili	t
detectabilit	iy
detectabiliti	e
detectabilitie	s
detectabl	ey
detectap	h
detectaph	o
detectapho	n
detectaphon	e
detecte	d
detecti	bnov
detectib	i
detectibi	l
detectibil	i
detectibili	t
detectibilit	iy
detectibiliti	e
detectibilitie	s
detectin	g
detectio	n
detection	s
detectiv	ae
detectiva	l
detective	ls
detectivel	i
detectiveli	k
detectivelik	e
detecto	r
detector	s
deten	t
detent	ei
detente	s
detenti	o
detentio	n
detention	s
deter	gimrs
deterg	e
deterge	n
detergen	t
detergent	s
deteri	o
deterio	r
deterior	a
deteriora	t
deteriorat	eio
deteriorate	ds
deteriorati	no
deterioratin	g
deterioratio	n
deteriorato	r
determ	ei
determe	n
determen	t
determent	s
determi	n
determin	aei
determina	bcnt
determinab	l
determinabl	e
determinac	y
determinan	t
determinant	s
determinat	ei
determinate	l
determinatel	y
determinati	ov
determinatio	n
determination	s
determinativ	e
determine	drs
determined	ln
determinedl	y
determinedn	e
determinedne	s
determinednes	s
determinedness	e
determinednesse	s
determiner	s
determini	ns
determinin	g
determinis	mt
determinist	i
deterministi	c
deterministic	a
deterministica	l
deterministical	l
deterministicall	y
deterr	aei
deterra	b
deterrab	i
deterrabi	l
deterrabil	i
deterrabili	t
deterrabilit	iy
deterrabiliti	e
deterrabilitie	s
deterre	dnr
deterren	ct
deterrenc	e
deterrent	ls
deterrentl	y
deterrer	s
deterri	n
deterrin	g
detes	t
detest	aeis
detesta	bt
detestab	l
detestabl	e
detestat	i
detestati	o
detestatio	n
deteste	dr
detester	s
detesti	n
detestin	g
deth	r
dethr	o
dethro	n
dethron	e
deti	n
detin	u
detinu	e
deto	nux
deton	a
detona	bt
detonab	l
detonabl	e
detonat	aeio
detonata	b
detonatab	il
detonatabi	l
detonatabil	i
detonatabili	t
detonatabilit	iy
detonatabiliti	e
detonatabilitie	s
detonatabl	e
detonate	ds
detonati	nov
detonatin	g
detonatio	n
detonativ	e
detonato	r
detonator	s
detou	r
detour	eis
detoure	d
detouri	n
detourin	g
detox	i
detoxi	cf
detoxic	a
detoxica	t
detoxicat	e
detoxif	iy
detoxifi	c
detoxific	a
detoxifica	t
detoxificat	i
detoxificati	o
detoxificatio	n
detr	aio
detra	ci
detrac	t
detract	aeios
detracta	t
detractat	i
detractati	o
detractatio	n
detracte	d
detracti	n
detractin	g
detracting	l
detractingl	y
detracto	r
detractor	s
detrai	n
detri	mt
detrim	e
detrime	n
detrimen	t
detriment	as
detrimenta	l
detrit	aiu
detrita	l
detriti	c
detritu	s
detritus	e
detrituse	s
detro	i
detroi	t
detu	mn
detum	e
detume	s
detumes	c
detumesc	e
detumesce	n
detumescen	c
detumescenc	e
detun	e
deu	cejstv
deuc	ei
deuce	drs
deuces	t
deuci	n
deucin	g
deut	esz
deute	r
deuter	io
deuteri	u
deuteriu	m
deuterium	s
deutero	gn
deuterog	a
deuteroga	m
deuterogam	y
deuteron	o
deuterono	m
deuteronom	iy
deuteronomi	c
deuts	c
deutsc	h
deutsch	el
deutschl	a
deutschla	n
deutschlan	d
deutz	i
deutzi	a
dev	aeio
deva	ls
deval	u
devalu	aei
devalua	t
devaluat	ei
devaluati	o
devaluatio	n
devalue	ds
devalui	n
devaluin	g
devas	t
devast	a
devasta	t
devastat	eio
devastate	ds
devastati	nov
devastatin	g
devastating	l
devastatingl	y
devastatio	n
devastation	s
devastativ	e
devastato	r
devastator	s
deve	lr
devel	o
develo	p
develop	aeims
developa	b
developab	i
developabi	l
developabil	i
developabili	t
developabilit	iy
developabiliti	e
developabilitie	s
develope	dr
developer	ps
developerp	r
developerpr	e
developerpre	v
developerprev	i
developerprevi	e
developerprevie	w
developi	n
developin	g
developm	e
developme	n
developmen	t
development	as
developmenta	lr
developmentar	y
dever	b
deverb	a
deverba	t
deverbat	i
deverbati	v
deverbativ	e
devi	aclost
devia	bnt
deviab	il
deviabi	l
deviabil	i
deviabili	t
deviabilit	iy
deviabiliti	e
deviabilitie	s
deviabl	e
devian	ct
devianc	e
deviant	als
devianta	r
deviantar	t
deviantl	y
deviat	eio
deviate	ds
deviati	nov
deviatin	g
deviatio	n
deviation	ais
deviationa	l
deviationi	s
deviationis	mt
deviationism	s
deviationist	s
deviativ	e
deviato	r
deviator	sy
devic	e
device	fls
devicef	u
devicefu	l
deviceful	ln
devicefull	y
devicefuln	e
devicefulne	s
devicefulnes	s
devicefulness	e
devicefulnesse	s
devicel	e
devicele	s
deviceles	s
devil	dehils
devild	o
devildo	m
devile	dst
deviles	s
devilh	eo
devilhe	a
devilhea	d
devilho	o
devilhoo	d
devili	nsz
devilin	g
devilis	h
devilish	l
devilishl	y
deviliz	e
devill	i
devilli	n
devillin	g
devils	h
devilsh	i
devilshi	p
devio	u
deviou	s
devious	ln
deviousl	y
deviousn	e
deviousne	s
deviousnes	s
deviousness	e
deviousnesse	s
devis	eio
devise	dmnrs
devisem	e
deviseme	n
devisemen	t
deviser	s
devisi	no
devisin	g
devising	s
devisio	n
devision	s
deviso	r
devit	ar
devita	l
devital	i
devitali	sz
devitalis	e
devitaliz	ae
devitaliza	t
devitalizat	i
devitalizati	o
devitalizatio	n
devitr	i
devitri	f
devitrif	iy
devitrifi	c
devitrific	a
devitrifica	t
devitrificat	i
devitrificati	o
devitrificatio	n
devo	ilnprtu
devoi	dr
devoid	eis
devoide	d
devoidi	n
devoidin	g
devol	uv
devolu	t
devolut	i
devoluti	o
devolutio	n
devolution	ais
devolutiona	r
devolutionar	iy
devolutionari	e
devolutionarie	s
devolutioni	s
devolutionis	t
devolutionist	s
devolv	ei
devolve	mrs
devolvem	e
devolveme	n
devolvemen	t
devolvement	s
devolvi	n
devolvin	g
devon	ist
devoni	a
devonia	n
devons	h
devonsh	i
devonshi	r
devonshir	e
devont	h
devonth	i
devonthi	n
devonthin	k
devop	s
devor	e
devot	ei
devote	dems
devoted	ln
devotedl	y
devotedn	e
devotedne	s
devotednes	s
devotedness	e
devotednesse	s
devotee	s
devotem	e
devoteme	n
devotemen	t
devotement	s
devoti	no
devotin	g
devotio	n
devotion	ais
devotiona	lr
devotionar	y
devotioni	s
devotionis	t
devou	rt
devour	aeims
devoura	b
devourab	l
devourabl	e
devoure	dr
devourer	s
devouri	n
devourin	g
devouring	ln
devouringl	y
devouringn	e
devouringne	s
devouringnes	s
devouringness	e
devouringnesse	s
devourm	e
devourme	n
devourmen	t
devout	eln
devoute	rs
devoutes	t
devoutl	y
devoutn	e
devoutne	s
devoutnes	s
devoutness	e
devoutnesse	s
dew	abcdefiluwy
dewa	lx
dewal	t
dewb	e
dewbe	r
dewber	r
dewberr	y
dewc	l
dewcl	a
dewcla	w
dewd	r
dewdr	o
dewdro	p
dewdrop	s
dewe	dy
dewf	a
dewfa	l
dewfal	l
dewi	nrt
dewin	eg
dewine	s
dewines	s
dewir	ei
dewire	ds
dewiri	n
dewirin	g
dewit	t
dewl	ae
dewla	p
dewle	s
dewles	s
dex	etv
dexe	d
dexed	r
dexedr	i
dexedri	n
dexedrin	e
dext	er
dexte	r
dexter	io
dexteri	t
dexterit	iy
dexteriti	e
dexteritie	s
dextero	u
dexterou	s
dextr	ao
dextra	ln
dextro	grs
dextrog	l
dextrogl	u
dextroglu	c
dextrogluc	o
dextrogluco	s
dextroglucos	e
dextroglucose	s
dextror	o
dextroro	t
dextrorot	a
dextrorota	t
dextrorotat	o
dextrorotato	r
dextrorotator	y
dextros	e
dextrose	s
dez	bfprstvw
dezf	v
dezs	v
dezw	v
df	befhklmnoprsuvxy
dfe	bltv
dfeb	v
dfet	rv
dff	efrv
dfk	f
dfn	dhnv
dfo	o
dfp	rv
dfr	o
dfro	v
dfs	v
dfu	b
dfv	az
dfy	dgrsv
dfyg	v
dg	efijlnqrx
dgf	f
dgi	v
dgj	rv
dgn	rv
dgq	f
dgr	v
dh	acehlnotux
dha	br
dhab	i
dhar	m
dharm	a
dhc	p
dhe	e
dhh	e
dhn	l
dho	jlrstvw
dhol	e
dhot	i
dht	m
dhtm	l
dhu	v
dhx	v
di	abcdefghijklmnopqrstuvwxyz
dia	bcdglmnprstz
diab	aelo
diaba	s
diabas	e
diabe	t
diabet	ei
diabete	s
diabetes	e
diabetese	s
diabeti	c
diabetic	as
diabetica	l
diabl	o
diabo	l
diabol	io
diaboli	c
diabolic	a
diabolica	l
diac	hor
diach	r
diachr	o
diachro	n
diachron	i
diachroni	c
diaco	n
diacon	a
diacona	t
diaconat	e
diacr	i
diacri	t
diacrit	i
diacriti	c
diacritic	a
diacritica	l
diad	e
diade	m
diag	nor
diagn	o
diagno	s
diagnos	aeit
diagnosa	b
diagnosab	l
diagnosabl	e
diagnose	ds
diagnosi	ns
diagnosin	g
diagnost	i
diagnosti	c
diagnostic	ais
diagnostica	l
diagnostical	l
diagnosticall	y
diagnostici	a
diagnosticia	n
diagnostician	s
diago	n
diagon	a
diagona	l
diagonal	ils
diagonali	z
diagonaliz	a
diagonaliza	t
diagonalizat	i
diagonalizati	o
diagonalizatio	n
diagonall	y
diagr	a
diagra	mp
diagram	eims
diagrame	d
diagrami	n
diagramin	g
diagramm	aei
diagramma	bt
diagrammab	l
diagrammabl	e
diagrammat	i
diagrammati	csz
diagrammatic	a
diagrammatica	l
diagrammatical	l
diagrammaticall	y
diagrammatis	e
diagrammatiz	e
diagramme	dr
diagrammer	s
diagrammi	n
diagrammin	g
diagrap	h
dial	eilosuy
diale	cdr
dialec	t
dialect	aios
dialecta	l
dialectal	l
dialectall	y
dialecti	c
dialectic	i
dialectici	a
dialecticia	n
dialecto	l
dialectol	o
dialectolo	g
dialectolog	y
dialer	s
diali	n
dialin	g
dialing	s
diall	ei
dialle	d
dialli	n
diallin	g
dialo	g
dialog	gisu
dialogg	ei
dialogge	d
dialoggi	n
dialoggin	g
dialogi	s
dialogis	t
dialogu	ei
dialogue	drs
dialoguer	s
dialogui	nsz
dialoguin	g
dialoguis	t
dialoguiz	e
dialu	p
dialy	stz
dialys	ai
dialysa	t
dialysat	e
dialysi	s
dialyt	i
dialyti	c
dialyz	e
dialyze	r
diam	aeo
diama	g
diamag	n
diamagn	e
diamagne	t
diamagnet	i
diamagneti	cs
diamagnetis	m
diame	t
diamet	er
diamete	r
diameter	s
diametr	ai
diametra	l
diametri	c
diametric	a
diametrica	l
diametrical	l
diametricall	y
diamo	n
diamon	d
diamond	beilsw
diamondb	a
diamondba	c
diamondbac	k
diamonde	d
diamondi	nz
diamondin	g
diamondiz	e
diamondl	i
diamondli	k
diamondlik	e
diamondw	i
diamondwi	s
diamondwis	e
dian	aent
diann	e
diant	h
dianth	u
dianthu	s
diap	aeh
diapa	s
diapas	o
diapaso	n
diape	r
diaper	eisy
diapere	d
diaperi	n
diaperin	g
diaph	aor
diapha	n
diaphan	o
diaphano	u
diaphanou	s
diapho	r
diaphor	e
diaphore	t
diaphoret	i
diaphoreti	c
diaphr	a
diaphra	g
diaphrag	m
diaphragm	aeis
diaphragma	t
diaphragmat	i
diaphragmati	c
diaphragmatic	a
diaphragmatica	l
diaphragmatical	l
diaphragmaticall	y
diaphragme	d
diaphragmi	n
diaphragmin	g
diar	ciry
diarc	h
diarch	y
diari	es
diarie	s
diaris	t
diarr	h
diarrh	eo
diarrhe	a
diarrho	e
diarrhoe	a
diarrhoea	l
dias	pt
diasp	o
diaspo	r
diaspor	a
diast	aor
diasta	s
diastas	e
diasto	l
diastol	ei
diastoli	c
diastr	o
diastro	p
diastrop	h
diastroph	i
diastrophi	s
diastrophis	m
diat	hor
diath	e
diathe	r
diather	m
diatherm	iy
diathermi	c
diato	mn
diatom	i
diatomi	ct
diatomic	i
diatomici	t
diatomicit	iy
diatomiciti	e
diatomicitie	s
diatomit	e
diaton	i
diatoni	c
diatr	i
diatri	b
diatrib	e
diatribe	s
diaz	eio
diaze	p
diazep	a
diazepa	m
diazi	n
diazin	e
dib	ab
diba	s
dibas	i
dibasi	c
dibb	l
dibbl	e
dic	ehikot
dice	drsy
dicer	s
dich	or
dicho	t
dichot	o
dichoto	m
dichotom	ioy
dichotomi	ez
dichotomie	s
dichotomiz	e
dichotomo	u
dichotomou	s
dichr	o
dichro	m
dichrom	a
dichroma	t
dichromat	i
dichromati	cs
dichromatis	m
dici	n
dicin	g
dick	eisy
dicke	nr
dicken	s
dicker	s
dickers	o
dickerso	n
dicki	n
dickin	s
dickins	o
dickinso	n
dicks	o
dickso	n
dico	t
dicot	y
dicoty	l
dicotyl	e
dicotyle	d
dicotyled	o
dicotyledo	n
dicotyledon	o
dicotyledono	u
dicotyledonou	s
dict	aiou
dicta	pt
dictap	h
dictaph	o
dictapho	n
dictaphon	e
dictat	eio
dictate	ds
dictati	nov
dictatin	g
dictating	l
dictatingl	y
dictatio	n
dictation	as
dictationa	l
dictativ	e
dictato	r
dictator	ais
dictatora	t
dictatorat	e
dictatori	al
dictatoria	ln
dictatorial	ln
dictatoriall	y
dictatorialn	e
dictatorialne	s
dictatorialnes	s
dictatorialness	e
dictatorialnesse	s
dictatoril	y
dictators	h
dictatorsh	i
dictatorshi	p
dicti	o
dictio	n
diction	a
dictiona	r
dictionar	iy
dictionari	e
dictionarie	s
dicto	g
dictog	r
dictogr	a
dictogra	p
dictograp	h
dictu	m
dictum	s
did	adory
dida	c
didac	t
didact	i
didacti	cv
didactic	ai
didactica	l
didactical	l
didacticall	y
didactici	s
didacticis	m
didacticism	s
didactiv	e
didd	l
diddl	e
didr	e
didre	x
didy	m
didym	i
didymi	u
didymiu	m
die	bcdghilmnrst
dieb	o
diebo	l
diebol	d
diec	a
dieca	s
diecas	t
dieg	o
dieh	a
dieha	r
diehar	d
diei	n
diein	g
diel	e
diele	c
dielec	t
dielect	r
dielectr	i
dielectri	c
dielectric	s
dien	c
dienc	e
dience	p
diencep	h
dienceph	a
diencepha	l
diencephal	o
diencephalo	n
dier	e
diere	s
dieres	i
dieresi	s
dies	ei
diese	l
diesel	is
dieseli	z
dieseliz	a
dieseliza	t
dieselizat	i
dieselizati	o
dieselizatio	n
diesi	n
diesin	k
diesink	e
diesinke	r
diet	aeirsz
dieta	r
dietar	y
diete	drt
dieter	s
dietet	i
dieteti	c
dietetic	s
dieti	cnt
dietic	i
dietici	a
dieticia	n
dietin	g
dietit	i
dietiti	a
dietitia	n
dietitian	s
dietr	i
dietri	c
dietric	h
dif	fly
diff	eilrsu
diffe	r
differ	eis
differe	dnr
differen	ct
differenc	ei
difference	ds
differenci	n
differencin	g
different	iln
differenti	a
differentia	blt
differentiab	il
differentiabi	l
differentiabil	i
differentiabili	t
differentiabilit	i
differentiabiliti	e
differentiabilitie	s
differentiabl	e
differential	ls
differentiall	y
differentiat	eio
differentiate	ds
differentiated	n
differentiatedn	e
differentiatedne	s
differentiatednes	s
differentiati	no
differentiatin	g
differentiatio	n
differentiation	s
differentiato	r
differentiator	s
differentl	y
differentn	e
differentne	s
differentnes	s
differentness	e
differentnesse	s
differer	s
differi	n
differin	g
diffi	cd
diffic	u
difficu	l
difficul	t
difficult	ailny
difficulta	t
difficultat	e
difficulti	e
difficultie	s
difficultl	y
difficultn	e
difficultne	s
difficultnes	s
diffid	e
diffide	n
diffiden	ct
diffidenc	e
diffident	ln
diffidentl	y
diffidentn	e
diffidentne	s
diffidentnes	s
diffidentness	e
diffidentnesse	s
diffl	u
difflu	e
difflue	n
diffluen	t
diffr	a
diffra	c
diffrac	t
diffract	eios
diffracte	d
diffracti	nov
diffractin	g
diffractio	n
diffractiv	e
diffracto	g
diffractog	r
diffractogr	a
diffractogra	m
diffu	s
diffus	ei
diffuse	dlnrs
diffused	ln
diffusedl	y
diffusedn	e
diffusedne	s
diffusednes	s
diffusel	y
diffusen	e
diffusene	s
diffusenes	s
diffuseness	e
diffusenesse	s
diffuser	s
diffusi	bnov
diffusib	l
diffusibl	e
diffusin	g
diffusio	n
diffusion	s
diffusiv	e
difl	u
diflu	o
difluo	r
difluor	i
difluori	d
difluorid	e
dig	aeghilnrs
diga	m
digam	y
dige	s
diges	t
digest	eis
digeste	d
digested	ln
digestedl	y
digestedn	e
digestedne	s
digestednes	s
digestedness	e
digestednesse	s
digesti	bnov
digestib	il
digestibi	l
digestibil	i
digestibili	t
digestibilit	y
digestibl	ey
digestible	n
digestiblen	e
digestiblene	s
digestiblenes	s
digestin	g
digestio	n
digestion	as
digestiona	l
digestiv	e
digg	eis
digge	r
digger	s
diggi	n
diggin	g
digging	s
digh	t
digi	mt
digim	o
digimo	n
digit	ais
digita	l
digital	ilors
digitali	s
digitall	y
digitalo	c
digitaloc	e
digitaloce	a
digitalocea	n
digitalr	e
digitalre	p
digitalrep	r
digitalrepr	e
digitalrepre	s
digitalrepres	e
digitalreprese	n
digitalrepresen	t
digitalrepresent	a
digitalrepresenta	t
digitalrepresentat	i
digitalrepresentati	o
digitalrepresentatio	n
digiti	gsz
digitig	r
digitigr	a
digitigra	d
digitigrad	e
digitis	ei
digitise	drs
digitisi	n
digitisin	g
digitiz	aei
digitiza	t
digitizat	i
digitizati	o
digitizatio	n
digitization	s
digitize	drs
digitizer	s
digitizi	n
digitizin	g
digl	o
diglo	t
dign	i
digni	ft
dignif	iy
dignifi	e
dignifie	d
dignified	ln
dignifiedl	y
dignifiedn	e
dignifiedne	s
dignifiednes	s
dignifiedness	e
dignifiednesse	s
dignit	aiy
dignita	r
dignitar	y
digniti	e
dignitie	s
digr	ae
digra	mp
digrap	h
digre	s
digres	s
digress	ei
digresse	drs
digresser	s
digressi	nov
digressin	g
digressing	l
digressingl	y
digressio	n
digression	s
digressiv	e
dih	e
dihe	d
dihed	r
dihedr	a
dihedra	l
dij	kov
dijk	s
dijks	t
dijkst	r
dijkstr	a
dijo	n
dik	ei
dike	drs
diker	s
diki	en
dikie	r
dikin	g
dil	adeilou
dila	pt
dilap	i
dilapi	d
dilapid	a
dilapida	t
dilapidat	ei
dilapidate	d
dilapidati	o
dilapidatio	n
dilat	aeio
dilata	bnt
dilatab	i
dilatabi	l
dilatabil	i
dilatabili	t
dilatabilit	iy
dilatabiliti	e
dilatabilitie	s
dilatan	c
dilatanc	y
dilatat	i
dilatati	o
dilatatio	n
dilate	ds
dilati	no
dilatin	g
dilatio	n
dilato	mr
dilatom	e
dilatome	t
dilatomet	e
dilatomete	r
dilator	isy
dilatori	n
dilatorin	e
dilatorine	s
dilatorines	s
dild	o
dildo	s
dile	mt
dilem	m
dilemm	a
dilemma	st
dilemmat	i
dilemmati	c
dilemmatic	a
dilemmatica	l
dilemmatical	l
dilemmaticall	y
dilet	t
dilett	a
diletta	n
dilettan	t
dilettant	e
dili	g
dilig	e
dilige	n
diligen	ct
diligenc	e
diligent	ln
diligentl	y
diligentn	e
diligentne	s
diligentnes	s
diligentness	e
diligentnesse	s
dill	oy
dillo	n
dilly	d
dillyd	a
dillyda	l
dillydal	l
dillydall	y
dilo	g
dilog	a
diloga	r
dilogar	i
dilogari	t
dilogarit	h
dilogarith	m
dilu	etv
dilue	n
diluen	t
dilut	aeio
diluta	b
dilutab	l
dilutabl	e
dilute	delnrs
diluted	l
dilutedl	y
dilutel	y
diluten	e
dilutene	s
dilutenes	s
diluteness	e
dilutenesse	s
diluter	s
diluti	no
dilutin	g
dilutio	n
diluto	r
dilutor	s
diluv	i
diluvi	au
diluvia	l
diluviu	m
dim	aeilmnopsw
dima	g
dimag	g
dimagg	i
dimaggi	o
dime	nrs
dimen	s
dimens	i
dimensi	o
dimensio	n
dimension	aeis
dimensiona	l
dimensional	il
dimensionali	t
dimensionalit	iy
dimensionaliti	e
dimensionalitie	s
dimensionall	y
dimensione	d
dimensioni	n
dimensionin	g
dimi	nt
dimin	iu
dimini	s
diminis	h
diminish	aeim
diminisha	b
diminishab	l
diminishabl	e
diminishable	n
diminishablen	e
diminishablene	s
diminishablenes	s
diminishe	drs
diminishi	n
diminishin	g
diminishing	s
diminishm	e
diminishme	n
diminishmen	t
diminishment	s
diminu	et
diminue	n
diminuen	d
diminuend	o
diminuendo	es
diminuendoe	s
diminut	i
diminuti	ov
diminutio	n
diminutiv	ae
diminutiva	l
diminutive	lns
diminutivel	y
diminutiven	e
diminutivene	s
diminutivenes	s
diminutiveness	e
diminutivenesse	s
dimit	y
diml	y
dimm	aeiy
dimma	b
dimmab	l
dimmabl	e
dimme	drs
dimmer	s
dimmes	t
dimmi	n
dimmin	g
dimn	e
dimne	s
dimnes	s
dimness	e
dimnesse	s
dimo	ru
dimor	p
dimorp	h
dimorph	i
dimorphi	s
dimorphis	m
dimou	t
dimp	l
dimpl	eiy
dimple	ds
dimpli	en
dimplie	rs
dimplies	t
dimplin	g
dimw	i
dimwi	t
din	aefgiknorstv
dina	hr
dine	drs
diner	gs
dinerg	a
dinerga	t
dinergat	e
dinf	u
dinfu	l
ding	bdhiloy
dingb	a
dingba	t
dingd	i
dingdi	n
dingdin	g
dingding	d
dingdingd	a
dingdingda	n
dingdingdan	g
dingdingdang	d
dingdingdangd	a
dingdingdangda	n
dingdingdangdan	g
dingh	iy
dinghi	e
dinghie	s
dingi	eln
dingie	rs
dingies	t
dingil	y
dingin	e
dingine	s
dingines	s
dinginess	e
dinginesse	s
dingl	e
dini	n
dinin	g
dink	euy
dinke	y
dinku	m
dinn	ei
dinne	dr
dinner	lstwy
dinnerl	e
dinnerle	s
dinnerles	s
dinnert	i
dinnerti	m
dinnertim	e
dinnerw	a
dinnerwa	r
dinnerwar	e
dinni	n
dinnin	g
dino	s
dinos	a
dinosa	u
dinosau	r
dinosaur	s
dio	cdgnprx
dioc	el
dioce	s
dioces	ae
diocesa	n
diocese	s
diocl	e
diocle	t
dioclet	i
diocleti	a
diocletia	n
diod	e
diode	s
diog	e
dioge	n
diogen	e
diogene	s
dion	y
diony	s
dionys	iu
dionysi	au
dionysia	n
dionysiu	s
dionysu	s
diop	ht
dioph	a
diopha	n
diophan	t
diophant	i
diophanti	n
diophantin	e
diopt	er
diopte	r
dioptr	i
dioptri	c
dioptric	s
dior	ai
diora	m
dioram	ai
diorami	c
diori	t
diorit	e
diox	i
dioxi	dn
dioxid	e
dioxide	s
dip	hlopstv
diph	t
dipht	h
diphth	eo
diphthe	r
diphther	i
diphtheri	a
diphtheria	ns
diphtho	n
diphthon	g
diphthong	aeios
diphthonga	l
diphthongal	l
diphthongall	y
diphthonge	d
diphthongi	cn
diphthongin	g
diphthongo	u
diphthongou	s
dipl	eo
diple	x
diplo	ims
diploi	d
diploid	aisy
diploida	l
diploidi	ce
diploidie	s
diplom	a
diploma	cist
diplomac	iy
diplomaci	e
diplomacie	s
diplomai	n
diplomain	g
diplomat	eis
diplomati	c
diplomatic	a
diplomatica	l
diplomatical	l
diplomaticall	y
diplos	i
diplosi	s
dipo	l
dipol	e
dipp	aeiy
dippa	b
dippab	l
dippabl	e
dippable	s
dippe	dr
dipper	s
dippi	n
dippin	g
dipping	s
dips	ot
dipso	m
dipsom	a
dipsoma	n
dipsoman	i
dipsomani	a
dipsomania	c
dipst	i
dipsti	c
dipstic	k
dipt	y
dipty	c
diptyc	h
diq	flr
dir	aegikpt
dira	c
dire	cflnrs
direc	t
direct	aeilnorsuvx
directa	b
directab	l
directabl	e
directe	ders
directes	t
directi	nov
directin	g
directio	n
direction	als
directiona	l
directional	il
directionali	t
directionalit	y
directionall	y
directionl	e
directionle	s
directionles	s
directionless	n
directionlessn	e
directionlessne	s
directionlessnes	s
directionlessness	e
directionlessnesse	s
directiv	ei
directive	lns
directivel	y
directiven	e
directivene	s
directivenes	s
directivi	t
directivit	y
directl	y
directn	e
directne	s
directnes	s
directo	r
director	aisy
directora	t
directorat	e
directori	e
directorie	s
directors	h
directorsh	i
directorshi	p
directorship	s
directr	i
directri	cx
directric	e
directrice	s
directu	s
diref	u
direfu	l
direl	ay
direla	t
direlat	i
direlati	o
direlatio	n
diren	e
direne	s
direnes	s
direness	e
direnesse	s
dires	t
dirg	e
dirge	s
diri	cgm
diric	h
dirich	l
dirichl	e
dirichle	t
dirig	i
dirigi	b
dirigib	il
dirigibi	l
dirigibil	i
dirigibili	t
dirigibilit	y
dirigibl	e
dirim	e
dirime	n
dirimen	t
dirt	ilsy
dirti	eln
dirtie	drs
dirties	t
dirtil	y
dirtin	e
dirtine	s
dirtines	s
dirtiness	e
dirtinesse	s
dirtl	e
dirtle	s
dirtles	s
dirty	i
dirtyi	ns
dirtyin	g
dirtyis	h
dis	abcdefghijklmnopqrstuvw
disa	bcdfglmnprstv
disab	ilu
disabi	l
disabil	i
disabili	t
disabilit	iy
disabiliti	e
disabilitie	s
disabl	ei
disable	dmnrs
disabled	s
disablem	e
disableme	n
disablemen	t
disablement	s
disablen	e
disablene	s
disablenes	s
disabler	s
disabli	n
disablin	g
disabu	s
disabus	e
disac	c
disacc	eo
disacce	p
disaccep	t
disaccept	a
disaccepta	n
disacceptan	c
disacceptanc	e
disacco	mr
disaccom	m
disaccomm	o
disaccommo	d
disaccommod	a
disaccommoda	t
disaccommodat	ei
disaccommodati	o
disaccommodatio	n
disaccor	d
disad	jov
disadj	u
disadju	s
disadjus	t
disado	r
disador	n
disadv	a
disadva	n
disadvan	t
disadvant	a
disadvanta	g
disadvantag	ei
disadvantage	ados
disadvantagea	b
disadvantageab	l
disadvantageabl	e
disadvantaged	ns
disadvantagedn	e
disadvantagedne	s
disadvantagednes	s
disadvantagedness	e
disadvantagednesse	s
disadvantageo	u
disadvantageou	s
disadvantageous	ln
disadvantageousl	y
disadvantageousn	e
disadvantageousne	s
disadvantageousnes	s
disadvantageousness	e
disadvantageousnesse	s
disadvantagi	n
disadvantagin	g
disaf	f
disaff	ei
disaffe	c
disaffec	t
disaffect	ei
disaffecte	d
disaffected	l
disaffectedl	y
disaffecti	o
disaffectio	n
disaffi	l
disaffil	i
disaffili	a
disaffilia	t
disaffiliat	i
disaffiliati	o
disaffiliatio	n
disag	r
disagr	e
disagre	e
disagree	adimrs
disagreea	b
disagreeab	il
disagreeabi	l
disagreeabil	i
disagreeabili	t
disagreeabilit	iy
disagreeabiliti	e
disagreeabilitie	s
disagreeabl	ey
disagreeable	ns
disagreeablen	e
disagreeablene	s
disagreeablenes	s
disagreeableness	e
disagreeablenesse	s
disagreei	n
disagreein	g
disagreem	e
disagreeme	n
disagreemen	t
disagreement	s
disal	l
disall	eoy
disalle	g
disalleg	i
disallegi	a
disallegia	n
disallegian	c
disallegianc	e
disallo	w
disallow	aeis
disallowa	bn
disallowab	l
disallowabl	e
disallowable	n
disallowablen	e
disallowablene	s
disallowablenes	s
disallowableness	e
disallowablenesse	s
disallowan	c
disallowanc	e
disallowance	s
disallowe	d
disallowi	n
disallowin	g
disam	b
disamb	i
disambi	g
disambig	u
disambigu	a
disambigua	t
disambiguat	ei
disambiguate	ds
disambiguati	no
disambiguatin	g
disambiguatio	n
disambiguation	s
disan	agn
disana	l
disanal	o
disanalo	g
disanalog	y
disang	e
disange	l
disangel	i
disangeli	c
disangelic	a
disangelica	l
disann	u
disannu	l
disap	p
disapp	elor
disappe	an
disappea	r
disappear	aeis
disappeara	n
disappearan	c
disappearanc	e
disappearance	s
disappeare	dr
disappeari	n
disappearin	g
disappen	d
disappend	a
disappenda	n
disappendan	t
disappl	i
disappli	c
disapplic	a
disapplica	t
disapplicat	i
disapplicati	o
disapplicatio	n
disappo	i
disappoi	n
disappoin	t
disappoint	eims
disappointe	dr
disappointed	l
disappointedl	y
disappointer	s
disappointi	n
disappointin	g
disappointing	l
disappointingl	y
disappointm	e
disappointme	n
disappointmen	t
disappointment	s
disappr	o
disappro	bv
disapprob	a
disapproba	t
disapprobat	i
disapprobati	o
disapprobatio	n
disapprov	aei
disapprova	bl
disapprovab	l
disapprovabl	e
disapproval	s
disapprove	drs
disapprover	s
disapprovi	n
disapprovin	g
disapproving	l
disapprovingl	y
disar	mrt
disarm	aeis
disarma	m
disarmam	e
disarmame	n
disarmamen	t
disarmament	s
disarme	dr
disarmer	s
disarmi	n
disarmin	g
disarr	a
disarra	ny
disarran	g
disarrang	e
disart	i
disarti	c
disartic	u
disarticu	l
disarticul	a
disarticula	t
disarticulat	ei
disarticulati	o
disarticulatio	n
disas	st
disass	eo
disasse	m
disassem	b
disassemb	l
disassembl	eiy
disassemble	drs
disassembli	n
disassemblin	g
disasso	c
disassoc	i
disassoci	a
disassocia	t
disassociat	ei
disassociate	ds
disassociati	no
disassociatin	g
disassociatio	n
disassociation	s
disast	er
disaste	r
disaster	s
disastr	o
disastro	u
disastrou	s
disastrous	ln
disastrousl	y
disastrousn	e
disastrousne	s
disastrousnes	s
disastrousness	e
disastrousnesse	s
disat	t
disatt	e
disatte	n
disatten	t
disattent	i
disattenti	o
disattentio	n
disav	o
disavo	w
disavow	a
disavowa	l
disb	aeoru
disba	lnr
disbal	a
disbala	n
disbalan	c
disbalanc	e
disban	d
disband	eims
disbande	d
disbandi	n
disbandin	g
disbandm	e
disbandme	n
disbandmen	t
disbandment	s
disbe	l
disbel	i
disbeli	e
disbelie	fv
disbelief	s
disbeliev	ei
disbelieve	drs
disbeliever	s
disbelievi	n
disbelievin	g
disbelieving	l
disbelievingl	y
disbo	d
disbod	y
disbr	a
disbra	in
disbrai	n
disbran	c
disbranc	h
disbu	dr
disbur	ds
disburd	e
disburde	n
disburs	ei
disburse	dms
disbursem	e
disburseme	n
disbursemen	t
disbursement	s
disbursi	n
disbursin	g
disc	aehilorsu
disca	glmnprs
discag	e
discal	c
discalc	e
discalce	d
discam	p
discan	do
discand	y
discano	n
discanon	i
discanoni	z
discanoniz	e
discap	a
discapa	c
discapac	i
discapaci	t
discapacit	a
discapacita	t
discapacitat	e
discar	d
discard	aeims
discarda	b
discardab	l
discardabl	e
discarde	dr
discarder	s
discardi	n
discardin	g
discardm	e
discardme	n
discardmen	t
discas	e
disce	dr
discer	n
discern	eims
discerne	dr
discerner	s
discerni	bn
discernib	il
discernibi	l
discernibil	i
discernibili	t
discernibilit	y
discernibl	ey
discernin	g
discerning	l
discerningl	y
discernm	e
discernme	n
discernmen	t
disch	a
discha	r
dischar	ag
dischara	g
discharag	e
discharg	ei
discharge	aders
dischargea	b
dischargeab	l
dischargeabl	e
dischargee	s
discharger	s
dischargi	n
dischargin	g
disci	np
discin	g
discip	l
discipl	ei
disciple	dls
disciplel	i
discipleli	k
disciplelik	e
disciples	h
disciplesh	i
discipleshi	p
discipleship	s
discipli	n
disciplin	aei
disciplina	lr
disciplinar	iy
disciplinari	alt
disciplinaria	n
disciplinaril	y
disciplinarit	iy
disciplinariti	e
disciplinaritie	s
discipline	drs
disciplined	l
disciplinedl	y
discipliner	s
disciplini	n
disciplinin	g
discl	aeio
discla	is
disclai	m
disclaim	aeis
disclaima	n
disclaiman	t
disclaime	dr
disclaimer	s
disclaimi	n
disclaimin	g
disclas	s
discle	s
discles	s
discli	k
disclik	e
disclo	is
discloi	s
disclois	t
discloist	e
discloiste	r
disclos	eiu
disclose	drs
discloser	s
disclosi	n
disclosin	g
disclosu	r
disclosur	e
disclosure	s
disco	begilmnprsuv
discob	o
discobo	l
discobol	u
discobolu	s
discoe	d
discog	r
discogr	a
discogra	p
discograp	h
discograph	y
discoi	dn
discoin	g
discol	o
discolo	ru
discolor	a
discolora	t
discolorat	i
discolorati	o
discoloratio	n
discolou	r
discolour	eims
discoloure	d
discolouri	n
discolourin	g
discolourm	e
discolourme	n
discolourmen	t
discom	bfmp
discomb	o
discombo	b
discombob	u
discombobu	l
discombobul	a
discombobula	t
discombobulat	e
discomf	io
discomfi	t
discomfo	r
discomfor	t
discomfort	eis
discomforte	dr
discomforti	n
discomfortin	g
discomm	o
discommo	dn
discommod	e
discommon	i
discommoni	z
discommoniz	e
discomp	o
discompo	s
discompos	eu
discomposu	r
discomposur	e
discon	cfgnst
disconc	e
disconce	r
disconcer	t
disconcert	eims
disconcerte	d
disconcerted	l
disconcertedl	y
disconcerti	no
disconcertin	g
disconcerting	l
disconcertingl	y
disconcertio	n
disconcertion	s
disconcertm	e
disconcertme	n
disconcertmen	t
disconcertment	s
disconf	io
disconfi	dr
disconfid	e
disconfide	n
disconfiden	c
disconfidenc	e
disconfir	m
disconfirm	a
disconfirma	bt
disconfirmab	l
disconfirmabl	e
disconfirmat	io
disconfirmati	o
disconfirmatio	n
disconfirmato	r
disconfirmator	y
disconfo	r
disconfor	m
disconform	a
disconforma	b
disconformab	l
disconformabl	y
discong	r
discongr	u
discongru	i
discongrui	t
discongruit	y
disconn	e
disconne	c
disconnec	t
disconnect	aeios
disconnecta	b
disconnectab	l
disconnectabl	e
disconnecte	dr
disconnecter	s
disconnecti	nov
disconnectin	g
disconnectio	n
disconnection	s
disconnectiv	e
disconnective	n
disconnectiven	e
disconnectivene	s
disconnectivenes	s
disconnectiveness	e
disconnectivenesse	s
disconnecto	r
discons	io
disconsi	d
disconsid	e
disconside	r
disconsider	a
disconsidera	t
disconsiderat	i
disconsiderati	o
disconsideratio	n
disconso	ln
disconsol	a
disconsola	t
disconsolat	e
disconson	a
disconsona	n
disconsonan	t
discont	ei
disconte	n
disconten	t
discontent	aefims
discontenta	t
discontentat	i
discontentati	o
discontentatio	n
discontente	d
discontentf	u
discontentfu	l
discontenti	n
discontentin	g
discontentm	e
discontentme	n
discontentmen	t
discontentment	s
disconti	n
discontin	u
discontinu	aeio
discontinua	nt
discontinuan	c
discontinuanc	e
discontinuat	i
discontinuati	o
discontinuatio	n
discontinuation	s
discontinue	ders
discontinuer	s
discontinui	nt
discontinuin	g
discontinuit	iy
discontinuiti	e
discontinuitie	s
discontinuo	ru
discontinuou	s
discop	h
discoph	i
discophi	l
discophil	e
discor	d
discord	aefios
discorda	n
discordan	ct
discordanc	e
discordant	l
discordantl	y
discorde	d
discordf	u
discordfu	l
discordi	n
discordin	g
discordo	u
discordou	s
discou	nr
discoun	t
discount	aeis
discounta	b
discountab	l
discountabl	e
discounte	dnr
discounten	a
discountena	n
discountenan	c
discountenanc	e
discounter	s
discounti	n
discountin	g
discour	ast
discoura	g
discourag	ei
discourage	admrs
discouragea	b
discourageab	l
discourageabl	e
discouragem	e
discourageme	n
discouragemen	t
discouragement	s
discourager	s
discouragi	n
discouragin	g
discouraging	l
discouragingl	y
discours	ei
discourse	drs
discourser	s
discoursi	n
discoursin	g
discourt	e
discourte	os
discourteo	u
discourteou	s
discourtes	y
discov	e
discove	nr
discoven	a
discovena	n
discovenan	t
discover	aeisy
discovera	b
discoverab	il
discoverabi	l
discoverabil	i
discoverabili	t
discoverabilit	y
discoverabl	y
discovere	dr
discoverer	s
discoveri	en
discoverie	s
discoverin	g
discr	eio
discre	dept
discred	ei
discrede	n
discreden	c
discredenc	e
discredi	bt
discredib	i
discredibi	l
discredibil	i
discredibili	t
discredibilit	y
discredit	aeis
discredita	b
discreditab	l
discreditabl	e
discredite	d
discrediti	n
discreditin	g
discree	t
discreet	eln
discreete	rs
discreetes	t
discreetl	y
discreetn	e
discreetne	s
discreetnes	s
discreetness	e
discreetnesse	s
discrep	a
discrepa	n
discrepan	ct
discrepanc	eiy
discrepance	s
discrepanci	e
discrepancie	s
discret	ei
discrete	ln
discretel	y
discreten	e
discretene	s
discretenes	s
discreti	o
discretio	n
discretion	as
discretiona	r
discretionar	y
discri	m
discrim	i
discrimi	n
discrimin	a
discrimina	nt
discriminan	t
discriminat	eio
discriminate	dlns
discriminatel	y
discriminaten	e
discriminatene	s
discriminatenes	s
discriminati	no
discriminatin	g
discriminating	l
discriminatingl	y
discriminatio	n
discrimination	as
discriminationa	l
discriminato	r
discriminator	iy
discriminatori	l
discriminatoril	y
discro	w
discrow	n
discu	rs
discur	s
discurs	i
discursi	v
discursiv	ei
discursive	ln
discursivel	y
discursiven	e
discursivene	s
discursivenes	s
discursiveness	e
discursivenesse	s
discursivi	t
discursivit	y
discus	es
discuse	s
discuss	aei
discussa	n
discussan	t
discusse	drs
discusser	s
discussi	no
discussin	g
discussio	n
discussion	ais
discussiona	l
discussioni	s
discussionis	t
disd	a
disda	i
disdai	n
disdain	aefis
disdaina	b
disdainab	l
disdainabl	e
disdaine	dr
disdainf	u
disdainfu	l
disdainful	l
disdainfull	y
disdaini	n
disdainin	g
dise	admnqs
disea	s
diseas	ei
disease	dfs
diseased	n
diseasedn	e
diseasedne	s
diseasednes	s
diseasedness	e
diseasednesse	s
diseasef	u
diseasefu	l
diseasi	n
diseasin	g
dised	gu
disedg	e
disedu	c
diseduc	a
diseduca	t
diseducat	e
disem	bp
disemb	aeor
disemba	r
disembar	k
disembark	aeims
disembarka	t
disembarkat	i
disembarkati	o
disembarkatio	n
disembarkation	s
disembarke	d
disembarki	n
disembarkin	g
disembarkm	e
disembarkme	n
disembarkmen	t
disembarkment	s
disembe	dl
disembel	l
disembell	i
disembelli	s
disembellis	h
disembo	dsw
disembod	iy
disembodi	m
disembodim	e
disembodime	n
disembodimen	t
disembos	o
disemboso	m
disembow	e
disembowe	l
disembr	ao
disembra	c
disembrac	e
disembro	i
disembroi	l
disemp	l
disempl	o
disemplo	y
disemploy	m
disemploym	e
disemployme	n
disemploymen	t
disen	cdfgjnrst
disenc	hu
disench	a
disencha	n
disenchan	t
disenchant	em
disenchante	d
disenchantm	e
disenchantme	n
disenchantmen	t
disencu	m
disencum	b
disencumb	e
disencumbe	r
disend	o
disendo	w
disenf	r
disenfr	a
disenfra	n
disenfran	c
disenfranc	h
disenfranch	i
disenfranchi	s
disenfranchis	ei
disenfranchise	dmrs
disenfranchisem	e
disenfranchiseme	n
disenfranchisemen	t
disenfranchisement	s
disenfranchisi	n
disenfranchisin	g
diseng	a
disenga	g
disengag	ei
disengage	dms
disengagem	e
disengageme	n
disengagemen	t
disengagi	n
disengagin	g
disenj	o
disenjo	y
disenn	o
disenno	b
disennob	l
disennobl	e
disenr	o
disenro	l
disens	l
disensl	a
disensla	v
disenslav	e
disent	ahorw
disenta	n
disentan	g
disentang	l
disentangl	ei
disentangle	dmrs
disentanglem	e
disentangleme	n
disentanglemen	t
disentanglement	s
disentangler	s
disentangli	n
disentanglin	g
disenth	r
disenthr	a
disenthra	l
disenthral	lm
disenthralm	e
disenthralme	n
disenthralmen	t
disento	m
disentom	b
disentr	a
disentra	mn
disentram	m
disentramm	e
disentramme	l
disentran	c
disentranc	e
disentw	i
disentwi	n
disentwin	e
diseq	u
disequ	ai
disequa	l
disequal	i
disequali	t
disequalit	y
disequi	l
disequil	i
disequili	b
disequilib	r
disequilibr	i
disequilibri	u
disequilibriu	m
dises	pt
disesp	o
disespo	u
disespou	s
disespous	e
disest	e
diseste	e
disestee	m
disf	ailor
disfa	iv
disfai	t
disfait	h
disfav	o
disfavo	ru
disfavou	r
disfi	g
disfig	u
disfigu	r
disfigur	ei
disfigure	dmrs
disfigurem	e
disfigureme	n
disfiguremen	t
disfigurement	s
disfigurer	s
disfiguri	n
disfigurin	g
disfiguring	l
disfiguringl	y
disfl	e
disfle	s
disfles	h
disfo	r
disfor	e
disfore	s
disfores	t
disfr	ao
disfra	n
disfran	c
disfranc	h
disfranch	i
disfranchi	s
disfranchis	e
disfranchise	m
disfranchisem	e
disfranchiseme	n
disfranchisemen	t
disfro	c
disfroc	k
disg	aoru
disga	r
disgar	lr
disgarl	a
disgarla	n
disgarlan	d
disgarr	i
disgarri	s
disgarris	o
disgarriso	n
disgo	ru
disgor	g
disgorg	e
disgou	t
disgr	au
disgra	c
disgrac	ei
disgrace	dfrs
disgracef	u
disgracefu	l
disgraceful	ln
disgracefull	y
disgracefuln	e
disgracefulne	s
disgracefulnes	s
disgracefulness	e
disgracefulnesse	s
disgracer	s
disgraci	n
disgracin	g
disgru	n
disgrun	t
disgrunt	l
disgruntl	e
disgruntle	d
disgruntled	ln
disgruntledl	y
disgruntledn	e
disgruntledne	s
disgruntlednes	s
disgu	ils
disgui	s
disguis	aei
disguisa	b
disguisab	l
disguisabl	e
disguise	dlmrs
disguised	ln
disguisedl	y
disguisedn	e
disguisedne	s
disguisednes	s
disguisedness	e
disguisednesse	s
disguisel	e
disguisele	s
disguiseles	s
disguisem	e
disguiseme	n
disguisemen	t
disguisement	s
disguiser	s
disguisi	n
disguisin	g
disgul	f
disgus	t
disgust	efis
disguste	dr
disgusted	ln
disgustedl	y
disgustedn	e
disgustedne	s
disgustednes	s
disgustedness	e
disgustednesse	s
disgustf	u
disgustfu	l
disgusti	n
disgustin	g
disgusting	ln
disgustingl	y
disgustingn	e
disgustingne	s
disgustingnes	s
disgustingness	e
disgustingnesse	s
dish	acefilnotuwy
disha	blru
dishab	i
dishabi	lt
dishabil	il
dishabili	t
dishabilit	a
dishabilita	t
dishabilitat	i
dishabilitati	o
dishabilitatio	n
dishabill	e
dishabit	u
dishabitu	a
dishabitua	t
dishabituat	e
dishal	l
dishall	u
dishallu	c
dishalluc	i
dishalluci	n
dishallucin	a
dishallucina	t
dishallucinat	i
dishallucinati	o
dishallucinatio	n
dishar	m
disharm	o
disharmo	n
disharmon	iy
disharmoni	o
disharmonio	u
disharmoniou	s
dishau	n
dishaun	t
dishc	l
dishcl	o
dishclo	t
dishclot	h
dishe	adsv
dishea	r
dishear	t
disheart	e
dishearte	n
dishearten	ei
disheartene	d
dishearteni	n
disheartenin	g
disheartening	l
dishearteningl	y
dishev	e
disheve	l
dishevel	el
dishevele	d
dishevell	e
dishevelle	d
dishf	u
dishfu	l
dishi	n
dishin	g
dishl	i
dishli	k
dishlik	e
dishn	e
dishne	t
dishnet	w
dishnetw	o
dishnetwo	r
dishnetwor	k
disho	mnru
dishom	e
dishon	eo
dishone	s
dishones	t
dishonest	ly
dishonestl	y
dishono	ru
dishonor	aeis
dishonora	b
dishonorab	l
dishonorabl	e
dishonore	d
dishonori	n
dishonorin	g
dishonou	r
dishonour	eis
dishonoure	d
dishonouri	n
dishonourin	g
dishor	s
dishors	e
dishou	s
dishous	e
disht	o
dishto	w
dishtow	e
dishtowe	l
dishtowel	s
dishu	m
dishum	ao
dishuma	n
dishuman	i
dishumani	z
dishumaniz	e
dishumo	u
dishumou	r
dishw	a
dishwa	rst
dishwar	e
dishwas	h
dishwash	ei
dishwashe	r
dishwasher	s
dishwashi	n
dishwashin	g
dishwat	e
dishwate	r
disi	lmn
disil	l
disill	u
disillu	s
disillus	i
disillusi	ov
disillusio	n
disillusion	aeims
disillusiona	r
disillusionar	y
disillusione	dr
disillusioni	ns
disillusionin	g
disillusionis	t
disillusionm	e
disillusionme	n
disillusionmen	t
disillusionment	s
disillusiv	e
disim	amp
disima	g
disimag	i
disimagi	n
disimagin	e
disimm	u
disimmu	r
disimmur	e
disimp	alr
disimpa	ls
disimpal	e
disimpas	s
disimpass	i
disimpassi	o
disimpassio	n
disimpassion	e
disimpassione	d
disimpl	i
disimpli	c
disimplic	a
disimplica	t
disimplicat	e
disimpr	i
disimpri	s
disimpris	o
disimpriso	n
disimprison	m
disimprisonm	e
disimprisonme	n
disimprisonmen	t
disin	cdfghtv
disinc	alo
disinca	r
disincar	c
disincarc	e
disincarce	r
disincarcer	a
disincarcera	t
disincarcerat	ei
disincarcerati	o
disincarceratio	n
disincl	i
disincli	n
disinclin	ae
disinclina	t
disinclinat	i
disinclinati	o
disinclinatio	n
disincline	d
disinco	r
disincor	p
disincorp	o
disincorpo	r
disincorpor	a
disincorpora	t
disincorporat	ei
disincorporate	d
disincorporati	o
disincorporatio	n
disind	i
disindi	v
disindiv	i
disindivi	d
disindivid	u
disindividu	a
disindividua	l
disindividual	i
disindividuali	z
disindividualiz	e
disinf	eo
disinfe	cs
disinfec	t
disinfect	aeios
disinfecta	n
disinfectan	t
disinfectant	s
disinfecte	d
disinfecti	nov
disinfectin	g
disinfectio	n
disinfection	s
disinfectiv	e
disinfecto	r
disinfector	s
disinfes	t
disinfest	a
disinfesta	t
disinfestat	i
disinfestati	o
disinfestatio	n
disinfo	r
disinfor	m
disinform	a
disinforma	t
disinformat	i
disinformati	o
disinformatio	n
dising	e
disinge	n
disingen	u
disingenu	o
disingenuo	u
disingenuou	s
disinh	aeiu
disinha	b
disinhab	i
disinhabi	t
disinhe	r
disinher	i
disinheri	t
disinherit	aeis
disinherita	bn
disinheritab	l
disinheritabl	e
disinheritan	c
disinheritanc	e
disinheritance	s
disinherite	d
disinheriti	n
disinheritin	g
disinhi	b
disinhib	i
disinhibi	t
disinhibit	o
disinhibito	r
disinhibitor	y
disinhu	m
disinhum	e
disint	e
disinte	gr
disinteg	r
disintegr	ai
disintegra	bt
disintegrab	l
disintegrabl	e
disintegrat	eio
disintegrate	ds
disintegrati	nov
disintegratin	g
disintegratio	n
disintegration	s
disintegrativ	e
disintegrative	l
disintegrativel	y
disintegrato	r
disintegrator	sy
disintegri	t
disintegrit	y
disinter	e
disintere	s
disinteres	t
disinterest	eis
disintereste	d
disinterested	ln
disinterestedl	y
disinterestedn	e
disinterestedne	s
disinterestednes	s
disinteresti	n
disinterestin	g
disinv	eo
disinve	s
disinves	t
disinvest	m
disinvestm	e
disinvestme	n
disinvestmen	t
disinvo	l
disinvol	v
disinvolv	e
disj	ou
disjo	i
disjoi	n
disjoin	t
disjoint	eln
disjointe	d
disjointed	ln
disjointedl	y
disjointedn	e
disjointedne	s
disjointednes	s
disjointedness	e
disjointednesse	s
disjointl	y
disjointn	e
disjointne	s
disjointnes	s
disju	n
disjun	c
disjunc	t
disjunct	is
disjuncti	ov
disjunctio	n
disjunction	s
disjunctiv	e
disjunctive	l
disjunctivel	y
disk	egilosu
diske	dt
disket	t
diskett	e
diskette	s
diskg	e
diskge	n
diskgen	i
diskgeni	u
diskgeniu	s
diski	n
diskin	dg
diskind	n
diskindn	e
diskindne	s
diskindnes	s
diskl	ei
diskle	s
diskles	s
diskli	k
disklik	e
disko	p
diskop	e
diskope	r
diskoper	a
diskopera	t
diskoperat	i
diskoperati	n
diskoperatin	g
diskoperating	s
diskoperatings	y
diskoperatingsy	s
diskoperatingsys	t
diskoperatingsyst	e
diskoperatingsyste	m
disku	t
diskut	i
diskuti	l
diskutil	i
diskutili	t
diskutilit	y
disl	eiou
disle	a
dislea	f
disli	kmn
dislik	ei
dislike	dflnrs
dislikef	u
dislikefu	l
dislikel	i
dislikeli	h
dislikelih	o
dislikeliho	o
dislikelihoo	d
disliken	e
dislikene	s
dislikenes	s
disliker	s
disliki	n
dislikin	g
dislim	b
dislin	k
dislo	acdy
disloa	d
disloc	a
disloca	t
dislocat	eio
dislocate	ds
dislocated	l
dislocatedl	y
dislocati	nov
dislocatin	g
dislocatio	n
dislocation	s
dislocativ	e
dislocato	r
dislocator	y
dislod	g
dislodg	eim
dislodge	adms
dislodgea	b
dislodgeab	l
dislodgeabl	e
dislodgem	e
dislodgeme	n
dislodgemen	t
dislodgement	s
dislodgi	n
dislodgin	g
dislodgm	e
dislodgme	n
dislodgmen	t
dislodgment	s
disloy	a
disloya	l
disloyal	ilt
disloyali	s
disloyalis	t
disloyalist	s
disloyall	y
disloyalt	y
dislu	s
dislus	t
dislust	r
dislustr	e
dism	aeio
disma	lnrsy
dismal	eilns
dismale	rs
dismales	t
dismali	tz
dismalit	iy
dismaliti	e
dismalitie	s
dismaliz	e
dismall	y
dismaln	e
dismalne	s
dismalnes	s
dismalness	e
dismalnesse	s
disman	t
dismant	l
dismantl	ei
dismantle	dmrs
dismantlem	e
dismantleme	n
dismantlemen	t
dismantlement	s
dismantler	s
dismantli	n
dismantlin	g
dismar	b
dismarb	l
dismarbl	e
dismas	t
dismay	efis
dismaye	dr
dismayed	n
dismayedn	e
dismayedne	s
dismayednes	s
dismayedness	e
dismayednesse	s
dismayf	u
dismayfu	l
dismayful	l
dismayfull	y
dismayi	n
dismayin	g
dismaying	l
dismayingl	y
disme	m
dismem	b
dismemb	e
dismembe	r
dismember	eims
dismembere	dr
dismemberer	s
dismemberi	n
dismemberin	g
dismemberm	e
dismemberme	n
dismembermen	t
dismemberment	s
dismi	s
dismis	s
dismiss	aei
dismissa	bl
dismissab	l
dismissabl	e
dismissal	s
dismisse	drs
dismisser	s
dismissi	nov
dismissin	g
dismissio	n
dismission	s
dismissiv	e
dismissive	ln
dismissivel	y
dismissiven	e
dismissivene	s
dismissivenes	s
dismo	u
dismou	n
dismoun	t
dismount	eis
dismounte	d
dismounti	n
dismountin	g
disn	e
disne	sy
disnes	t
disney	l
disneyl	a
disneyla	n
disneylan	d
diso	bcrwx
disob	els
disobe	dy
disobed	i
disobedi	e
disobedie	n
disobedien	ct
disobedienc	e
disobedient	l
disobedientl	y
disobey	eis
disobeye	dr
disobeyer	s
disobeyi	n
disobeyin	g
disobl	i
disobli	g
disoblig	ei
disobligi	n
disobligin	g
disobs	t
disobst	r
disobstr	u
disobstru	c
disobstruc	t
disoc	c
disocc	u
disoccu	p
disoccup	ay
disoccupa	t
disoccupat	i
disoccupati	o
disoccupatio	n
disor	dgi
disord	e
disorde	r
disorder	eils
disordere	dr
disordered	ln
disorderedl	y
disorderedn	e
disorderedne	s
disorderednes	s
disorderedness	e
disorderednesse	s
disorderi	n
disorderin	g
disorderl	iy
disorderli	n
disorderlin	e
disorderline	s
disorderlines	s
disorderliness	e
disorderlinesse	s
disorg	a
disorga	n
disorgan	i
disorgani	csz
disorganis	e
disorganise	d
disorganiz	ae
disorganiza	t
disorganizat	i
disorganizati	o
disorganizatio	n
disorganize	d
disori	e
disorie	n
disorien	t
disorient	a
disorienta	t
disorientat	ei
disorientate	ds
disorientati	no
disorientatin	g
disorientatio	n
disorientation	s
disow	n
disown	eims
disowne	dr
disowni	n
disownin	g
disownm	e
disownme	n
disownmen	t
disownment	s
disox	iy
disoxi	d
disoxid	a
disoxida	t
disoxidat	e
disoxy	g
disoxyg	e
disoxyge	n
disoxygen	a
disoxygena	t
disoxygenat	e
disp	aeiloru
dispa	rstu
dispar	ai
dispara	gt
disparag	ei
disparage	admrs
disparagea	b
disparageab	l
disparageabl	e
disparagem	e
disparageme	n
disparagemen	t
disparagement	s
disparager	s
disparagi	n
disparagin	g
disparaging	l
disparagingl	y
disparat	e
dispari	st
disparis	h
disparit	iy
dispariti	e
disparitie	s
dispas	s
dispass	i
dispassi	o
dispassio	n
dispassion	a
dispassiona	t
dispassionat	e
dispat	c
dispatc	h
dispatch	efi
dispatche	drs
dispatcher	s
dispatchf	u
dispatchfu	l
dispatchi	n
dispatchin	g
dispau	p
dispaup	e
dispaupe	r
dispauper	i
dispauperi	z
dispauperiz	e
dispe	alnrt
dispea	c
dispeac	e
dispel	ls
dispell	aei
dispella	b
dispellab	l
dispellabl	e
dispelle	dr
dispeller	s
dispelli	n
dispellin	g
dispen	s
dispens	aei
dispensa	brt
dispensab	il
dispensabi	l
dispensabil	i
dispensabili	t
dispensabilit	iy
dispensabiliti	e
dispensabilitie	s
dispensabl	ey
dispensable	n
dispensablen	e
dispensablene	s
dispensablenes	s
dispensableness	e
dispensablenesse	s
dispensar	iy
dispensari	e
dispensarie	s
dispensat	i
dispensati	o
dispensatio	n
dispense	drs
dispenser	s
dispensi	n
dispensin	g
disper	s
dispers	aei
dispersa	bl
dispersab	il
dispersabi	l
dispersabil	i
dispersabili	t
dispersabilit	y
dispersabl	e
dispersal	s
disperse	dmrs
dispersed	ln
dispersedl	y
dispersedn	e
dispersedne	s
dispersednes	s
dispersem	e
disperseme	n
dispersemen	t
disperser	s
dispersi	bno
dispersib	il
dispersibi	l
dispersibil	i
dispersibili	t
dispersibilit	iy
dispersibiliti	e
dispersibilitie	s
dispersibl	e
dispersin	g
dispersio	n
dispersion	s
dispet	a
dispeta	l
dispi	rt
dispir	i
dispiri	t
dispirit	e
dispirite	d
dispit	e
dispite	o
dispiteo	u
dispiteou	s
displ	aeu
displa	cy
displac	ei
displace	adms
displacea	b
displaceab	il
displaceabi	l
displaceabil	i
displaceabili	t
displaceabilit	y
displaceabl	e
displacem	e
displaceme	n
displacemen	t
displacement	s
displaci	nv
displacin	g
displaciv	e
display	aeis
displaya	b
displayab	l
displayabl	e
displaye	dr
displayer	s
displayi	n
displayin	g
disple	a
displea	s
displeas	eiu
displease	ds
displeased	n
displeasedn	e
displeasedne	s
displeasednes	s
displeasi	n
displeasin	g
displeasing	ln
displeasingl	y
displeasingn	e
displeasingne	s
displeasingnes	s
displeasingness	e
displeasingnesse	s
displeasu	r
displeasur	aei
displeasura	b
displeasurab	l
displeasurabl	ey
displeasure	ads
displeasurea	b
displeasureab	l
displeasureabl	ey
displeasuri	n
displeasurin	g
displu	m
displum	e
dispo	prs
dispop	e
dispor	t
dispos	aeis
disposa	bl
disposab	il
disposabi	l
disposabil	i
disposabili	t
disposabilit	iy
disposabiliti	e
disposabilitie	s
disposabl	ey
disposable	n
disposablen	e
disposablene	s
disposablenes	s
disposableness	e
disposablenesse	s
disposal	s
dispose	drs
disposer	s
disposi	nt
disposin	g
disposing	l
disposingl	y
disposit	i
dispositi	o
dispositio	n
disposition	aes
dispositiona	l
dispositional	l
dispositionall	y
dispositione	d
disposs	e
disposse	s
disposses	s
dispossess	ei
dispossesse	d
dispossessi	o
dispossessio	n
dispr	aio
dispra	i
disprai	s
disprais	e
dispri	v
dispriv	i
disprivi	l
disprivil	e
disprivile	g
disprivileg	e
dispro	fopv
disprof	e
disprofe	s
disprofes	s
disproo	f
disprop	eo
disprope	r
disproper	t
dispropert	y
dispropo	r
dispropor	t
disproport	i
disproporti	o
disproportio	n
disproportion	a
disproportiona	lt
disproportionat	e
disproportionate	ln
disproportionatel	y
disproportionaten	e
disproportionatene	s
disproportionatenes	s
disproportionateness	e
disproportionatenesse	s
disprov	aei
disprova	bl
disprovab	l
disprovabl	e
disprove	dmrs
disprovem	e
disproveme	n
disprovemen	t
disprover	s
disprovi	n
disprovin	g
dispu	t
disput	aei
disputa	bnt
disputab	il
disputabi	l
disputabil	i
disputabili	t
disputabilit	y
disputabl	ey
disputan	t
disputat	i
disputati	o
disputatio	n
dispute	dlrs
disputel	e
disputele	s
disputeles	s
disputer	s
disputi	n
disputin	g
disq	u
disqu	ais
disqua	l
disqual	i
disquali	f
disqualif	iy
disqualifi	ace
disqualifia	b
disqualifiab	l
disqualifiabl	e
disqualific	a
disqualifica	t
disqualificat	i
disqualificati	o
disqualificatio	n
disqualifie	ds
disqualify	i
disqualifyi	n
disqualifyin	g
disqui	es
disquie	t
disquiet	i
disquieti	n
disquietin	g
disquis	i
disquisi	t
disquisit	i
disquisiti	o
disquisitio	n
disr	aeou
disra	et
disrae	l
disrael	i
disrat	e
disre	acglpsv
disrea	l
disreal	i
disreali	z
disrealiz	e
disrec	o
disreco	m
disrecom	m
disrecomm	e
disrecomme	n
disrecommen	d
disrecommend	a
disrecommenda	t
disrecommendat	i
disrecommendati	o
disrecommendatio	n
disreg	a
disrega	r
disregar	d
disregard	aeis
disregarda	bn
disregardab	l
disregardabl	e
disregardan	t
disregarde	dr
disregarder	s
disregardi	n
disregardin	g
disrel	a
disrela	t
disrelat	e
disrep	au
disrepa	i
disrepai	r
disrepair	s
disrepu	t
disreput	ae
disreputa	b
disreputab	il
disreputabi	l
disreputabil	i
disreputabili	t
disreputabilit	i
disreputabiliti	e
disreputabilitie	s
disreputabl	ey
disreputable	n
disreputablen	e
disreputablene	s
disreputablenes	s
disreputableness	e
disreputablenesse	s
disrepute	s
disres	pt
disresp	e
disrespe	c
disrespec	t
disrespect	efis
disrespecte	dr
disrespectf	u
disrespectfu	l
disrespectful	ln
disrespectfull	y
disrespectfuln	e
disrespectfulne	s
disrespectfulnes	s
disrespectfulness	e
disrespectfulnesse	s
disrespecti	n
disrespectin	g
disrev	e
disreve	r
disrever	e
disrevere	n
disreveren	c
disreverenc	e
disro	bo
disrob	e
disroo	ft
disru	p
disrup	t
disrupt	eios
disrupte	dr
disrupter	s
disrupti	nov
disruptin	g
disruptio	n
disruption	s
disruptiv	e
disruptive	ln
disruptivel	y
disruptiven	e
disruptivene	s
disruptivenes	s
disruptiveness	e
disruptivenesse	s
disrupto	r
disruptor	s
diss	acehiouy
dissa	t
dissat	i
dissati	s
dissatis	f
dissatisf	aiy
dissatisfa	c
dissatisfac	t
dissatisfact	io
dissatisfacti	o
dissatisfactio	n
dissatisfaction	s
dissatisfacto	r
dissatisfactor	y
dissatisfi	e
dissatisfie	d
dissatisfied	ln
dissatisfiedl	y
dissatisfiedn	e
dissatisfiedne	s
dissatisfiednes	s
dissatisfiedness	e
dissatisfiednesse	s
dissc	e
dissce	p
disscep	t
disscept	r
dissceptr	e
disse	cmnprv
dissec	t
dissect	eios
dissecte	d
dissecti	bnov
dissectib	l
dissectibl	e
dissectin	g
dissectio	n
dissectiv	e
dissecto	r
dissector	s
dissem	bi
dissemb	l
dissembl	ae
dissembla	n
dissemblan	c
dissemblanc	e
dissemblance	s
dissemble	r
dissemi	n
dissemin	a
dissemina	t
disseminat	ei
disseminate	ds
disseminati	no
disseminatin	g
disseminatio	n
dissen	st
dissens	i
dissensi	o
dissensio	n
dissension	s
dissent	eims
dissente	dr
dissenter	s
dissenti	eno
dissentie	n
dissentien	t
dissentin	g
dissenting	l
dissentingl	y
dissentio	u
dissentiou	s
dissentm	e
dissentme	n
dissentmen	t
dissep	u
dissepu	l
dissepul	c
dissepulc	h
dissepulch	r
dissepulchr	e
dissepulchre	d
disser	tv
dissert	a
disserta	t
dissertat	io
dissertati	o
dissertatio	n
dissertation	ais
dissertationa	l
dissertationi	s
dissertationis	t
dissertationist	s
dissertato	r
disserv	ei
disservi	c
disservic	ei
disservice	ads
disservicea	b
disserviceab	l
disserviceabl	e
disservici	n
disservicin	g
dissev	e
disseve	r
dissh	aeir
dissha	d
disshad	o
disshado	w
disshe	a
disshea	t
dissheat	h
dissheath	e
disshi	v
disshiv	e
disshive	r
disshr	o
disshro	u
disshrou	d
dissi	dgmp
dissid	e
disside	n
dissiden	ct
dissidenc	e
dissident	ls
dissidentl	y
dissig	h
dissigh	t
dissight	l
dissightl	y
dissim	iu
dissimi	l
dissimil	ai
dissimila	rt
dissimilar	il
dissimilari	t
dissimilarit	iy
dissimilariti	e
dissimilaritie	s
dissimilarl	y
dissimilat	e
dissimili	t
dissimilit	u
dissimilitu	d
dissimilitud	e
dissimu	l
dissimul	a
dissimula	t
dissimulat	eio
dissimulati	o
dissimulatio	n
dissimulato	r
dissip	a
dissipa	t
dissipat	eio
dissipate	drs
dissipati	no
dissipatin	g
dissipatio	n
dissipato	r
disso	clnu
dissoc	i
dissoci	a
dissocia	t
dissociat	ei
dissociate	ds
dissociati	nov
dissociatin	g
dissociatio	n
dissociativ	e
dissol	uv
dissolu	t
dissolut	ei
dissoluti	o
dissolutio	n
dissolution	s
dissolv	aei
dissolva	b
dissolvab	il
dissolvabi	l
dissolvabil	i
dissolvabili	t
dissolvabilit	iy
dissolvabiliti	e
dissolvabilitie	s
dissolvabl	e
dissolvable	n
dissolvablen	e
dissolvablene	s
dissolvablenes	s
dissolvableness	e
dissolvablenesse	s
dissolve	dnrs
dissolven	t
dissolvent	s
dissolver	s
dissolvi	n
dissolvin	g
dissolving	l
dissolvingl	y
disson	a
dissona	n
dissonan	ct
dissonanc	e
dissou	l
dissu	an
dissua	ds
dissuad	aei
dissuada	b
dissuadab	l
dissuadabl	e
dissuade	drs
dissuader	s
dissuadi	n
dissuadin	g
dissuas	i
dissuasi	ov
dissuasio	n
dissuasiv	e
dissun	d
dissund	e
dissunde	r
dissy	lm
dissyl	l
dissyll	a
dissylla	b
dissyllab	i
dissyllabi	c
dissym	p
dissymp	a
dissympa	t
dissympat	h
dissympath	y
dist	aeioru
dista	flns
distaf	f
distal	l
distall	y
distan	ct
distanc	ei
distance	dls
distancel	e
distancele	s
distanceles	s
distanci	n
distancin	g
distant	ln
distantl	y
distantn	e
distantne	s
distantnes	s
distantness	e
distantnesse	s
distas	t
distast	ei
distaste	dfs
distastef	u
distastefu	l
distasteful	ln
distastefull	y
distastefuln	e
distastefulne	s
distastefulnes	s
distastefulness	e
distastefulnesse	s
distasti	n
distastin	g
diste	mn
distem	p
distemp	e
distempe	r
distemper	es
distempere	d
disten	ads
distena	n
distenan	t
distend	eis
distende	dr
distended	l
distendedl	y
distender	s
distendi	bn
distendib	l
distendibl	e
distendin	g
distens	i
distensi	bo
distensib	l
distensibl	e
distensio	n
disti	cln
distic	h
distil	ls
distill	aeis
distilla	t
distillat	i
distillati	o
distillatio	n
distille	dr
distiller	isy
distilleri	e
distillerie	s
distilli	n
distillin	g
distin	cg
distinc	t
distinct	eiln
distincte	rs
distinctes	t
distincti	ov
distinctio	n
distinction	ls
distinctionl	e
distinctionle	s
distinctionles	s
distinctiv	e
distinctive	ln
distinctivel	y
distinctiven	e
distinctivene	s
distinctivenes	s
distinctiveness	e
distinctivenesse	s
distinctl	y
distinctn	e
distinctne	s
distinctnes	s
distinctness	e
distinctnesse	s
disting	u
distingu	is
distingui	s
distinguis	h
distinguish	aeim
distinguisha	b
distinguishab	il
distinguishabi	l
distinguishabil	i
distinguishabili	t
distinguishabilit	i
distinguishabiliti	e
distinguishabilitie	s
distinguishabl	ey
distinguishable	n
distinguishablen	e
distinguishablene	s
distinguishablenes	s
distinguishableness	e
distinguishablenesse	s
distinguishe	drs
distinguished	l
distinguishedl	y
distinguisher	s
distinguishi	n
distinguishin	g
distinguishm	e
distinguishme	n
distinguishmen	t
distinguishment	s
distingus	i
distingusi	h
distingusih	e
distingusihe	d
disto	r
distor	t
distort	aeis
distorta	b
distortab	l
distortabl	e
distorte	dr
distorter	s
distorti	nov
distortin	g
distorting	l
distortingl	y
distortio	n
distortion	s
distortiv	e
distr	aeiu
distra	ciu
distrac	t
distract	aefis
distracta	b
distractab	il
distractabi	l
distractabil	i
distractabili	t
distractabilit	y
distractabl	e
distracte	d
distracted	ln
distractedl	y
distractedn	e
distractedne	s
distractednes	s
distractedness	e
distractednesse	s
distractf	u
distractfu	l
distracti	bno
distractib	il
distractibi	l
distractibil	i
distractibili	t
distractibilit	iy
distractibiliti	e
distractibilitie	s
distractibl	e
distractin	g
distracting	l
distractingl	y
distractio	n
distraction	s
distrai	n
distrain	t
distrau	g
distraug	h
distraugh	t
distraught	ln
distraughtl	y
distraughtn	e
distraughtne	s
distraughtnes	s
distre	s
distres	st
distress	efi
distresse	ds
distressf	u
distressfu	l
distressi	n
distressin	g
distressing	l
distressingl	y
distri	bc
distrib	u
distribu	t
distribut	aeio
distributa	r
distributar	y
distribute	des
distributee	s
distributi	nosv
distributin	g
distributio	n
distribution	ais
distributiona	l
distributional	l
distributionall	y
distributioni	s
distributionis	t
distributis	t
distributiv	ei
distributivi	t
distributivit	y
distributo	r
distributor	s
distributors	h
distributorsh	i
distributorshi	p
distric	t
district	eis
districte	d
districti	n
districtin	g
distru	s
distrus	t
distrust	efils
distruste	dr
distruster	s
distrustf	u
distrustfu	l
distrusti	n
distrustin	g
distrustl	e
distrustle	s
distrustles	s
distu	nr
distun	e
distur	bn
disturb	aeis
disturba	nt
disturban	c
disturbanc	e
disturbance	s
disturbat	i
disturbati	v
disturbativ	e
disturbe	dr
disturbed	ls
disturbedl	y
disturber	s
disturbi	n
disturbin	g
disturbing	l
disturbingl	y
disturn	p
disturnp	i
disturnpi	k
disturnpik	e
disu	ns
disun	i
disuni	fot
disunif	oy
disunifo	r
disunifor	m
disuniform	i
disuniformi	t
disuniformit	y
disunio	n
disunit	ey
disus	ei
disuse	ds
disusi	n
disusin	g
disv	eou
disve	is
disvei	l
disves	t
disvo	u
disvou	c
disvouc	h
disvu	l
disvul	n
disvuln	e
disvulne	r
disvulner	a
disvulnera	b
disvulnerab	i
disvulnerabi	l
disvulnerabil	i
disvulnerabili	t
disvulnerabilit	y
disw	aio
diswa	r
diswar	r
diswarr	e
diswarre	n
diswi	g
diswo	o
diswoo	d
dit	chtz
ditc	h
ditch	eil
ditche	drs
ditchi	n
ditchin	g
ditchl	e
ditchle	s
ditchles	s
dith	ey
dithe	r
dither	eisy
dithere	dr
ditherer	s
ditheri	n
ditherin	g
dithy	r
dithyr	a
dithyra	m
dithyram	b
ditt	oy
ditto	eis
dittoe	ds
dittoi	n
dittoin	g
ditz	e
ditze	l
diu	mr
dium	o
diumo	o
diur	en
diure	t
diuret	i
diureti	c
diurn	a
diurna	l
diurnal	ilns
diurnali	s
diurnalis	t
diurnall	y
diurnaln	e
diurnalne	s
diurnalnes	s
diurnalness	e
diurnalnesse	s
div	aeiouvx
diva	ln
dival	e
divale	n
divalen	t
divan	s
dive	drs
diver	glst
diverg	ei
diverge	dmns
divergem	e
divergeme	n
divergemen	t
divergen	ct
divergenc	e
divergence	s
divergi	n
divergin	g
diverging	l
divergingl	y
diverl	e
diverle	s
diverles	s
divers	ei
diverse	ln
diversel	y
diversen	e
diversene	s
diversenes	s
diverseness	e
diversenesse	s
diversi	fot
diversif	iy
diversifi	ace
diversifia	b
diversifiab	il
diversifiabi	l
diversifiabil	i
diversifiabili	t
diversifiabilit	iy
diversifiabiliti	e
diversifiabilitie	s
diversifiabl	e
diversific	a
diversifica	t
diversificat	i
diversificati	o
diversificatio	n
diversification	s
diversifie	drs
diversifier	s
diversify	i
diversifyi	n
diversifyin	g
diversio	n
diversion	ais
diversiona	lr
diversionar	y
diversioni	s
diversionis	m
diversit	iy
diversiti	e
diversitie	s
divert	eios
diverte	dr
diverted	l
divertedl	y
diverter	s
diverti	bnv
divertib	il
divertibi	l
divertibil	i
divertibili	t
divertibilit	y
divertibl	e
divertin	g
diverting	n
divertingn	e
divertingne	s
divertingnes	s
divertiv	e
diverto	r
dives	t
divest	eis
diveste	d
divesti	nt
divestin	g
divestit	u
divestitu	r
divestitur	e
divi	dns
divid	ei
divide	dnrs
dividen	d
dividend	ls
dividendl	e
dividendle	s
dividendles	s
divider	s
dividi	n
dividin	g
divin	aegi
divina	bt
divinab	l
divinabl	e
divinat	i
divinati	o
divinatio	n
divine	dlnrs
divinel	y
divinen	e
divinene	s
divinenes	s
divineness	e
divinenesse	s
divines	t
divini	nt
divinin	g
divinit	iy
diviniti	e
divinitie	s
divis	io
divisi	bov
divisib	il
divisibi	l
divisibil	i
divisibili	t
divisibilit	iy
divisibiliti	e
divisibilitie	s
divisibl	ey
divisible	n
divisiblen	e
divisiblene	s
divisiblenes	s
divisibleness	e
divisiblenesse	s
divisio	n
division	as
divisiona	lr
divisional	l
divisionall	y
divisionar	y
divisiv	e
divisive	ln
divisivel	y
divisiven	e
divisivene	s
divisivenes	s
divisiveness	e
divisivenesse	s
diviso	r
divisor	s
divo	rt
divor	c
divorc	ei
divorce	adelmrs
divorcea	b
divorceab	l
divorceabl	e
divorcee	s
divorcel	e
divorcele	s
divorceles	s
divorcem	e
divorceme	n
divorcemen	t
divorcement	s
divorcer	s
divorci	nv
divorcin	g
divorciv	e
divu	l
divul	gs
divulg	ei
divulge	dmnrs
divulgem	e
divulgeme	n
divulgemen	t
divulgement	s
divulgen	c
divulgenc	e
divulgence	s
divulger	s
divulgi	n
divulgin	g
divuls	i
divulsi	o
divulsio	n
divv	y
diw	a
diwa	l
diwal	i
diwali	s
dix	io
dixi	e
dixie	cl
dixiec	r
dixiecr	a
dixiecra	t
dixiecrat	s
dixiel	a
dixiela	n
dixielan	d
dixo	n
diy	s
diz	oz
dizz	iy
dizzi	eln
dizzie	drs
dizzies	t
dizzil	y
dizzin	e
dizzine	s
dizzines	s
dizziness	e
dizzinesse	s
dizzy	i
dizzyi	n
dizzyin	g
dizzying	l
dizzyingl	y
dj	acegijklmnoqrsuv
dja	ekn
djak	a
djaka	r
djakar	t
djakart	a
djan	g
djang	o
djc	s
dje	d
djg	n
dji	b
djib	o
djibo	u
djibou	t
djibout	i
djj	rsv
djm	el
djn	g
djo	r
djq	as
djr	rsw
djv	u
dk	aehilmnowxyz
dkh	v
dki	v
dkn	v
dko	e
dkx	rsv
dky	v
dl	abcdehklnopqrsuvwxz
dla	rv
dlb	v
dld	j
dlh	opv
dll	b
dln	orv
dlo	bkmopst
dlok	v
dlos	v
dlr	bu
dls	bikmtv
dlsi	t
dlsit	e
dlu	l
dlz	p
dm	abcdeghilmor
dma	r
dmar	c
dmc	as
dmd	v
dmi	ktz
dmit	r
dmitr	i
dml	v
dmo	b
dmob	o
dn	abcdefgiklmoprsuxy
dna	rsv
dnas	e
dnb	filmw
dnc	bprv
dncp	v
dncr	rv
dnd	ls
dne	beo
dnf	irv
dng	f
dni	e
dnie	p
dniep	e
dniepe	r
dnk	b
dnkb	v
dnl	bimw
dnli	v
dnm	fruvw
dno	frv
dnp	b
dnpb	v
dnr	qr
dns	bmops
dnsm	a
dnsma	s
dnsmas	q
dnso	v
dnsov	e
dnsove	r
dnsover	hq
dnsoverh	t
dnsoverht	t
dnsoverhtt	p
dnsoverhttp	s
dnsoverq	u
dnsoverqu	i
dnsoverqui	c
dnsp	o
dnspo	d
dnss	e
dnsse	c
dnx	rv
dny	o
dnyo	v
do	abcdefghijklmnopqrstuvwxyz
doa	bm
doab	l
doabl	e
dob	befs
dobb	eis
dobbe	r
dobbi	n
dobe	r
dober	m
doberm	a
doberma	n
doberman	n
dobs	o
dobso	n
dobson	f
dobsonf	l
dobsonfl	y
doc	bikstux
docb	o
docbo	o
docboo	k
doci	l
docil	ei
docile	l
docilel	y
docili	t
docilit	iy
dociliti	e
docilitie	s
dock	eimsy
docke	drt
docker	fhs
dockerf	i
dockerfi	l
dockerfil	e
dockerh	u
dockerhu	b
docki	n
dockin	g
dockm	a
dockma	s
dockmas	t
dockmast	e
dockmaste	r
docks	i
docksi	d
docksid	e
docky	a
dockya	r
dockyar	d
doct	or
docto	r
doctor	aehils
doctora	lt
doctoral	l
doctorall	y
doctorat	e
doctorate	s
doctore	dr
doctorh	o
doctorho	o
doctorhoo	d
doctori	nsz
doctorin	g
doctoris	m
doctoriz	e
doctorl	ey
doctorle	s
doctorles	s
doctors	h
doctorsh	i
doctorshi	p
doctorship	s
doctr	i
doctri	n
doctrin	aei
doctrina	ilr
doctrinai	r
doctrinair	ei
doctrinairi	s
doctrinairis	m
doctrinar	i
doctrinari	s
doctrinaris	m
doctrine	s
doctrini	s
doctrinis	t
docu	mst
docum	e
docume	n
documen	t
document	aeis
documenta	blrt
documentab	l
documentabl	ey
documentar	iy
documentari	el
documentarie	s
documentaril	y
documentat	i
documentati	o
documentatio	n
documentation	s
documente	dr
documenter	s
documenti	n
documentin	g
docus	a
docusa	u
docusau	r
docusaur	u
docusauru	s
docut	e
docute	m
dod	degios
dodd	el
dodde	r
dodder	ei
doddere	d
dodderi	n
dodderin	g
doddl	e
doddle	s
dode	c
dodec	a
dodeca	gh
dodecag	o
dodecago	n
dodecah	e
dodecahe	d
dodecahed	r
dodecahedr	ao
dodecahedra	l
dodecahedro	n
dodg	eiy
dodge	bdrs
dodgeb	a
dodgeba	l
dodgebal	l
dodger	s
dodgi	eln
dodgie	rs
dodgies	t
dodgil	y
dodgin	eg
dodgine	s
dodgines	s
dodginess	e
dodginesse	s
dodi	n
dodin	g
doding	t
dodingt	o
dodingto	n
dods	o
dodso	n
doe	rs
doer	s
does	kn
doesk	i
doeski	n
doesn	o
doesno	t
dof	flu
dog	abcefghlmstw
doga	t
dogat	e
dogb	ae
dogba	n
dogban	e
dogbe	r
dogber	r
dogberr	y
dogc	a
dogca	r
dogcar	t
doge	c
dogec	o
dogeco	i
dogecoi	n
dogf	ai
dogfa	c
dogfac	e
dogfi	gs
dogfig	h
dogfigh	t
dogfis	h
dogg	eio
dogge	dr
dogged	ln
doggedl	y
doggedn	e
doggedne	s
doggednes	s
doggedness	e
doggednesse	s
dogger	ey
doggere	l
doggi	ens
doggin	g
doggis	h
doggo	n
doggon	e
dogh	o
dogho	lou
doghol	e
doghoo	d
doghou	s
doghous	e
dogl	ei
dogle	gs
dogles	s
dogli	k
doglik	e
dogm	ae
dogma	st
dogmat	ai
dogmati	cs
dogmatic	ai
dogmatica	l
dogmatical	ln
dogmaticall	y
dogmaticaln	e
dogmaticalne	s
dogmaticalnes	s
dogmaticalness	e
dogmaticalnesse	s
dogmatici	a
dogmaticia	n
dogmatis	mt
dogme	a
dogmea	t
dogs	bhkl
dogsb	o
dogsbo	d
dogsbod	iy
dogsbodi	e
dogsbodie	s
dogsbody	i
dogsbodyi	n
dogsbodyin	g
dogsh	o
dogsho	r
dogshor	e
dogsk	i
dogski	n
dogsl	e
dogsle	e
dogslee	p
dogt	o
dogto	ow
dogtoo	t
dogtoot	h
dogtow	n
dogw	ao
dogwa	t
dogwat	c
dogwatc	h
dogwo	o
dogwoo	d
doh	e
dohe	r
doher	t
dohert	y
doi	lntv
doil	y
doin	g
doing	s
doit	e
doite	d
doj	v
dol	abcdeiklopt
dola	n
dolb	y
dolc	e
dold	r
doldr	u
doldru	m
doldrum	s
dole	dfrs
dolef	u
dolefu	l
doleful	ln
dolefull	ey
dolefulle	rs
dolefulles	t
dolefuln	e
dolefulne	s
dolefulnes	s
dolefulness	e
dolefulnesse	s
doler	i
doleri	t
dolerit	e
doli	n
dolin	g
doll	adehiosy
dolla	r
dollar	ds
dollard	o
dollardo	m
dolld	o
dolldo	m
dolle	d
dollh	o
dollho	o
dollhoo	d
dolli	ens
dollie	s
dollin	g
dollis	h
dollish	ln
dollishl	y
dollishn	e
dollishne	s
dollishnes	s
dollishness	e
dollishnesse	s
dollo	p
dollop	eis
dollope	d
dollopi	n
dollopin	g
dolls	h
dollsh	i
dollshi	p
dolo	mr
dolom	i
dolomi	t
dolomit	e
dolor	e
dolore	s
dolp	h
dolph	i
dolphi	n
dolphin	aes
dolphina	t
dolphinat	e
dolphine	ds
dolphines	s
dolt	i
dolti	s
doltis	h
dom	abefi
doma	i
domai	n
domain	ns
domainn	a
domainna	m
domainnam	e
domainname	s
domainnames	y
domainnamesy	s
domainnamesys	t
domainnamesyst	e
domainnamesyste	m
domb	v
dome	dlns
domel	i
domeli	k
domelik	e
domen	i
domeni	c
domenic	o
domes	dt
domesd	a
domesda	y
domest	i
domesti	c
domestic	ails
domestica	lt
domestical	l
domesticall	y
domesticat	ei
domesticate	ds
domesticati	no
domesticatin	g
domesticatio	n
domestici	stz
domesticis	m
domesticit	y
domesticiz	e
domesticl	y
domi	cn
domic	i
domici	l
domicil	ei
domicili	a
domicilia	r
domiciliar	y
domin	aegio
domina	nt
dominan	ct
dominanc	e
dominant	ls
dominantl	y
dominat	eio
dominate	ds
dominati	no
dominatin	g
dominating	l
dominatingl	y
dominatio	n
dominato	r
dominator	s
domine	e
dominee	r
domineer	i
domineeri	n
domineerin	g
domineering	ln
domineeringl	y
domineeringn	e
domineeringne	s
domineeringnes	s
domineeringness	e
domineeringnesse	s
doming	o
domini	ceoq
dominic	ak
dominica	ln
dominican	s
dominio	n
dominion	s
dominiq	u
dominiqu	e
domino	es
dominoe	ds
don	acefgjknosu
dona	hlt
donah	u
donahu	e
donal	d
donald	s
donalds	o
donaldso	n
donat	eio
donate	ds
donati	nov
donatin	g
donatio	n
donation	s
donativ	e
donato	r
donc	a
donca	s
doncas	t
doncast	e
doncaste	r
done	ce
donec	k
dong	a
donj	o
donjo	n
donk	e
donke	y
donkey	deisw
donkeyd	o
donkeydo	m
donkeye	rs
donkeyes	t
donkeyi	s
donkeyis	h
donkeyw	o
donkeywo	r
donkeywor	k
donn	aeiy
donne	lr
donnel	l
donnell	y
donni	s
donnis	h
donny	b
donnyb	r
donnybr	o
donnybro	o
donnybroo	k
dono	rv
donor	s
donors	h
donorsh	i
donorshi	p
donorship	s
donov	a
donova	n
donu	t
donut	s
doo	dhjklmprvy
dood	il
doodi	e
doodl	ei
doodle	drs
doodler	s
doodli	n
doodlin	g
dooh	i
doohi	c
doohic	k
doohick	e
doohicke	y
dooj	v
dook	v
dool	ei
doole	y
dooli	t
doolit	t
doolitt	l
doolittl	e
doom	eis
doome	dr
doomi	n
doomin	g
dooms	d
doomsd	a
doomsda	y
door	bejklmnpswy
doorb	e
doorbe	l
doorbel	l
doorbell	eis
doorbelle	d
doorbelli	n
doorbellin	g
doore	d
doorj	a
doorja	m
doorjam	b
doork	en
doorke	e
doorkee	p
doorkeep	e
doorkeepe	r
doorkn	o
doorkno	b
doorl	ei
doorle	s
doorles	s
doorli	k
doorlik	e
doorm	ae
doorma	nt
doormat	s
doorme	n
doorn	a
doorna	i
doornai	l
doorp	lo
doorpl	a
doorpla	t
doorplat	e
doorpo	s
doorpos	t
doors	it
doorsi	l
doorsil	l
doorst	eo
doorste	p
doorstep	ps
doorstepp	ei
doorsteppe	dr
doorsteppi	n
doorsteppin	g
doorsto	p
doorw	a
doorwa	y
doorway	s
doory	a
doorya	r
dooryar	d
dooy	o
dooyo	o
dop	aeiop
dopa	n
dopan	t
dope	drsy
doper	s
dopes	t
dopest	e
dopeste	r
dopey	n
dopeyn	e
dopeyne	s
dopeynes	s
dopeyness	e
dopeynesse	s
dopi	eln
dopie	rs
dopies	t
dopil	y
dopin	eg
dopine	s
dopines	s
dopiness	e
dopinesse	s
dopo	d
dopp	l
doppl	e
dopple	r
dor	aceikmopsty
dora	d
dorad	o
dorc	ah
dorca	s
dorch	e
dorche	s
dorches	t
dorchest	e
dorcheste	r
dore	e
doree	n
dori	acs
doria	n
doric	i
dorici	z
doriciz	e
doricize	s
dorm	aioy
dorma	n
dorman	ct
dormanc	y
dormi	t
dormit	o
dormito	r
dormitor	iy
dormitori	e
dormitorie	s
dormo	u
dormou	s
dormous	e
doro	t
dorot	h
doroth	ey
dorothe	a
dors	ae
dorsa	l
dorsal	ilms
dorsali	t
dorsalit	y
dorsall	y
dorsalm	o
dorsalmo	s
dorsalmos	t
dorse	t
dorset	s
dorsets	h
dorsetsh	i
dorsetshi	r
dorsetshir	e
dort	m
dortm	u
dortmu	n
dortmun	d
dos	aeist
dosa	g
dosag	e
dosage	s
dose	drs
doser	s
dosi	mn
dosim	e
dosime	t
dosimet	er
dosimete	r
dosimetr	y
dosin	g
doss	aehi
dossa	l
dosse	ds
dossh	e
dosshe	l
dosshel	l
dossi	en
dossie	r
dossier	s
dossin	g
dost	o
dosto	e
dostoe	v
dostoev	s
dostoevs	k
dostoevsk	y
dot	aceilmopst
dota	gl
dotag	e
dotc	o
dotco	mv
dotcov	e
dotcove	r
dote	drs
doter	s
doti	n
dotin	g
doting	ls
dotingl	y
dotl	i
dotli	k
dotlik	e
dotm	e
dotme	m
dotmem	o
dotmemo	r
dotmemor	y
dotp	e
dotpe	e
dotpee	k
dott	aeiry
dotta	b
dottab	l
dottabl	e
dotte	dr
dotter	s
dotti	n
dottin	g
dottr	a
dottra	c
dottrac	e
dou	bcgrs
doub	lt
doubl	eioy
double	cdfghnrst
doublec	lr
doublecl	i
doublecli	c
doubleclic	k
doubleclick	e
doubleclicke	d
doublecr	o
doublecro	s
doublecros	s
doublecross	e
doublecrosse	rs
doubled	au
doubleda	y
doubledu	t
doubledut	c
doubledutc	h
doublef	o
doublefo	l
doublefol	d
doubleg	u
doublegu	a
doublegua	r
doubleguar	d
doubleh	e
doublehe	a
doublehea	d
doublehead	e
doubleheade	r
doublen	e
doublene	s
doublenes	s
doubleness	e
doublenesse	s
doubler	s
doublet	hos
doubleth	i
doublethi	n
doublethin	k
doubleto	n
doubli	n
doublin	g
doublo	o
doubloo	n
doubt	aefils
doubta	b
doubtab	l
doubtabl	ey
doubte	dr
doubter	s
doubtf	u
doubtfu	l
doubtful	ln
doubtfull	y
doubtfuln	e
doubtfulne	s
doubtfulnes	s
doubtfulness	e
doubtfulnesse	s
doubti	n
doubtin	g
doubting	ln
doubtingl	y
doubtingn	e
doubtingne	s
doubtingnes	s
doubtingness	e
doubtingnesse	s
doubtl	e
doubtle	s
doubtles	s
doubtless	ln
doubtlessl	y
doubtlessn	e
doubtlessne	s
doubtlessnes	s
doubtlessness	e
doubtlessnesse	s
douc	eh
douch	e
doug	hl
dough	belnsty
doughb	o
doughbo	y
doughe	r
dougher	t
doughert	y
doughl	i
doughli	k
doughlik	e
doughn	u
doughnu	t
doughnut	ls
doughnutl	i
doughnutli	k
doughnutlik	e
dought	iy
doughti	l
doughtil	y
dougl	a
dougla	s
douglas	s
dour	eln
doure	rs
doures	t
dourl	y
dourn	e
dourne	s
dournes	s
dourness	e
dournesse	s
dous	ei
douse	drs
douser	s
dousi	n
dousin	g
dov	ei
dove	clrst
dovec	o
doveco	t
dovel	i
doveli	n
dovelin	g
dovet	a
doveta	i
dovetai	l
dovi	s
dovis	h
dovish	n
dovishn	e
dovishne	s
dovishnes	s
dovishness	e
dovishnesse	s
dow	adelnrsv
dowa	g
dowag	e
dowage	r
dowd	iy
dowdi	eln
dowdie	rs
dowdies	t
dowdil	y
dowdin	e
dowdine	s
dowdines	s
dowdiness	e
dowdinesse	s
dowdy	i
dowdyi	s
dowdyis	hm
dowdyism	s
dowe	lr
dowl	i
dowli	n
dowlin	g
down	bcefghilmprstwy
downb	e
downbe	a
downbea	t
downbeat	s
downc	a
downca	s
downcas	t
downcast	lns
downcastl	y
downcastn	e
downcastne	s
downcastnes	s
downcastness	e
downcastnesse	s
downe	dry
downer	s
downf	a
downfa	l
downfal	l
downfall	es
downfalle	n
downg	r
downgr	a
downgra	d
downgrad	ei
downgrade	drs
downgrader	s
downgradi	n
downgradin	g
downh	ei
downhe	a
downhea	r
downhear	t
downheart	e
downhearte	d
downhearted	ln
downheartedl	y
downheartedn	e
downheartedne	s
downheartednes	s
downheartedness	e
downheartednesse	s
downhi	l
downhil	l
downhill	s
downi	en
downin	g
downl	io
downli	kn
downlik	e
downlin	k
downlink	s
downlo	a
downloa	d
download	aeis
downloada	b
downloadab	l
downloadabl	e
downloade	dr
downloadi	n
downloadin	g
downm	a
downma	r
downmar	k
downmark	e
downmarke	t
downp	lo
downpl	a
downpla	y
downplay	eis
downplaye	d
downplayi	n
downplayin	g
downpo	u
downpou	r
downpour	s
downr	i
downri	g
downrig	h
downrigh	t
downright	ln
downrightl	y
downrightn	e
downrightne	s
downrightnes	s
downrightness	e
downrightnesse	s
downs	cit
downsc	a
downsca	l
downscal	e
downsi	dz
downsid	e
downside	s
downsiz	ei
downsize	ds
downsizi	n
downsizin	g
downst	ar
downsta	git
downstag	e
downstai	r
downstair	s
downstairs	e
downstairse	s
downstat	e
downstr	e
downstre	a
downstrea	m
downstream	e
downstreame	r
downt	hioru
downth	r
downthr	o
downthro	w
downti	m
downtim	e
downto	w
downtow	n
downtown	s
downtr	eo
downtre	n
downtren	d
downtro	d
downtrod	d
downtrodd	e
downtrodde	n
downtrodden	n
downtroddenn	e
downtroddenne	s
downtroddennes	s
downtroddenness	e
downtroddennesse	s
downtu	r
downtur	n
downturn	eis
downturne	d
downturni	n
downturnin	g
downw	ai
downwa	r
downwar	d
downward	lns
downwardl	y
downwardn	e
downwardne	s
downwardnes	s
downwardness	e
downwardnesse	s
downwi	n
downwin	d
dowr	iy
dowri	e
dowrie	s
dowry	l
dowryl	e
dowryle	s
dowryles	s
dows	ei
dowse	drs
dowsi	n
dowsin	g
dox	ov
doxo	l
doxol	o
doxolo	g
doxolog	y
doy	el
doye	n
doyen	n
doyenn	e
doyl	e
doz	eiy
doze	dnrs
dozed	n
dozedn	e
dozedne	s
dozednes	s
dozen	est
dozene	dr
dozent	h
dozer	s
dozi	eln
dozie	rs
dozies	t
dozil	y
dozin	eg
dozine	s
dozines	s
doziness	e
dozinesse	s
dp	bdefghimnpquz
dpb	o
dpd	jp
dpdj	v
dpf	j
dph	i
dphi	l
dpm	djt
dpn	o
dpno	v
dpp	o
dpq	g
dq	abejlno
dqa	v
dqb	v
dqe	r
dqer	v
dql	fr
dqo	rv
dr	abcdefgijklnoqrsuvwy
dra	bcfgikmnprstuvwy
drab	bn
drabb	eily
drabbe	drs
drabbes	t
drabbi	ns
drabbin	eg
drabbine	s
drabbines	s
drabbis	h
drabbl	e
drabn	e
drabne	s
drabnes	s
drabness	e
drabnesse	s
drac	ou
draco	n
dracon	i
draconi	ac
draconia	n
dracu	l
dracul	a
draf	t
draft	aeisy
drafta	b
draftab	l
draftabl	e
drafte	ders
draftee	s
drafter	s
draftes	t
drafti	eln
draftie	rs
drafties	t
draftil	y
draftin	eg
draftine	s
draftines	s
draftiness	e
draftinesse	s
drafts	m
draftsm	ae
draftsma	n
draftsman	ls
draftsmanl	y
draftsmans	h
draftsmansh	i
draftsmanshi	p
draftsmanship	s
draftsme	n
drag	gnors
dragg	eily
dragge	d
draggi	n
draggin	g
dragging	l
draggingl	y
draggl	e
dragn	e
dragne	t
drago	mno
dragom	a
dragoma	n
dragon	befhilrs
dragonb	a
dragonba	l
dragonbal	l
dragone	s
dragones	s
dragonf	l
dragonfl	iy
dragonfli	e
dragonflie	s
dragonh	e
dragonhe	a
dragonhea	d
dragoni	s
dragonis	m
dragonl	i
dragonli	k
dragonlik	e
dragonr	o
dragonro	o
dragonroo	t
dragonroot	s
dragoo	n
dragoon	es
dragoone	d
dragr	o
dragro	p
dragrop	e
drai	ln
drain	abeips
draina	bg
drainab	l
drainabl	e
drainag	e
drainage	s
drainb	o
drainbo	a
drainboa	r
drainboar	d
draine	dr
drainer	s
draini	n
drainin	g
drainp	i
drainpi	p
drainpip	e
drainpipe	s
drak	e
dram	as
drama	mst
dramam	i
dramami	n
dramamin	e
dramat	i
dramati	csz
dramatic	asu
dramatica	l
dramatical	l
dramaticall	y
dramaticu	l
dramaticul	e
dramatis	aeit
dramatisa	b
dramatisab	l
dramatisabl	e
dramatise	ds
dramatisi	n
dramatisin	g
dramatist	s
dramatiz	aei
dramatiza	bt
dramatizab	l
dramatizabl	e
dramatizat	i
dramatizati	o
dramatizatio	n
dramatize	drs
dramatizer	s
dramatizi	n
dramatizin	g
drams	h
dramsh	o
dramsho	p
dran	k
drap	aei
drapa	b
drapab	il
drapabi	l
drapabil	i
drapabili	t
drapabilit	iy
drapabiliti	e
drapabilitie	s
drapabl	e
drape	adrsy
drapea	b
drapeab	il
drapeabi	l
drapeabil	i
drapeabili	t
drapeabilit	iy
drapeabiliti	e
drapeabilitie	s
drapeabl	e
draper	isy
draperi	e
draperie	s
drapi	n
drapin	g
dras	t
drast	i
drasti	c
drastic	a
drastica	l
drastical	l
drasticall	y
drau	gh
draug	h
draugh	t
draught	eisy
draughte	dr
draughter	s
draughti	n
draughtin	g
draughts	m
draughtsm	ae
draughtsma	n
draughtsme	n
drauh	g
drauhg	h
drauhgh	t
drauhght	s
drav	i
dravi	d
dravid	i
dravidi	a
dravidia	n
draw	bdeilns
drawb	aer
drawba	cr
drawbac	k
drawback	s
drawbe	r
drawbr	i
drawbri	d
drawbrid	g
drawbridg	e
drawbridge	s
drawd	o
drawdo	w
drawdow	n
drawe	r
drawer	fs
drawerf	u
drawerfu	l
drawerful	s
drawi	n
drawin	g
drawing	s
drawl	eisy
drawle	dr
drawler	s
drawli	en
drawlie	rs
drawlies	t
drawlin	g
drawling	ln
drawlingl	y
drawlingn	e
drawlingne	s
drawlingnes	s
drawlingness	e
drawlingnesse	s
drawn	ln
drawnl	y
drawnn	e
drawnne	s
drawnnes	s
draws	t
drawst	r
drawstr	i
drawstri	n
drawstrin	g
drawstring	s
dray	am
draya	g
drayag	e
draym	a
drayma	n
drb	bivw
drbb	v
drc	rv
drd	dv
dre	abdgnswxy
drea	dmr
dread	aefilns
dreada	b
dreadab	l
dreadabl	e
dreade	drs
dreades	t
dreadf	u
dreadfu	l
dreadful	lns
dreadfull	y
dreadfuln	e
dreadfulne	s
dreadfulnes	s
dreadfulness	e
dreadfulnesse	s
dreadi	n
dreadin	g
dreading	l
dreadingl	y
dreadl	oy
dreadlo	c
dreadloc	k
dreadlock	es
dreadlocke	d
dreadlocks	e
dreadlockse	s
dreadn	eo
dreadne	s
dreadnes	s
dreadness	e
dreadnesse	s
dreadno	u
dreadnou	g
dreadnoug	h
dreadnough	t
dream	bcefilstwy
dreamb	o
dreambo	a
dreamboa	t
dreamc	a
dreamca	s
dreamcas	t
dreame	dr
dreamer	sy
dreamf	u
dreamfu	l
dreamful	ln
dreamfull	y
dreamfuln	e
dreamfulne	s
dreamfulnes	s
dreamfulness	e
dreamfulnesse	s
dreami	elns
dreamie	rs
dreamies	t
dreamil	y
dreamin	eg
dreamine	s
dreamines	s
dreaminess	e
dreaminesse	s
dreamis	h
dreaml	aei
dreamla	n
dreamlan	d
dreamle	s
dreamles	s
dreamless	ln
dreamlessl	y
dreamlessn	e
dreamlessne	s
dreamlessnes	s
dreamlessness	e
dreamlessnesse	s
dreamli	k
dreamlik	e
dreamw	e
dreamwe	a
dreamwea	v
dreamweav	e
dreamweave	r
drear	iy
dreari	ehlmn
drearie	rs
drearies	t
drearih	eo
drearihe	a
drearihea	d
dreariho	o
drearihoo	d
drearil	y
drearim	e
drearime	n
drearimen	t
drearin	e
drearine	s
drearines	s
dreariness	e
drearinesse	s
dred	g
dredg	ei
dredge	drs
dredger	s
dredgi	n
dredgin	g
dreg	gs
dregg	y
dren	c
drenc	h
drench	ei
drenche	drs
drencher	s
drenchi	n
drenchin	g
drenching	l
drenchingl	y
dres	ds
dresd	e
dresde	n
dress	aeimy
dressa	g
dressag	e
dresse	drs
dresser	s
dressi	n
dressin	g
dressing	s
dressm	a
dressma	k
dressmak	ei
dressmake	r
dressmaker	s
dressmaki	n
dressmakin	g
drex	e
drexe	l
drey	f
dreyf	u
dreyfu	s
dreyfus	s
drf	fv
dri	beflnprsvz
drib	b
dribb	l
dribbl	eiy
dribble	drs
dribbler	s
dribbli	n
dribblin	g
drie	drs
drier	s
dries	t
drif	t
drift	aeilsw
drifta	g
driftag	e
drifte	dr
drifter	s
drifti	en
driftie	rs
drifties	t
driftin	g
drifting	l
driftingl	y
driftl	e
driftle	s
driftles	s
driftless	n
driftlessn	e
driftlessne	s
driftlessnes	s
driftlessness	e
driftlessnesse	s
driftw	o
driftwo	o
driftwoo	d
dril	ly
drill	aeims
drilla	b
drillab	il
drillabi	l
drillabil	i
drillabili	t
drillabilit	iy
drillabiliti	e
drillabilitie	s
drillabl	e
drille	dr
driller	s
drilli	n
drillin	g
drillm	a
drillma	s
drillmas	t
drillmast	e
drillmaste	r
drin	k
drink	aeils
drinka	b
drinkab	l
drinkabl	e
drinke	r
drinker	s
drinki	n
drinkin	g
drinking	s
drinkl	e
drinkle	s
drinkles	s
drip	opst
dripo	l
dripol	a
dripola	t
dripolat	o
dripolato	r
dripp	eiy
drippe	dr
dripper	s
drippi	n
drippin	g
drips	t
dripst	o
dripsto	n
dripston	e
dris	c
drisc	o
drisco	l
driscol	l
driv	aei
driva	b
drivab	i
drivabi	l
drivabil	i
drivabili	t
drivabilit	i
drivabiliti	e
drivabilitie	s
drive	alnrsw
drivea	b
driveab	i
driveabi	l
driveabil	i
driveabili	t
driveabilit	i
driveabiliti	e
driveabilitie	s
driven	n
drivenn	e
drivenne	s
drivennes	s
drivenness	e
drivennesse	s
driver	ls
driverl	e
driverle	s
driverles	s
drivew	a
drivewa	y
driveway	s
drivi	n
drivin	g
driving	ls
drivingl	y
driz	z
drizz	l
drizzl	eiy
drizzle	ds
drizzli	en
drizzlie	rs
drizzlies	t
drizzlin	g
drizzling	l
drizzlingl	y
drj	q
drjq	v
drk	bfglnrs
drl	k
drn	bfpq
dro	bfgilmnopsuvw
drog	hu
drogh	e
droghe	r
drogu	e
droi	t
drol	l
droll	ey
drolle	r
droller	y
drom	e
drome	d
dromed	a
dromeda	r
dromedar	iy
dromedari	e
dromedarie	s
dron	aei
drona	g
dronag	e
drone	drs
droner	s
droni	ns
dronin	g
droning	l
droningl	y
dronis	h
droo	lp
drool	eis
droole	dr
drooli	n
droolin	g
droop	eisy
droope	dr
droopi	n
droopin	g
drooping	ln
droopingl	y
droopingn	e
droopingne	s
droopingnes	s
drop	bklopstwz
dropb	o
dropbo	x
dropk	i
dropki	c
dropkic	k
dropl	ei
drople	st
droples	s
droplet	s
dropli	k
droplik	e
dropo	u
dropou	t
dropp	ei
droppe	dr
dropper	fs
dropperf	u
dropperfu	l
dropperful	s
droppers	f
droppersf	u
droppersfu	l
droppi	n
droppin	g
dropping	s
drops	t
dropst	o
dropsto	n
dropston	e
dropw	i
dropwi	s
dropwis	e
dropz	o
dropzo	n
dropzon	e
dros	os
droso	p
drosop	h
drosoph	i
drosophi	l
drosophil	a
dross	y
drou	gt
droug	h
drough	t
drought	eis
droughte	d
droughti	en
droughtie	rs
droughties	t
droughtin	e
droughtine	s
droughtines	s
droughtiness	e
droughtinesse	s
drout	h
drouth	s
drov	ei
drove	drs
drover	s
drovi	n
drovin	g
drow	ns
drown	eis
drowne	dr
drowner	s
drowni	n
drownin	g
drowning	ls
drowningl	y
drows	eiy
drowse	ds
drowsi	ehln
drowsie	rs
drowsies	t
drowsih	e
drowsihe	a
drowsihea	d
drowsil	y
drowsin	eg
drowsine	s
drowsines	s
drowsiness	e
drowsinesse	s
drq	b
drr	jq
drrj	v
drs	st
dru	bdfgimnprsv
drub	b
drubb	i
drubbi	n
drubbin	g
drud	g
drudg	e
drudge	r
drudger	iy
drudgeri	e
drudgerie	s
drug	gls
drugg	ei
drugge	d
druggi	es
druggie	s
druggis	t
druggist	s
drugl	e
drugle	s
drugles	s
drugs	t
drugst	o
drugsto	r
drugstor	e
drugstore	s
drui	d
druid	i
druidi	s
druidis	m
drum	bhlms
drumb	e
drumbe	a
drumbea	t
drumh	e
drumhe	a
drumhea	d
druml	i
drumli	kn
drumlik	e
drumlin	ios
drumlini	z
drumliniz	e
drumlinize	d
drumlino	i
drumlinoi	d
drumm	eioy
drumme	dr
drummer	s
drummi	n
drummin	g
drummo	n
drummon	d
drums	t
drumst	ei
drumste	r
drumsti	c
drumstic	k
drumstick	s
drun	k
drunk	aeilos
drunka	r
drunkar	d
drunkard	s
drunke	nrs
drunken	lns
drunkenl	y
drunkenn	e
drunkenne	s
drunkennes	s
drunkenness	e
drunkennesse	s
drunkens	o
drunkenso	m
drunkensom	e
drunker	y
drunkes	t
drunki	s
drunkis	h
drunkl	y
drunko	m
drunkom	e
drunkome	t
drunkomet	e
drunkomete	r
drup	ae
drupa	cl
drupac	e
drupace	o
drupaceo	u
drupaceou	s
drur	y
drus	e
dry	adegilnps
drya	bds
dryab	l
dryabl	e
dryas	d
dryasd	u
dryasdu	s
dryasdus	t
dryd	e
dryde	n
drye	rs
dryer	s
dryes	t
dryg	o
drygo	o
drygoo	d
drygood	s
dryi	ns
dryin	g
dryis	h
dryl	ay
dryla	n
drylan	d
dryland	e
drylande	r
dryn	e
dryne	s
drynes	s
dryness	e
drynesse	s
dryp	o
drypo	i
drypoi	n
drypoin	t
drys	a
drysa	l
drysal	t
drysalt	e
drysalte	r
drysalter	y
ds	abeimnoqst
dsa	q
dse	rv
dser	v
dsi	v
dsn	f
dsq	j
dt	adkmnoprt
dta	frsv
dtd	d
dtm	b
dtmb	rv
dtn	bv
dto	fhiru
dtou	v
dtr	p
du	abcdefgijklmnopqrstuvwy
dua	dln
dual	eils
duale	drs
duales	t
duali	nst
dualin	g
dualis	mt
dualist	i
dualisti	c
dualit	iy
dualiti	e
dualitie	s
duall	ey
dualle	d
duan	eg
dub	abhilpsu
duba	i
dubb	eio
dubbe	d
dubbi	n
dubbin	g
dubh	e
dubi	eot
dubie	t
dubiet	y
dubio	u
dubiou	s
dubious	ln
dubiousl	y
dubiousn	e
dubiousne	s
dubiousnes	s
dubiousness	e
dubiousnesse	s
dubit	a
dubita	b
dubitab	l
dubitabl	e
dubl	i
dubli	n
dubu	q
dubuq	u
dubuqu	e
duc	ahkt
duca	blt
ducab	l
ducabl	e
ducat	i
duch	ey
duche	ns
duchen	n
duchenn	e
duches	s
duchess	el
duchesse	s
duchessl	i
duchessli	k
duchesslik	e
duck	deilswy
duckd	bu
duckdu	c
duckduc	k
duckduck	g
duckduckg	o
ducke	dr
ducker	s
ducki	n
duckin	g
duckl	i
duckli	n
ducklin	g
duckw	e
duckwe	e
duckwee	d
duct	aeils
ducta	l
ducte	d
ducti	l
ductil	e
ductl	ei
ductle	s
ductles	s
ductli	k
ductlik	e
dud	degils
dudd	e
dudde	r
dudder	y
dude	ds
dudes	s
dudg	e
dudge	o
dudgeo	n
dudi	ns
dudin	eg
dudis	h
dudish	l
dudishl	y
dudl	e
dudle	y
due	flnrstv
duef	u
duefu	l
duel	eils
duele	dr
dueler	s
dueli	ns
duelin	g
dueling	s
duelis	t
duelist	s
duell	ei
duelle	dr
dueller	s
duelli	s
duellis	t
duellist	s
duen	e
duene	s
duenes	s
dueness	e
duenesse	s
dues	t
duet	eist
duete	d
dueti	n
duetin	g
duett	ei
duette	d
duetti	ns
duettin	g
duettis	t
duettist	s
duf	frv
duff	y
dug	agos
duga	n
dugg	y
dugo	nu
dugon	g
dugou	t
dui	s
duk	aefitvy
duke	dlsv
duked	o
dukedo	m
dukedom	s
dukel	iy
dukeli	n
dukelin	g
dukes	h
dukesh	i
dukeshi	p
duki	n
dukin	g
duky	v
dul	clnsuy
dulc	ei
dulce	t
dulci	afm
dulcia	n
dulcian	a
dulcif	y
dulcim	e
dulcime	r
dull	aeinsy
dulla	r
dullar	d
dulle	drs
dulles	t
dulli	fns
dullif	y
dullin	g
dullis	h
dulln	e
dullne	s
dullnes	s
dullness	e
dullnesse	s
duln	e
dulne	s
dulnes	s
dulness	e
dulnesse	s
duls	e
dulu	t
dulut	h
dum	bdfmp
dumb	befilns
dumbb	e
dumbbe	l
dumbbel	l
dumbbell	s
dumbe	drs
dumbes	t
dumbf	o
dumbfo	u
dumbfou	n
dumbfoun	d
dumbfound	e
dumbfounde	d
dumbi	n
dumbin	g
dumbl	y
dumbn	e
dumbne	s
dumbnes	s
dumbness	e
dumbnesse	s
dumbs	t
dumbst	r
dumbstr	u
dumbstru	c
dumbstruc	k
dumd	u
dumdu	m
dumf	o
dumfo	u
dumfou	n
dumfoun	d
dumm	iy
dummi	en
dummie	drs
dummies	t
dummin	e
dummine	s
dummines	s
dummy	i
dummyi	n
dummyin	g
dump	ceilsty
dumpc	a
dumpca	r
dumpcar	t
dumpe	dr
dumpi	ns
dumpin	g
dumpis	h
dumpl	i
dumpli	n
dumplin	g
dumpling	s
dumpt	y
dun	bcdeghikln
dunb	a
dunba	r
dunc	ae
dunca	n
dunce	s
dund	e
dunde	er
dunder	h
dunderh	e
dunderhe	a
dunderhea	d
dune	dls
duned	i
dunedi	n
dunel	i
duneli	k
dunelik	e
dung	aehisy
dunga	r
dungar	e
dungare	e
dungaree	s
dunge	do
dungeo	n
dungeon	s
dungh	i
dunghi	l
dunghil	l
dungi	en
dungie	rs
dungies	t
dungin	g
dunh	au
dunha	m
dunhu	a
dunhua	r
dunhuar	n
dunhuarn	g
duni	w
duniw	a
duniwa	s
duniwas	s
duniwass	a
duniwassa	l
dunk	i
dunki	r
dunkir	k
dunl	aio
dunla	p
dunli	n
dunlo	p
dunn	eo
duo	dlps
duod	ei
duode	cn
duodec	i
duodeci	m
duodecim	ao
duodecima	l
duoden	au
duodena	l
duodenu	m
duodenum	s
duodi	o
duodio	d
duodiod	e
duol	o
duolo	g
duolog	u
duologu	e
duop	l
duopl	a
duopla	s
duoplas	m
duoplasm	a
duoplasma	t
duoplasmat	r
duoplasmatr	o
duoplasmatro	n
dup	aeilovy
dupa	b
dupab	il
dupabi	l
dupabil	i
dupabili	t
dupabilit	i
dupabiliti	e
dupabilitie	s
dupabl	e
dupe	drs
duper	sy
dupi	n
dupin	g
dupl	ei
duple	x
duplex	e
duplexe	r
dupli	c
duplic	ai
duplica	bt
duplicab	l
duplicabl	e
duplicat	aeio
duplicata	b
duplicatab	l
duplicatabl	e
duplicate	dls
duplicatel	y
duplicati	nov
duplicatin	g
duplicatio	n
duplication	s
duplicativ	e
duplicato	r
duplicator	s
duplici	t
duplicit	y
dupo	n
dupon	t
dupont	s
duq	u
duqu	e
duque	s
duques	n
duquesn	e
dur	abehiknpruvw
dura	blmnt
durab	il
durabi	l
durabil	i
durabili	t
durabilit	iy
durabiliti	e
durabilitie	s
durabl	ey
durable	n
durablen	e
durablene	s
durablenes	s
durableness	e
durablenesse	s
dural	u
duralu	m
duralum	i
duralumi	n
duram	e
durame	n
duran	cg
duranc	e
durang	o
durat	i
durati	ov
duratio	n
duration	als
durationa	l
durationl	e
durationle	s
durationles	s
durativ	e
durb	a
durba	n
dure	rs
durer	s
dures	s
duress	e
duresse	s
durh	a
durha	m
duri	an
duria	n
durin	g
durk	ei
durke	e
durki	n
durr	ae
durre	l
durrel	l
duru	m
durw	a
durwa	r
durwar	d
dus	ekst
duse	n
dusen	b
dusenb	eu
dusenbe	r
dusenber	g
dusenbu	r
dusenbur	y
dusk	eilnsy
duske	dn
duski	lns
duskil	y
duskin	eg
duskine	s
duskines	s
duskis	h
duskl	y
duskn	e
duskne	s
dusknes	s
duss	e
dusse	l
dussel	d
dusseld	o
dusseldo	r
dusseldor	f
dust	beilmpsuy
dustb	io
dustbi	n
dustbin	s
dustbo	t
duste	dr
duster	s
dusti	en
dustie	rs
dusties	t
dustin	g
dustl	i
dustli	k
dustlik	e
dustm	ae
dustma	n
dustme	n
dustp	ar
dustpa	n
dustpan	s
dustpr	o
dustpro	o
dustproo	f
dustu	p
dut	ceirty
dutc	h
dutch	ceilmy
dutchc	o
dutchco	u
dutchcou	r
dutchcour	a
dutchcoura	g
dutchcourag	e
dutche	rs
dutches	s
dutchi	f
dutchif	y
dutchl	y
dutchm	ae
dutchma	n
dutchme	n
dute	o
duteo	u
duteou	s
duti	aef
dutia	b
dutiab	l
dutiabl	e
dutie	s
dutif	u
dutifu	l
dutiful	ln
dutifull	y
dutifuln	e
dutifulne	s
dutifulnes	s
dutifulness	e
dutifulnesse	s
dutt	o
dutto	n
duu	mv
duum	v
duumv	i
duumvi	r
duv	ev
duve	t
duvet	s
duw	u
dv	adefjmoqsvw
dvd	ms
dve	v
dvm	bhp
dvo	jmrx
dvor	a
dvora	k
dw	aehijnovwxy
dwa	br
dwar	fv
dwarf	eilnsy
dwarfe	drs
dwarfes	t
dwarfi	ns
dwarfin	g
dwarfis	h
dwarfish	ln
dwarfishl	y
dwarfishn	e
dwarfishne	s
dwarfishnes	s
dwarfishness	e
dwarfishnesse	s
dwarfl	i
dwarfli	kn
dwarflik	e
dwarflin	g
dwarfn	e
dwarfne	s
dwarfnes	s
dwarfness	e
dwarfnesse	s
dwarv	e
dwarve	s
dwe	l
dwel	lt
dwell	eis
dwelle	dr
dweller	s
dwelli	n
dwellin	g
dwelling	s
dwi	gn
dwig	h
dwigh	t
dwin	d
dwind	l
dwindl	ei
dwindle	dmrs
dwindlem	e
dwindleme	n
dwindlemen	t
dwindli	n
dwindlin	g
dwj	v
dwn	flrsvw
dwo	es
dww	bit
dwx	v
dwy	e
dwye	r
dx	adefijklnx
dxa	v
dxj	v
dxl	v
dxn	v
dxx	fnx
dy	adefiklmnoprsy
dya	bdk
dyab	l
dyabl	e
dyad	i
dyadi	c
dyd	ox
dye	adirsv
dyea	b
dyeab	i
dyeabi	l
dyeabil	i
dyeabili	t
dyeabilit	i
dyeabiliti	e
dyeabilitie	s
dyei	n
dyein	g
dyer	s
dyes	t
dyest	u
dyestu	f
dyestuf	f
dyf	b
dyi	n
dyin	g
dying	lns
dyingl	y
dyingn	e
dyingne	s
dyingnes	s
dyk	ei
dyke	drs
dyki	en
dykie	r
dykin	g
dyl	a
dyla	n
dyn	adeo
dyna	cmst
dynac	o
dynaco	m
dynacom	m
dynam	io
dynami	cst
dynamic	as
dynamica	l
dynamical	l
dynamicall	y
dynamis	m
dynamit	ei
dynamite	drs
dynamiter	s
dynamiti	cn
dynamitic	a
dynamitica	l
dynamitical	l
dynamiticall	y
dynamitin	g
dynamo	ms
dynamom	e
dynamome	t
dynamomet	er
dynamomete	r
dynamometr	y
dynas	t
dynast	iy
dynasti	ce
dynastic	a
dynastica	l
dynastical	l
dynasticall	y
dynastie	s
dynat	r
dynatr	o
dynatro	n
dynd	v
dyno	d
dynod	e
dyo	or
dyp	djo
dypd	rv
dyr	v
dys	efgloptuv
dyse	n
dysen	t
dysent	e
dysente	r
dysenter	iy
dysenteri	ce
dysenterie	s
dysf	u
dysfu	n
dysfun	c
dysfunc	t
dysfunct	i
dysfuncti	o
dysfunctio	n
dysg	e
dysge	n
dysgen	i
dysgeni	c
dysl	eo
dysle	x
dyslex	i
dyslexi	ac
dyslexia	s
dyslexic	s
dyslo	g
dyslog	i
dyslogi	s
dyslogis	t
dyslogist	i
dyslogisti	c
dyso	n
dysp	er
dyspe	p
dyspep	t
dyspept	i
dyspepti	c
dyspr	o
dyspro	s
dyspros	i
dysprosi	u
dysprosiu	m
dyst	or
dysto	c
dystoc	i
dystoci	a
dystr	o
dystro	p
dystrop	h
dystroph	y
dysu	r
dysur	i
dysuri	a
dyy	rv
dyyr	v
dz	acdlqz
dza	s
dzc	m
dzd	j
dzq	f
