e	abcdefghijklmnopqrstuvwxyz
ea	abcdeijlmnopqrstuvwxyz
eaa	rsv
eab	lz
ead	fko
eadk	v
eae	rv
eai	rv
eaj	q
eajq	v
eal	rv
eam	v
ean	fv
eao	bev
eaob	v
eap	brtv
eaq	gnoqs
eaqo	v
ear	u
earu	v
eas	e
eat	brstv
eatb	v
eau	r
eaur	v
eax	bfrz
eaxr	v
eay	rv
eaz	r
eb	abdehiklnopqrtuvxz
eba	v
ebb	ou
ebd	v
ebe	afgpvw
ebh	i
ebhi	v
ebi	frsv
ebk	div
ebki	rv
ebl	cmt
ebp	sv
ebq	d
ebr	u
ebt	p
ebu	e
ebz	v
ec	adefgjklmnorst
eca	v
ecd	j
ece	euw
ecee	v
eceu	v
ecf	v
ecj	o
eck	v
ecl	v
ecn	v
ecr	as
ecs	tv
ed	abcdefhijklmnopqrstvwxyz
eda	drv
edb	rsv
edbs	v
edc	rv
edd	qu
ede	cmrsvz
edec	v
edez	v
edf	rv
edi	l
edil	v
edj	k
edm	r
edn	flv
edo	foprsv
edp	v
edq	l
edql	v
edr	crsv
edt	bo
edv	m
edx	v
edy	arv
edz	u
ee	abcdefgijklmnopqrstvwxz
eea	rvx
eeb	bdfmqrtv
eebb	v
eebd	v
eec	vw
eed	evz
eee	demrsv
eeem	v
eef	ae
eeg	uv
eei	fhrsv
eej	fjqrsuv
eejj	v
eek	j
eel	gosv
eem	rsv
een	cfo
eep	cdrv
eepd	v
eeq	by
eer	jsv
ees	jn
eet	b
eev	fq
eew	d
eex	p
ef	abdeflmnoprsuvxy
efa	av
efb	u
efbu	v
efd	av
efe	bdhlqty
efed	rv
efel	v
efet	v
eff	dkoqrtv
effk	v
efl	rsv
efm	bt
efmb	rv
efn	nrv
efo	fo
efoo	v
efr	s
efs	v
efv	az
efx	rv
efy	gv
efyg	v
eg	efgijnoqruxy
ege	av
egf	s
egg	q
egi	uv
egj	vy
egn	forv
ego	v
egq	f
egr	y
egu	afvw
eguw	v
egx	v
eh	adgijnoprux
ehg	uv
ehi	rv
ehj	rv
ehn	f
ehx	v
ei	ejnoqvx
eij	v
eio	abuv
eiq	v
eix	v
ej	abdejkmnoqrsuvz
eja	v
ejb	bt
ejbt	v
eje	z
ejj	qrv
ejm	bt
ejmb	rv
ejmt	v
ejn	v
ejo	uv
ejq	bsu
ejqs	v
ejv	v
ek	befijklnorwx
ekb	lu
eke	v
ekj	v
ekk	d
ekl	brsv
ekn	f
eko	v
ekr	l
el	abdefghijlnoprtuvwxyz
ela	rv
elb	i
elbi	v
eld	hjv
ele	low
eleo	v
elg	v
elh	otxz
elho	v
eli	o
elio	v
elj	k
eljk	v
ell	b
eln	fnotvx
elno	v
elo	dikortvxz
eloo	v
eloz	v
elp	ms
elr	u
elt	mos
elto	v
elts	v
elu	l
elul	v
elv	v
elw	w
elx	u
ely	y
elyy	v
elz	v
em	abcdegilnpqrstvw
ema	q
emb	gr
embr	v
emc	s
emi	aepz
emiz	v
emn	f
emr	frsv
ems	r
emsr	v
emt	b
en	abcdefghijklmnopqrsuvwxy
ena	adgmv
enb	befiorv
enbb	rv
enbe	v
enc	qsv
end	s
ene	orv
eneo	rv
enf	cflrsvw
enh	p
eni	rv
enj	v
enk	v
enl	ip
enlp	v
enn	fqv
eno	al
enp	v
enq	t
enr	efis
enrf	v
enu	jlrv
enw	rsuv
enx	u
enxu	v
eny	rv
eo	abfjklmnopqrtvxz
eoa	v
eob	fh
eobf	v
eobh	v
eoj	o
eojo	v
eok	v
eol	k
eom	r
eon	cefimpqt
eonc	v
eone	v
eonf	v
eonq	v
eoo	kop
eoop	rsv
eop	v
eoq	fqrvw
eor	q
eot	b
eov	v
eox	frsv
ep	bdefgijmopqruvx
epb	ceglmntz
epbl	v
epd	korv
epf	v
epi	p
epm	t
epo	rsv
epp	abmuz
epq	gu
epqu	v
epr	u
epru	v
epu	v
epx	v
eq	abcdefghijklmnopqrstuwxyz
eqa	fqrv
eqar	v
eqb	befgk
eqc	cl
eqd	fghkoxy
eqdk	v
eqe	defqruv
eqed	v
eqee	rsv
eqer	rv
eqeu	v
eqf	oxz
eqg	rw
eqgr	v
eqh	tv
eqi	duv
eqj	bv
eqk	v
eql	hos
eqm	gmuz
eqn	abforuv
eqnb	v
eqno	v
eqo	cfjrsuvw
eqou	v
eqp	bdgortw
eqpg	v
eqpr	v
eqr	cdquv
eqt	d
equ	crsv
eqx	nv
eqy	dtv
eqyd	v
er	bcdefiklmnoprtuvwx
erb	kr
erc	mv
erd	blv
ere	qrv
erf	dfq
erfd	v
erff	v
eri	frsv
erl	v
ern	dptv
ero	dfkv
erod	rv
erok	v
erp	g
err	frv
errf	v
ert	bv
ertb	v
eru	v
erw	w
es	agiloqruv
esi	bdfrstw
esib	v
esit	v
esl	p
eslp	v
eso	v
esr	b
esv	q
et	abcdfhijkmnoqstux
eta	kqrv
etb	u
etc	n
etd	efp
etf	gy
eti	q
etj	q
etm	bp
etmb	v
etmp	v
etn	bilrtvw
etnl	v
etnr	rsv
eto	v
etq	x
ets	f
ett	brv
etu	q
eu	abcdefgijlmnopqrstuw
eua	v
eub	p
eubp	v
euc	e
eud	ms
eue	v
eug	n
eui	v
eum	rv
eun	n
euo	o
eup	d
eur	kprsv
eurp	v
eus	n
eut	r
eutr	v
euu	bdmqru
euud	v
euum	v
ev	aefjmnouvxz
eva	v
eve	v
evf	frsvw
evn	bo
evno	v
evo	mv
ew	abdeflnoruwy
ewa	rsv
ewb	u
ewd	forvw
ewdf	v
ewe	f
ewf	borvw
ewl	ms
ewn	bcfklrsvw
ewo	v
ewr	v
ewu	cfsuvw
ex	bdefjlopruvx
exe	rv
exl	v
exo	f
exu	prv
exup	v
exx	u
ey	abeipruvxyz
eyb	p
eye	v
eyp	dfz
eyr	pv
eyu	f
eyy	ary
eyya	rv
eyyr	v
eyz	u
ez	bdehjklnoptu
ezd	q
eze	dqz
ezed	v
ezh	lu
ezk	bf
ezn	f
ezp	o
ezt	b
