f	abcdefghijklmnopqrstuvwxyz
fa	abcdefghijklmnopqrstuvwxyz
faa	rv
fab	aeilru
faba	c
fabac	e
fabace	o
fabaceo	u
fabaceou	s
fabe	r
fabi	a
fabia	n
fabl	ei
fable	drs
fabler	s
fabli	n
fablin	g
fabr	i
fabri	c
fabric	as
fabrica	t
fabricat	eio
fabricate	ds
fabricati	nov
fabricatin	g
fabricatio	n
fabricativ	e
fabricato	r
fabricator	s
fabu	l
fabul	io
fabuli	s
fabulis	t
fabulo	u
fabulou	s
fabulous	ln
fabulousl	y
fabulousn	e
fabulousne	s
fabulousnes	s
fabulousness	e
fabulousnesse	s
fac	aeistu
faca	d
facad	e
facade	ds
face	abcdilrst
facea	b
faceab	l
faceabl	e
faceb	o
facebo	o
faceboo	k
facec	l
facecl	o
faceclo	t
faceclot	h
facecloth	s
facei	d
facel	ei
facele	s
faceles	s
faceless	ln
facelessl	y
facelessn	e
facelessne	s
facelessnes	s
facelessness	e
facelessnesse	s
faceli	f
facelif	t
faces	i
facesi	t
facesit	t
facesitt	i
facesitti	n
facesittin	g
facet	eist
facete	d
faceti	mno
facetim	e
facetime	a
facetimea	u
facetimeau	d
facetimeaud	i
facetimeaudi	o
facetin	g
facetio	u
facetiou	s
facetious	ln
facetiousl	y
facetiousn	e
facetiousne	s
facetiousnes	s
facetiousness	e
facetiousnesse	s
facett	i
facetti	n
facettin	g
faci	aeln
facia	l
facial	ils
faciali	s
facialis	t
facialist	s
faciall	y
facie	s
facil	ei
facile	ln
facilel	y
facilen	e
facilene	s
facilenes	s
facileness	e
facilenesse	s
facili	t
facilit	aiy
facilita	t
facilitat	eio
facilitate	ds
facilitati	nov
facilitatin	g
facilitatio	n
facilitativ	e
facilitato	r
facilitator	y
faciliti	e
facilitie	s
facin	g
facing	s
facs	i
facsi	m
facsim	i
facsimi	l
facsimil	ei
facsimile	dis
facsimilei	n
facsimilein	g
facsimili	sz
facsimilis	t
facsimiliz	e
fact	fiosu
factf	u
factfu	l
facti	ot
factio	nu
faction	aeis
factiona	l
factional	il
factionali	s
factionalis	m
factionalism	s
factionall	y
factione	e
factionee	r
factioni	s
factionis	t
factiou	s
factit	i
factiti	ov
factitio	u
factitiou	s
factitiv	e
facto	rt
factor	aeisy
factora	bg
factorab	il
factorabi	l
factorabil	i
factorabili	t
factorabilit	iy
factorabiliti	e
factorabilitie	s
factorabl	e
factorag	e
factore	ds
factores	s
factori	aenoz
factoria	l
factorie	s
factorin	g
factoring	s
factoriz	a
factoriza	t
factorizat	i
factorizati	o
factorizatio	n
factorization	s
factors	h
factorsh	i
factorshi	p
factorship	s
factory	l
factoryl	ei
factoryle	s
factoryles	s
factoryli	k
factorylik	e
factot	u
factotu	m
factu	am
factua	l
factual	iln
factuali	st
factualis	m
factualit	i
factualiti	e
factualitie	s
factuall	y
factualn	e
factualne	s
factualnes	s
factualness	e
factualnesse	s
facu	l
facul	at
facult	iy
faculti	e
facultie	ds
fad	adeiklosv
fada	b
fadab	l
fadabl	e
fadd	i
faddi	es
faddie	rs
faddies	t
faddis	hmt
faddish	ln
faddishl	y
faddishn	e
faddishne	s
faddishnes	s
faddishness	e
faddishnesse	s
faddism	s
faddist	s
fade	dloprs
faded	n
fadedn	e
fadedne	s
fadednes	s
fadedness	e
fadednesse	s
fadel	e
fadele	s
fadeles	s
fadeo	u
fadeou	t
fadep	r
fadepr	o
fadepro	o
fadeproo	f
fader	s
fadi	n
fadin	g
fadl	i
fadli	k
fadlik	e
fae	cr
faec	ae
faeca	l
faece	s
faeces	e
faecese	s
faer	y
faf	nv
fafn	i
fafni	r
fag	gios
fagg	io
faggi	ns
faggin	g
faggis	h
faggo	t
fagi	n
fago	t
fah	er
fahe	y
fahr	e
fahre	n
fahren	h
fahrenh	e
fahrenhe	i
fahrenhei	t
fahrenheit	s
fai	elnrt
faie	n
faien	c
faienc	e
fail	eilsu
faile	drs
failes	t
faili	n
failin	g
failing	lns
failingl	y
failingn	e
failingne	s
failingnes	s
failingness	e
failingnesse	s
faill	e
fails	o
failso	f
failsof	t
failu	r
failur	e
failure	s
fain	t
faint	ehilns
fainte	drs
fainter	s
faintes	t
fainth	e
fainthe	a
fainthea	r
fainthear	t
faintheart	e
fainthearte	d
fainti	ns
faintin	g
fainting	l
faintingl	y
faintis	h
faintish	n
faintishn	e
faintishne	s
faintishnes	s
faintishness	e
faintishnesse	s
faintl	ey
faintle	s
faintles	s
faintn	e
faintne	s
faintnes	s
faintness	e
faintnesse	s
fair	bcefgilmnpsvwy
fairb	a
fairba	n
fairban	k
fairbank	s
fairc	h
fairch	i
fairchi	l
fairchil	d
faire	drs
faires	t
fairf	ai
fairfa	x
fairfi	e
fairfie	l
fairfiel	d
fairg	r
fairgr	o
fairgro	u
fairgrou	n
fairgroun	d
fairground	s
fairi	elns
fairie	rs
fairies	t
fairil	y
fairin	g
fairis	h
fairl	y
fairm	o
fairmo	n
fairmon	t
fairn	e
fairne	s
fairnes	s
fairness	e
fairnesse	s
fairp	o
fairpo	r
fairpor	t
fairv	i
fairvi	e
fairvie	w
fairw	a
fairwa	y
fairy	hlt
fairyh	o
fairyho	o
fairyhoo	d
fairyl	ai
fairyla	n
fairylan	d
fairyli	k
fairylik	e
fairyt	a
fairyta	l
fairytal	e
fait	h
faith	fls
faithf	u
faithfu	l
faithful	lns
faithfull	y
faithfuln	e
faithfulne	s
faithfulnes	s
faithfulness	e
faithfulnesse	s
faithl	e
faithle	s
faithles	s
faithless	ln
faithlessl	y
faithlessn	e
faithlessne	s
faithlessnes	s
faj	aq
fak	eiv
fake	drs
faker	is
fakeri	e
fakerie	s
fakes	t
faki	nr
fakin	g
fal	cklmrstv
falc	ho
falch	i
falchi	o
falchio	n
falco	n
falcon	eors
falcone	rt
falcono	i
falconoi	d
falconr	y
falk	l
falkl	a
falkla	n
falklan	d
falkland	s
fall	abeios
falla	c
fallac	iy
fallaci	eo
fallacie	s
fallacio	u
fallaciou	s
fallb	a
fallba	c
fallbac	k
fallback	s
falle	nr
fallen	n
fallenn	e
fallenne	s
fallennes	s
falli	bn
fallib	il
fallibi	l
fallibil	i
fallibili	t
fallibilit	y
fallibl	ey
fallible	n
falliblen	e
falliblene	s
falliblenes	s
fallibleness	e
falliblenesse	s
fallin	g
fallo	fpuw
fallof	f
fallop	i
fallopi	a
fallopia	n
fallopian	t
fallopiant	u
fallopiantu	b
fallopiantub	e
fallopiantube	s
fallou	t
fallout	s
fallow	eins
fallowe	d
fallowi	n
fallowin	g
fallown	e
fallowne	s
fallownes	s
fallowness	e
fallownesse	s
falm	o
falmo	u
falmou	t
falmout	h
fals	eit
false	hlnrstw
falseh	o
falseho	o
falsehoo	d
falsehood	s
falsel	y
falsen	e
falsene	s
falsenes	s
falseness	e
falsenesse	s
falses	t
falset	t
falsett	o
falsew	o
falsewo	r
falsewor	k
falsi	ft
falsif	iy
falsifi	ce
falsific	a
falsifica	t
falsificat	i
falsificati	o
falsificatio	n
falsifie	drs
falsify	i
falsifyi	n
falsifyin	g
falsit	y
falst	a
falsta	f
falstaf	f
falt	be
faltb	o
faltbo	a
faltboa	t
falte	r
falter	eis
faltere	dr
falterer	s
falteri	n
falterin	g
faltering	ls
falteringl	y
fam	eiou
fame	dfls
famef	u
famefu	l
famel	e
famele	s
fameles	s
fami	lns
famil	aiy
famila	r
familar	i
familari	t
familarit	y
famili	aes
familia	lr
familiar	ilns
familiari	stz
familiaris	eim
familiarise	ds
familiarisi	n
familiarisin	g
familiarising	l
familiarisingl	y
familiarit	iy
familiariti	e
familiaritie	s
familiariz	aei
familiariza	t
familiarizat	i
familiarizati	o
familiarizatio	n
familiarization	s
familiarize	drs
familiarizer	s
familiarizi	n
familiarizin	g
familiarl	y
familiarn	e
familiarne	s
familiarnes	s
familiarness	e
familiarnesse	s
familie	s
familis	m
family	hm
familyh	o
familyho	o
familyhoo	d
familyhood	s
familym	a
familyma	r
familymar	t
famin	eg
famine	s
famis	h
famish	e
famishe	d
famo	u
famou	s
famous	ln
famousl	y
famousn	e
famousne	s
famousnes	s
famousness	e
famousnesse	s
famu	l
famul	u
famulu	s
fan	acdefgilnostwz
fana	t
fanat	i
fanati	c
fanatic	ais
fanatica	l
fanatical	ln
fanaticall	y
fanaticaln	e
fanaticalne	s
fanaticalnes	s
fanaticalness	e
fanaticalnesse	s
fanatici	s
fanaticis	m
fanc	iy
fanci	efln
fancie	drs
fancier	s
fancies	t
fancif	u
fancifu	l
fanciful	l
fancifull	y
fancil	ey
fancile	s
fanciles	s
fancin	e
fancine	s
fancines	s
fanciness	e
fancinesse	s
fancy	iw
fancyi	n
fancyin	g
fancyw	o
fancywo	r
fancywor	k
fand	a
fanda	n
fandan	g
fandang	o
fanf	ao
fanfa	r
fanfar	e
fanfare	s
fanfo	l
fanfol	d
fang	eils
fange	d
fangi	n
fangin	g
fangl	ei
fangle	ds
fangles	s
fangli	k
fanglik	e
fani	o
fanio	n
fanl	i
fanli	g
fanlig	h
fanligh	t
fann	eiy
fanne	dr
fanner	s
fanni	en
fannie	s
fannin	g
fano	u
fanou	t
fans	h
fansh	a
fansha	p
fanshap	e
fanshape	d
fant	ao
fanta	bs
fantab	u
fantabu	l
fantabul	o
fantabulo	u
fantabulou	s
fantas	ity
fantasi	aesz
fantasie	s
fantasis	eit
fantasise	ds
fantasisi	n
fantasisin	g
fantasiz	ei
fantasize	drs
fantasizer	s
fantasizi	n
fantasizin	g
fantast	i
fantasti	c
fantastic	ans
fantastica	lt
fantastical	iln
fantasticali	t
fantasticalit	iy
fantasticaliti	e
fantasticalitie	s
fantasticall	y
fantasticaln	e
fantasticalne	s
fantasticalnes	s
fantasticalness	e
fantasticalnesse	s
fantasticat	o
fantasticn	e
fantasticne	s
fantasticnes	s
fantasy	i
fantasyi	n
fantasyin	g
fanto	d
fanw	i
fanwi	s
fanwis	e
fanz	i
fanzi	n
fanzin	e
fanzine	s
fao	bemv
fap	u
faq	deos
faqe	v
faqo	v
far	abcefgiklmnorst
fara	dw
farad	a
farada	y
faraw	a
farawa	y
faraway	n
farawayn	e
farawayne	s
farawaynes	s
farb	e
farbe	r
farc	eiy
farce	drs
farci	cefn
farcic	a
farcica	l
farcif	y
farcin	g
fare	adrsw
farea	s
fareas	t
fareast	e
fareaste	r
fareaster	n
farer	s
farew	e
farewe	l
farewel	l
farewell	eis
farewelle	d
farewelli	n
farewellin	g
farf	ae
farfa	m
farfam	e
farfame	d
farfe	t
farfet	c
farfetc	h
farfetch	e
farfetche	d
farg	o
fari	n
farin	ag
farina	c
farinac	e
farinace	o
farinaceo	u
farinaceou	s
fark	a
farka	s
farl	e
farle	y
farm	aehilsy
farma	b
farmab	l
farmabl	e
farme	dr
farmer	els
farmere	s
farmeres	s
farmerl	iy
farmerli	k
farmerlik	e
farmh	ao
farmha	n
farmhan	d
farmho	u
farmhou	s
farmhous	e
farmhouse	s
farmi	n
farmin	g
farming	st
farmingt	o
farmingto	n
farml	a
farmla	n
farmlan	d
farms	t
farmst	e
farmste	a
farmstea	d
farmy	a
farmya	r
farmyar	d
farmyard	s
farn	es
farne	s
farnes	s
farness	e
farnesse	s
farns	w
farnsw	o
farnswo	r
farnswor	t
farnswort	h
faro	ef
farof	f
farr	aeio
farra	g
farrag	o
farre	l
farrel	l
farri	e
farrie	r
farrier	y
farro	w
fars	ei
farse	e
farsee	i
farseei	n
farseein	g
farsi	g
farsig	h
farsigh	t
farsight	e
farsighte	d
farsighted	n
farsightedn	e
farsightedne	s
farsightednes	s
fart	ehis
farte	dr
farth	ei
farthe	rs
farther	am
farthera	n
fartheran	c
fartheranc	e
fartherm	o
farthermo	rs
farthermor	e
farthermos	t
farthes	t
farthi	n
farthin	g
farthing	a
farthinga	l
farthingal	e
farti	n
fartin	g
fas	ceht
fasc	i
fasci	acns
fascia	t
fasciat	e
fasciate	d
fascic	lu
fascicl	e
fascicu	l
fascicul	a
fascicula	r
fascin	a
fascina	t
fascinat	ei
fascinate	ds
fascinati	nov
fascinatin	g
fascinatio	n
fascinativ	e
fascis	mt
fascism	s
fascist	is
fascisti	c
fascistic	a
fascistica	l
fascistical	l
fascisticall	y
fash	i
fashi	o
fashio	n
fashion	aeilms
fashiona	b
fashionab	il
fashionabi	l
fashionabil	i
fashionabili	t
fashionabilit	iy
fashionabiliti	e
fashionabilitie	s
fashionabl	ey
fashionable	ns
fashionablen	e
fashionablene	s
fashionablenes	s
fashionableness	e
fashionablenesse	s
fashione	dr
fashioner	s
fashioni	ns
fashionin	g
fashionis	t
fashionl	e
fashionle	s
fashionles	s
fashionm	o
fashionmo	n
fashionmon	g
fashionmong	e
fashionmonge	r
fast	aeimnst
fasta	p
fastap	i
faste	dnrs
fasten	eis
fastene	dr
fastener	s
fasteni	n
fastenin	g
fastening	s
fastes	t
fasti	dfn
fastid	i
fastidi	o
fastidio	u
fastidiou	s
fastidious	ln
fastidiousl	y
fastidiousn	e
fastidiousne	s
fastidiousnes	s
fastidiousness	e
fastidiousnesse	s
fastif	y
fastin	g
fastm	a
fastma	i
fastmai	l
fastn	e
fastne	s
fastnes	s
fastt	r
fasttr	a
fasttra	c
fasttrac	k
fasttrack	es
fasttracke	r
fat	aehilnstuv
fata	l
fatal	ilns
fatali	st
fatalis	mt
fatalist	i
fatalisti	c
fatalit	iy
fataliti	e
fatalitie	s
fatall	y
fataln	e
fatalne	s
fatalnes	s
fatalness	e
fatalnesse	s
fate	dfs
fatef	u
fatefu	l
fateful	ln
fatefull	y
fatefuln	e
fatefulne	s
fatefulnes	s
fatefulness	e
fatefulnesse	s
fath	eo
fathe	ar
fathea	d
fathead	e
fatheade	d
father	cehils
fatherc	h
fatherch	r
fatherchr	i
fatherchri	s
fatherchris	t
fatherchrist	m
fatherchristm	a
fatherchristma	s
fatherchristmas	e
fatherchristmase	s
fathere	d
fatherh	o
fatherho	o
fatherhoo	d
fatherhood	s
fatheri	n
fatherin	g
fatherl	aeiy
fatherla	n
fatherlan	d
fatherle	s
fatherles	s
fatherli	n
fatherlin	e
fatherline	s
fatherlines	s
fatherliness	e
fatherlinesse	s
fatho	m
fathom	eils
fathome	drt
fathomer	s
fathomet	e
fathomete	r
fathomi	n
fathomin	g
fathoml	e
fathomle	s
fathomles	s
fati	gmn
fatig	u
fatigu	aei
fatigua	b
fatiguab	il
fatiguabi	l
fatiguabil	i
fatiguabili	t
fatiguabilit	y
fatiguabl	e
fatigue	ds
fatigues	o
fatigueso	m
fatiguesom	e
fatigui	n
fatiguin	g
fatiguing	l
fatiguingl	y
fatim	a
fatin	g
fatl	ei
fatle	s
fatles	s
fatli	kn
fatlik	e
fatlin	g
fatn	e
fatne	s
fatnes	s
fatness	e
fatnesse	s
fats	o
fatt	eiy
fatte	dnrs
fatten	aeis
fattena	b
fattenab	l
fattenabl	e
fattene	dr
fattener	s
fatteni	n
fattenin	g
fattening	s
fattes	t
fatti	elns
fattie	rs
fatties	t
fattil	y
fattin	eg
fattine	s
fattines	s
fattiness	e
fattinesse	s
fattis	h
fatu	io
fatui	t
fatuit	y
fatuo	u
fatuou	s
fau	cglnrsvx
fauc	ae
fauca	l
fauce	t
faucet	s
faug	h
faul	kt
faulk	n
faulkn	e
faulkne	r
faulkner	i
faulkneri	a
faulkneria	n
fault	efilsuy
faulte	d
faultf	iu
faultfi	n
faultfin	d
faultfind	ei
faultfinde	r
faultfindi	n
faultfindin	g
faultfu	l
faulti	eln
faultie	rs
faulties	t
faultil	y
faultin	eg
faultine	s
faultines	s
faultiness	e
faultinesse	s
faultl	e
faultle	s
faultles	s
faultless	ln
faultlessl	y
faultlessn	e
faultlessne	s
faultlessnes	s
faultlessness	e
faultlessnesse	s
faultu	r
faultur	e
faun	ait
fauna	els
faunal	l
faunall	y
fauni	s
faunis	t
faunt	l
fauntl	e
fauntle	r
fauntler	o
fauntlero	y
faus	t
faust	iu
fausti	a
faustia	n
faustu	s
fauv	i
fauvi	s
fauvis	m
fav	eiov
fave	s
favi	c
favic	o
favico	n
favo	ru
favor	aeis
favora	b
favorab	l
favorabl	ey
favore	dr
favori	nt
favorin	g
favorit	ei
favorite	s
favoriti	s
favoritis	m
favou	r
favour	aeils
favoura	b
favourab	il
favourabi	l
favourabil	i
favourabili	t
favourabilit	y
favourabl	ey
favourable	n
favourablen	e
favourablene	s
favourablenes	s
favoure	d
favouri	nt
favourin	g
favourit	ei
favourite	s
favouriti	s
favouritis	m
favourl	e
favourle	s
favourles	s
faw	kn
fawk	e
fawke	s
fawn	eils
fawne	drs
fawner	s
fawnes	t
fawni	en
fawnie	r
fawnin	g
fawning	ln
fawningl	y
fawningn	e
fawningne	s
fawningnes	s
fawnl	i
fawnli	k
fawnlik	e
fax	aeiux
faxa	b
faxab	l
faxabl	e
faxe	drs
faxes	t
faxi	n
faxin	g
fay	eho
faye	t
fayet	t
fayett	e
fayette	v
fayettev	i
fayettevi	l
fayettevil	l
fayettevill	e
faz	ei
faze	ds
fazi	n
fazin	g
fb	abcdeghikmnopqrstuvx
fba	rsv
fbb	foz
fbd	e
fbe	adfqw
fbg	n
fbi	rsvw
fbiw	a
fbiwa	r
fbiwar	n
fbiwarn	i
fbiwarni	n
fbiwarnin	g
fbk	ikr
fbm	r
fbn	rsv
fbo	hv
fbp	dnv
fbq	dp
fbqd	v
fbqp	v
fbr	v
fbu	hrv
fc	acdeiklmnorsvwy
fca	rsv
fcc	cv
fcd	j
fce	beu
fci	t
fcit	x
fcn	bv
fcr	as
fcw	cv
fcy	o
fd	abcdefghijklmnopqrstuvwxyz
fdb	prsv
fdc	v
fdd	bcflquv
fddc	v
fddf	v
fddl	v
fddq	v
fde	mruvz
fdf	uv
fdg	bfrv
fdh	v
fdi	l
fdj	v
fdk	w
fdl	s
fdn	cflmv
fdnc	v
fdnl	v
fdo	osv
fdq	l
fdr	quw
fds	rv
fdt	ov
fdu	v
fdv	m
fdy	fy
fdz	u
fe	abcdefghijklmnopqrstuvwxyz
fea	flrst
feal	t
fealt	y
fear	efils
feare	dr
fearer	s
fearf	u
fearfu	l
fearful	eln
fearfule	rs
fearfules	t
fearfull	y
fearfuln	e
fearfulne	s
fearfulnes	s
fearfulness	e
fearfulnesse	s
feari	n
fearin	g
fearing	l
fearingl	y
fearl	e
fearle	s
fearles	s
fearless	ln
fearlessl	y
fearlessn	e
fearlessne	s
fearlessnes	s
fearlessness	e
fearlessnesse	s
fears	o
fearso	m
fearsom	e
feas	ait
feasa	n
feasan	c
feasanc	e
feasi	b
feasib	il
feasibi	l
feasibil	i
feasibili	t
feasibilit	iy
feasibiliti	e
feasibilitie	s
feasibl	ey
feasible	n
feasiblen	e
feasiblene	s
feasiblenes	s
feasibleness	e
feasiblenesse	s
feast	eils
feaste	dr
feaster	s
feasti	n
feastin	g
feastl	e
feastle	s
feastles	s
feat	ehnsu
feate	rs
feates	t
feath	e
feathe	r
feather	beilmswy
featherb	er
featherbe	d
featherbed	d
featherbedd	i
featherbeddi	n
featherbeddin	g
featherbr	a
featherbra	i
featherbrai	n
featherbrain	e
featherbraine	d
feathere	dr
feathered	g
featheredg	e
featherer	s
featheri	en
featherie	rs
featheries	t
featherin	eg
featherine	s
featherines	s
featheriness	e
featherinesse	s
featherl	ei
featherle	st
featherles	s
featherless	n
featherlessn	e
featherlessne	s
featherlessnes	s
featherlessness	e
featherlessnesse	s
featherli	k
featherlik	e
featherm	a
featherma	n
featherw	e
featherwe	i
featherwei	g
featherweig	h
featherweigh	t
featn	e
featne	s
featnes	s
featu	r
featur	ei
feature	dls
featurel	e
featurele	s
featureles	s
featuri	n
featurin	g
feb	abdfhilmqrstux
feba	rv
febd	v
febr	iu
febri	f
febrif	u
febrifu	g
febrifug	e
febru	a
februa	r
februar	iy
februari	e
februarie	s
february	s
fec	aeku
feca	l
fece	s
feces	e
fecese	s
feck	l
feckl	e
feckle	s
feckles	s
fecu	ln
fecul	e
fecule	n
feculen	ct
feculenc	e
fecun	d
fecund	ai
fecunda	t
fecundat	ei
fecundati	o
fecundatio	n
fecundi	t
fecundit	y
fed	bdeios
fedd	e
fedde	r
fedder	s
fede	rx
feder	a
federa	lt
federal	ilns
federali	sz
federalis	emt
federalist	is
federalisti	c
federaliz	ae
federaliza	t
federalizat	i
federalizati	o
federalizatio	n
federall	y
federaln	e
federalne	s
federalnes	s
federalness	e
federalnesse	s
federat	eio
federate	ds
federati	nov
federatin	g
federatio	n
federation	is
federationi	s
federationis	t
federativ	e
federato	r
federator	s
fedi	v
fediv	e
fedive	r
fediver	s
fedivers	e
fedo	r
fedor	a
fedora	c
fedorac	o
fedoraco	r
fedoracor	e
fedoracore	o
fedoracoreo	s
fee	bdilmnrstv
feeb	l
feebl	eiy
feeble	mnrs
feeblem	i
feeblemi	n
feeblemin	d
feeblemind	e
feebleminde	d
feeblen	e
feeblene	s
feeblenes	s
feebleness	e
feeblenesse	s
feebles	t
feebli	n
feeblin	g
feed	abeils
feeda	b
feedab	l
feedabl	e
feedb	a
feedba	c
feedbac	k
feedback	s
feede	r
feeder	s
feedi	n
feedin	g
feeding	s
feedl	o
feedlo	t
feeds	t
feedst	u
feedstu	f
feedstuf	f
feei	n
feein	g
feel	aeis
feela	b
feelab	l
feelabl	e
feele	rs
feeler	s
feeles	s
feeli	n
feelin	g
feeling	flns
feelingf	u
feelingfu	l
feelingl	ey
feelingle	s
feelingles	s
feelingn	e
feelingne	s
feelingnes	s
feelingness	e
feelingnesse	s
feen	eis
feene	dy
feeni	n
feenin	g
fef	af
feg	u
feh	e
fehe	l
fehel	p
fehelp	e
fehelpe	r
fei	agns
feig	n
feign	ei
feigne	d
feigni	n
feignin	g
fein	t
feis	t
fek	v
fel	dilostuv
feld	ems
felde	r
feldm	a
feldma	n
felds	p
feldsp	a
feldspa	r
feldspar	s
feli	cnx
felic	ei
felici	at
felicit	aioy
felicita	t
felicitat	e
feliciti	e
felicitie	s
felicito	u
felicitou	s
felin	ei
feline	lns
felinel	y
felinen	e
felinene	s
felinenes	s
felineness	e
felinenesse	s
felini	t
felinit	iy
feliniti	e
felinitie	s
fell	aeimnos
fella	bt
fellab	l
fellabl	e
fellat	i
fellati	o
felle	drs
feller	s
felles	t
felli	n
fellin	gi
fellm	o
fellmo	n
fellmon	g
fellmong	e
fellmonge	r
felln	e
fellne	s
fellnes	s
fellness	e
fellnesse	s
fello	w
fellow	eims
fellowe	ds
fellowes	s
fellowi	n
fellowin	g
fellowm	e
fellowme	n
fellows	h
fellowsh	i
fellowshi	p
fellowship	eips
fellowshipe	d
fellowshipi	n
fellowshipin	g
fellowshipp	ei
fellowshippe	d
fellowshippi	n
fellowshippin	g
felo	n
felon	irsy
feloni	eo
felonie	s
felonio	u
feloniou	s
felonr	y
fels	i
felsi	t
felsit	e
felt	ilnsy
felti	n
feltin	g
feltl	i
feltli	k
feltlik	e
feltn	e
feltne	s
feltnes	s
felu	c
feluc	c
felucc	a
fem	adeimotu
fema	l
femal	ei
female	lns
femalel	y
femalen	e
femalene	s
femalenes	s
femaleness	e
femalenesse	s
femali	tz
femalit	y
femaliz	e
femd	o
femdo	m
femi	nt
femin	ei
femine	i
feminei	t
femineit	y
femini	nsz
feminin	ei
feminine	lns
femininel	y
femininen	e
femininene	s
femininenes	s
feminineness	e
femininenesse	s
feminini	t
femininit	y
feminis	emt
feminism	s
feminist	s
feminiz	e
femit	r
femitr	o
femitro	n
femitron	s
femm	e
femo	r
femor	a
femora	l
femt	o
femto	s
femtos	e
femtose	c
femtosec	o
femtoseco	n
femtosecon	d
femu	r
femur	s
fen	bcdeglnptuw
fenc	ei
fence	dflrs
fencef	u
fencefu	l
fencel	ei
fencele	s
fenceles	s
fenceless	n
fencelessn	e
fencelessne	s
fencelessnes	s
fencelessness	e
fencelessnesse	s
fenceli	k
fencelik	e
fencer	s
fenci	bn
fencib	l
fencibl	e
fencin	g
fencing	s
fend	eisy
fende	dr
fender	els
fendere	d
fenderl	e
fenderle	s
fenderles	s
fendi	n
fendin	g
fene	s
fenes	t
fenest	e
feneste	l
fenestel	l
fenestell	a
feng	h
fengh	u
fenghu	a
fenl	a
fenla	n
fenlan	d
fenn	ey
fenne	l
fennel	s
fent	o
fento	n
fenu	g
fenug	r
fenugr	e
fenugre	e
fenugree	k
fenw	i
fenwi	c
fenwic	k
feo	efkqw
feof	f
feoff	m
feoffm	e
feoffme	n
feoffmen	t
fep	v
feq	d
fer	abdgilmnortuv
fera	l
feral	ls
ferall	y
ferb	e
ferbe	r
ferd	i
ferdi	n
ferdin	a
ferdina	n
ferdinan	d
ferdinand	o
ferg	u
fergu	s
fergus	o
ferguso	n
feri	a
feria	l
ferm	aei
ferma	t
ferme	n
fermen	t
ferment	aeis
fermenta	bt
fermentab	il
fermentabi	l
fermentabil	i
fermentabili	t
fermentabilit	iy
fermentabiliti	e
fermentabilitie	s
fermentabl	e
fermentat	i
fermentati	ov
fermentatio	n
fermentation	s
fermentativ	e
fermente	d
fermenti	n
fermentin	g
fermi	u
fermiu	m
fern	aeilsy
ferna	n
fernan	d
fernand	eo
fernande	z
ferne	r
ferner	y
ferni	en
fernie	rs
fernies	t
fernin	s
fernins	t
ferninst	e
ferninste	r
fernl	ei
fernle	s
fernles	s
fernli	k
fernlik	e
fero	c
feroc	i
feroci	ot
ferocio	u
ferociou	s
ferocious	ln
ferociousl	y
ferociousn	e
ferociousne	s
ferociousnes	s
ferociousness	e
ferociousnesse	s
ferocit	iy
ferociti	e
ferocitie	s
ferr	aeiouy
ferra	gr
ferrag	a
ferraga	m
ferragam	o
ferrar	i
ferre	irt
ferrei	r
ferreir	a
ferret	eis
ferrete	dr
ferreter	s
ferreti	n
ferretin	g
ferri	cest
ferrie	ds
ferrit	e
ferrite	s
ferro	mtu
ferrom	a
ferroma	g
ferromag	n
ferromagn	e
ferromagne	t
ferromagnet	i
ferromagneti	cs
ferromagnetis	m
ferrot	y
ferroty	p
ferrotyp	e
ferrou	s
ferru	lm
ferrul	e
ferry	ai
ferrya	b
ferryab	l
ferryabl	e
ferryi	n
ferryin	g
fert	i
ferti	l
fertil	ei
fertile	ln
fertilel	y
fertilen	e
fertilene	s
fertilenes	s
fertileness	e
fertilenesse	s
fertili	stz
fertilis	ei
fertilise	drs
fertilisi	n
fertilisin	g
fertilit	y
fertiliz	aei
fertiliza	bt
fertilizab	i
fertilizabi	l
fertilizabil	i
fertilizabili	t
fertilizabilit	iy
fertilizabiliti	e
fertilizabilitie	s
fertilizat	i
fertilizati	o
fertilizatio	n
fertilize	drs
fertilizer	s
fertilizi	n
fertilizin	g
feru	l
ferul	a
ferv	eio
ferve	n
ferven	ct
fervenc	y
fervent	ln
ferventl	y
ferventn	e
ferventne	s
ferventnes	s
ferventness	e
ferventnesse	s
fervi	d
fervo	ru
fervor	s
fervou	r
fes	cdiqstx
fesc	eu
fesce	n
fescen	n
fescenn	i
fescenni	n
fescennin	e
fescu	e
fesi	v
fest	aeios
festa	l
feste	r
fester	eims
festere	d
festeri	n
festerin	g
festerm	e
festerme	n
festermen	t
festi	v
festiv	aeio
festiva	l
festival	s
festive	ln
festivel	y
festiven	e
festivene	s
festivenes	s
festiveness	e
festivenesse	s
festivi	t
festivit	iy
festiviti	e
festivitie	s
festivo	u
festivou	s
festo	o
festoo	n
fests	c
festsc	h
festsch	r
festschr	i
festschri	f
festschrif	t
fet	aceilortu
feta	l
fetc	h
fetch	ei
fetche	drs
fetcher	s
fetchi	n
fetchin	g
fetching	l
fetchingl	y
feti	cds
fetic	i
fetici	d
feticid	e
fetis	ch
fetisc	h
fetish	i
fetishi	s
fetishis	mt
fetishist	i
fetishisti	c
fetl	o
fetlo	c
fetloc	k
feto	lr
fetol	o
fetolo	g
fetolog	y
fett	el
fette	r
fetter	es
fettere	d
fettl	e
fetu	s
fetus	e
fetuse	s
feu	d
feud	aeis
feuda	lt
feudal	il
feudali	s
feudalis	mt
feudalism	s
feudalist	is
feudalisti	c
feudall	y
feudat	o
feudato	r
feudator	y
feude	dr
feudi	ns
feudin	g
feudis	t
fev	ev
feve	r
fever	efils
fevere	dt
feverf	e
feverfe	w
feveri	ns
feverin	g
feveris	h
feverish	ln
feverishl	y
feverishn	e
feverishne	s
feverishnes	s
feverishness	e
feverishnesse	s
feverl	e
feverle	s
feverles	s
few	ensuv
fewe	rs
fewes	t
fewn	e
fewne	s
fewnes	s
fewness	e
fewnesse	s
fey	hu
fez	rsv
ff	bcefijklmnopqrstuyz
ffb	v
ffc	c
ffe	bcdefhlprtuv
ffec	v
ffef	rv
fff	cdfikrstvx
fffc	v
ffft	v
ffj	u
ffl	bft
ffm	prv
ffmp	e
ffmpe	g
ffn	acdefghijkorstuvwxyz
ffna	rv
ffnc	v
ffne	rv
ffnf	rv
ffnr	v
ffns	rv
ffnt	rv
ffnu	v
ffnw	v
ffo	clo
ffp	v
ffq	b
ffr	euv
ffre	m
ffrem	o
ffremo	n
ffremon	t
fft	bv
fftb	v
ffu	bv
ffy	fgrsv
ffz	ou
fg	ailnoqrtxy
fgi	amu
fgn	ov
fgq	df
fgqf	v
fgr	am
fgy	u
fh	acdefjmnotvx
fha	rv
fhc	c
fht	b
fhx	v
fi	abcdefgjlmnoprstvxz
fia	cnstv
fiac	r
fiacr	e
fian	c
fianc	e
fiance	es
fias	c
fiasc	ho
fiasch	i
fiasco	es
fiascoe	s
fib	beorsu
fibb	ei
fibbe	dr
fibber	sy
fibbi	n
fibbin	g
fibe	r
fiber	gs
fiberg	l
fibergl	a
fibergla	s
fiberglas	s
fibo	n
fibon	a
fibona	c
fibonac	c
fibonacc	i
fibr	eio
fibre	dgls
fibreg	l
fibregl	a
fibregla	s
fibreglas	s
fibrel	e
fibrele	s
fibreles	s
fibri	ln
fibrin	aos
fibrina	t
fibrinat	i
fibrinati	o
fibrinatio	n
fibrino	gu
fibrinog	e
fibrinoge	n
fibrinogen	s
fibrinou	s
fibro	imsu
fibroi	dn
fibrom	a
fibros	i
fibrosi	nst
fibrosin	g
fibrosit	iy
fibrositi	e
fibrositie	s
fibrou	s
fibrous	l
fibrousl	y
fibs	t
fibst	e
fibste	r
fibster	s
fibu	l
fibul	a
fibula	ers
fic	hkt
fich	eu
fick	l
fickl	ey
fickle	nrs
ficklen	e
ficklene	s
ficklenes	s
fickleness	e
ficklenesse	s
fickles	t
fict	i
ficti	lotv
fictil	e
fictio	n
fiction	as
fictiona	lr
fictional	il
fictionali	tz
fictionalit	iy
fictionaliti	e
fictionalitie	s
fictionaliz	a
fictionaliza	t
fictionalizat	i
fictionalizati	o
fictionalizatio	n
fictionall	y
fictionar	y
fictit	i
fictiti	o
fictitio	u
fictitiou	s
fictitious	ln
fictitiousl	y
fictitiousn	e
fictitiousne	s
fictitiousnes	s
fictitiousness	e
fictitiousnesse	s
fictiv	e
fid	degu
fidd	l
fiddl	eiy
fiddle	drs
fiddler	s
fiddles	t
fiddlest	i
fiddlesti	c
fiddlestic	k
fiddlestick	s
fiddli	en
fiddlie	rs
fiddlies	t
fiddlin	g
fiddling	s
fide	l
fidel	i
fideli	t
fidelit	iy
fideliti	e
fidelitie	s
fidg	e
fidge	t
fidget	eisy
fidgete	dr
fidgeter	s
fidgeti	n
fidgetin	g
fidgeting	l
fidgetingl	y
fidu	c
fiduc	i
fiduci	a
fiducia	lr
fiduciar	y
fie	flnrsv
fief	d
fiefd	o
fiefdo	m
fiel	d
field	efipsw
fielde	drs
fielder	s
fieldes	t
fieldf	u
fieldfu	l
fieldi	n
fieldin	g
fieldp	i
fieldpi	e
fieldpie	c
fieldpiec	e
fields	t
fieldst	o
fieldsto	n
fieldston	e
fieldw	ao
fieldwa	r
fieldwar	d
fieldward	s
fieldwo	r
fieldwor	k
fieldwork	es
fieldworke	r
fieldworker	s
fien	d
fiend	eils
fiende	d
fiendi	ns
fiendin	g
fiendis	h
fiendish	n
fiendishn	e
fiendishne	s
fiendishnes	s
fiendishness	e
fiendishnesse	s
fiendl	iy
fiendli	k
fiendlik	e
fier	ciy
fierc	e
fierce	lnrs
fiercel	y
fiercen	e
fiercene	s
fiercenes	s
fierceness	e
fiercenesse	s
fierces	t
fieri	eln
fierie	rs
fieries	t
fieril	y
fierin	e
fierine	s
fierines	s
fieriness	e
fierinesse	s
fies	t
fiest	a
fiesta	s
fif	abcdefloprtu
fifc	v
fife	r
fiff	rv
fifp	rv
fifr	v
fift	ehiy
fifte	e
fiftee	n
fifteen	est
fifteene	r
fifteent	h
fifteenth	s
fifth	els
fifthe	rs
fifthes	t
fifthl	y
fifti	e
fiftie	rst
fifties	t
fiftiet	h
fiftieth	s
fifty	fi
fiftyf	o
fiftyfo	l
fiftyfol	d
fiftyi	s
fiftyis	h
fig	aeghmsuw
figa	r
figar	o
fige	a
figea	t
figeat	e
figeate	r
figg	eiy
figge	d
figgi	n
figgin	g
figh	t
fight	aeisy
fighta	b
fightab	il
fightabi	l
fightabil	i
fightabili	t
fightabilit	iy
fightabiliti	e
fightabilitie	s
fightabl	e
fighte	r
fighter	s
fighti	n
fightin	g
fighting	l
fightingl	y
figm	e
figme	n
figmen	t
figu	lr
figul	i
figuli	n
figulin	e
figur	aei
figura	lt
figurat	i
figurati	ov
figuratio	n
figurativ	e
figurative	ln
figurativel	y
figurativen	e
figurativene	s
figurativenes	s
figurativeness	e
figurativenesse	s
figure	dhlrs
figureh	e
figurehe	a
figurehea	d
figurel	e
figurele	s
figureles	s
figurer	s
figuri	n
figurin	eg
figurine	s
figuring	s
figw	o
figwo	r
figwor	t
fij	i
fiji	a
fijia	n
fijian	s
fil	abcehilmt
fila	mr
filam	e
filame	n
filamen	t
filament	aeos
filamenta	r
filamentar	y
filamente	d
filamento	isu
filamentoi	d
filamentos	e
filamentou	s
filb	e
filbe	r
filber	t
filc	h
file	acdmnprstv
filea	b
fileab	l
fileabl	e
filec	o
fileco	i
filecoi	n
filem	a
filema	k
filemak	e
filemake	r
filen	a
filena	m
filenam	e
filename	s
filep	l
filepl	a
filepla	n
fileplan	e
fileplane	t
filer	s
files	iy
filesi	z
filesiz	e
filesy	s
filesys	t
filesyst	e
filesyste	m
filet	y
filety	p
filetyp	e
filev	a
fileva	u
filevau	l
filevaul	t
filh	e
filhe	r
filher	m
filherm	a
filherma	n
fili	abcnp
filia	lt
filiat	i
filiati	o
filiatio	n
filib	u
filibu	s
filibus	t
filibust	e
filibuste	r
filic	i
filici	d
filicid	e
filin	g
filing	s
filip	ip
filipi	n
filipin	o
filipino	s
filipp	o
fill	aeimosy
filla	b
fillab	l
fillabl	e
fille	drt
filler	s
fillet	eis
fillete	dr
filleti	n
filletin	g
filli	enp
fillie	s
fillin	g
filling	s
fillm	o
fillmo	r
fillmor	e
fillo	u
fillou	t
film	degilmosy
filmd	o
filmdo	m
filme	dr
filmg	o
filmgo	e
filmgoe	r
filmi	cn
filmin	g
filml	ei
filmle	s
filmles	s
filmli	k
filmlik	e
filmm	a
filmma	k
filmmak	e
filmmake	r
filmmaker	s
filmo	g
filmog	r
filmogr	a
filmogra	p
filmograp	h
filmograph	y
films	t
filmst	r
filmstr	i
filmstri	p
filt	ehr
filte	r
filter	aeis
filtera	b
filterab	l
filterabl	e
filtere	dr
filterer	s
filteri	n
filterin	g
filth	isy
filthi	efln
filthie	drs
filthies	t
filthif	y
filthil	y
filthin	e
filthine	s
filthines	s
filthiness	e
filthinesse	s
filthy	i
filthyi	n
filthyin	g
filtr	a
filtra	t
filtrat	aei
filtrata	b
filtratab	l
filtratabl	e
filtrate	ds
filtrati	no
filtratin	g
filtratio	n
filtration	s
fim	b
fin	abcdegiklns
fina	bgln
finab	l
finabl	e
finag	l
finagl	e
final	ceils
finalc	u
finalcu	t
finalcut	p
finalcutp	r
finalcutpr	o
finale	s
finali	stz
finalis	eit
finalise	ds
finalisi	n
finalisin	g
finalist	s
finalit	y
finaliz	aei
finaliza	t
finalizat	i
finalizati	o
finalizatio	n
finalization	s
finalize	drs
finalizer	s
finalizi	n
finalizin	g
finall	y
finals	h
finalsh	e
finalshe	l
finalshel	l
finan	c
financ	ei
finance	adrs
financea	b
financeab	l
financeabl	e
financi	aens
financia	l
financial	ils
financiali	s
financialis	t
financiall	y
financie	r
financier	s
financin	g
financis	t
finb	a
finba	c
finbac	k
finc	h
finch	el
finche	s
finchl	i
finchli	k
finchlik	e
find	aeilst
finda	br
findab	l
findabl	e
findar	t
findart	i
findarti	c
findartic	l
findarticl	e
findarticle	s
finde	r
finder	s
findi	n
findin	g
finding	s
findl	a
findla	w
findt	i
findti	m
findtim	e
fine	dlnprs
finel	y
finen	e
finene	s
finenes	s
fineness	e
finenesse	s
finep	i
finepi	x
finer	y
fines	pst
finesp	u
finespu	n
finess	ei
finesse	d
finessi	n
finessin	g
fing	e
finge	r
finger	beilmnpsty
fingerb	o
fingerbo	a
fingerboa	r
fingerboar	d
fingere	dr
fingerer	s
fingeri	n
fingerin	g
fingering	s
fingerl	ei
fingerle	s
fingerles	s
fingerli	kn
fingerlik	e
fingerlin	g
fingerm	a
fingerma	r
fingermar	k
fingermark	es
fingermarke	d
fingern	a
fingerna	i
fingernai	l
fingernail	s
fingerp	lr
fingerpl	a
fingerpla	t
fingerplat	e
fingerpr	i
fingerpri	n
fingerprin	t
fingerprint	eis
fingerprinte	d
fingerprinti	n
fingerprintin	g
fingerprinting	s
fingert	i
fingerti	p
fingertip	s
fini	acnst
finia	l
finic	ak
finica	l
finick	y
finin	g
finis	h
finish	aei
finisha	b
finishab	l
finishabl	e
finishe	drs
finisher	s
finishi	n
finishin	g
finishing	s
finit	e
finite	lns
finitel	y
finiten	e
finitene	s
finitenes	s
finiteness	e
finitenesse	s
finl	aei
finla	n
finlan	d
finle	sy
finles	s
finli	k
finlik	e
finn	eisy
finne	dg
finneg	a
finnega	n
finni	ns
finnin	g
finnis	h
fio	nr
fion	a
fior	dei
fiore	l
fiorel	l
fiorell	o
fiori	c
fioric	e
fiorice	t
fip	s
fir	eikmnrst
fire	abcdfhlmprstw
firea	br
fireab	l
fireabl	e
firear	m
firearm	es
firearme	d
fireb	aioru
fireba	l
firebal	l
firebi	r
firebir	d
firebo	amx
fireboa	t
firebom	b
firebr	aei
firebra	n
firebran	d
firebre	a
firebrea	k
firebri	c
firebric	k
firebu	g
firec	lr
firecl	a
firecla	y
firecr	a
firecra	c
firecrac	k
firecrack	e
firecracke	r
firecracker	s
fired	ar
fireda	m
firedam	p
firedr	a
firedra	k
firedrak	e
firef	ilo
firefi	g
firefig	h
firefigh	t
firefight	ei
firefighte	r
firefighter	s
firefighti	n
firefightin	g
firefighting	s
firefl	iy
firefli	e
fireflie	s
firefo	x
fireh	o
fireho	u
firehou	s
firehous	e
firel	ei
firele	s
fireles	s
fireli	gt
firelig	h
fireligh	t
firelight	s
firem	ae
firema	n
fireme	n
firep	lor
firepl	au
firepla	c
fireplac	e
fireplace	ds
fireplu	g
firepo	w
firepow	e
firepowe	r
firepr	o
firepro	o
fireproo	f
fireproof	eis
fireproofe	d
fireproofi	n
fireproofin	g
firer	s
fires	it
firesi	d
firesid	e
fireside	s
firest	o
firesto	n
fireston	e
firet	r
firetr	a
firetra	p
firew	aeio
firewa	lt
firewal	l
firewall	s
firewat	e
firewate	r
firewe	e
firewee	d
firewi	r
firewir	e
firewo	or
firewoo	d
firewood	s
firewor	k
firework	es
fireworke	r
firi	n
firin	g
firing	s
firk	i
firki	n
firm	aeilnsw
firma	m
firmam	e
firmame	n
firmamen	t
firme	drs
firmes	t
firmi	ns
firmin	g
firmis	h
firml	y
firmn	e
firmne	s
firmnes	s
firmness	e
firmnesse	s
firmw	a
firmwa	r
firmwar	e
firr	y
firs	t
first	beghlns
firstb	o
firstbo	r
firstbor	n
firstborn	s
firste	rs
firstes	t
firstg	o
firstgo	v
firsth	a
firstha	n
firsthan	d
firstl	iy
firstli	n
firstlin	g
firstn	e
firstne	s
firstnes	s
firt	h
fis	chkst
fisc	ah
fisca	l
fiscal	ils
fiscali	t
fiscalit	y
fiscall	y
fisch	be
fischb	e
fischbe	i
fischbei	n
fische	r
fish	abefhiklmptwy
fisha	b
fishab	i
fishabi	l
fishabil	i
fishabili	t
fishabilit	iy
fishabiliti	e
fishabilitie	s
fishb	o
fishbo	nw
fishbon	e
fishbow	l
fishe	drs
fisher	imsy
fisheri	e
fisherie	s
fisherm	ae
fisherma	n
fisherme	n
fishf	u
fishfu	l
fishh	o
fishho	o
fishhoo	k
fishi	eln
fishie	rs
fishies	t
fishil	y
fishin	eg
fishine	s
fishines	s
fishiness	e
fishinesse	s
fishing	s
fishk	i
fishki	l
fishkil	l
fishl	ei
fishle	s
fishles	s
fishli	kn
fishlik	e
fishlin	eg
fishm	eo
fishme	a
fishmea	l
fishmo	n
fishmon	g
fishmong	e
fishmonge	r
fishmonger	s
fishp	alo
fishpa	p
fishpap	e
fishpape	r
fishpl	a
fishpla	t
fishplat	e
fishpo	n
fishpon	d
fisht	a
fishta	i
fishtai	l
fishw	i
fishwi	f
fishwif	e
fisk	e
fiss	iu
fissi	lop
fissil	ei
fissili	t
fissilit	y
fissio	n
fission	aeis
fissiona	bl
fissionab	i
fissionabi	l
fissionabil	i
fissionabili	t
fissionabilit	y
fissione	d
fissioni	n
fissionin	g
fissip	a
fissipa	r
fissipar	o
fissiparo	u
fissiparou	s
fissu	r
fissur	aei
fissura	l
fissure	dls
fissurel	e
fissurele	s
fissureles	s
fissuri	n
fissurin	g
fist	efisu
fiste	d
fistf	i
fistfi	g
fistfig	h
fistfigh	t
fisti	cn
fistic	u
fisticu	f
fisticuf	f
fistin	g
fistu	l
fistul	a
fit	cflmnstz
fitc	h
fitch	b
fitchb	u
fitchbu	r
fitchbur	g
fitf	u
fitfu	l
fitful	l
fitfull	y
fitl	y
fitm	e
fitme	n
fitmen	t
fitn	e
fitne	s
fitnes	s
fitness	e
fitnesse	s
fitt	aei
fitta	b
fittab	l
fittabl	e
fitte	drs
fitted	n
fittedn	e
fittedne	s
fittednes	s
fittedness	e
fittednesse	s
fitter	s
fittes	t
fitti	n
fittin	g
fitting	lns
fittingl	y
fittingn	e
fittingne	s
fittingnes	s
fittingness	e
fittingnesse	s
fitz	gpr
fitzg	e
fitzge	r
fitzger	a
fitzgera	l
fitzgeral	d
fitzp	a
fitzpa	t
fitzpat	r
fitzpatr	i
fitzpatri	c
fitzpatric	k
fitzr	o
fitzro	y
fiv	e
five	frs
fivef	o
fivefo	l
fivefol	d
fiver	rs
fives	ot
fiveso	m
fivesom	e
fix	aeitu
fixa	bt
fixab	i
fixabi	l
fixabil	i
fixabili	t
fixabilit	iy
fixabiliti	e
fixabilitie	s
fixat	eiu
fixate	ds
fixati	nov
fixatin	g
fixatio	n
fixation	s
fixativ	e
fixatu	r
fixatur	e
fixe	drs
fixed	ln
fixedl	y
fixedn	e
fixedne	s
fixednes	s
fixedness	e
fixednesse	s
fixer	s
fixi	nt
fixin	g
fixing	s
fixit	y
fixt	u
fixtu	r
fixtur	e
fixture	ls
fixturel	e
fixturele	s
fixtureles	s
fixu	p
fiz	ez
fize	a
fizea	u
fizz	eily
fizze	ds
fizzi	eln
fizzie	rs
fizzies	t
fizzil	y
fizzin	eg
fizzine	s
fizzines	s
fizzl	ei
fizzle	ds
fizzli	n
fizzlin	g
fj	adefjlmnoqrsv
fje	v
fjm	efl
fjn	fgvwy
fjng	v
fjo	ru
fjor	d
fjord	is
fjordi	c
fjq	s
fjr	br
fk	abcdeiklmnopruvwz
fka	bv
fkb	kl
fki	rsv
fkk	d
fkl	br
fko	v
fkr	l
fl	abcdefghiklnopqrstuvwxyz
fla	bcdgikmnprstuvwxy
flab	b
flabb	eiy
flabbe	r
flabber	g
flabberg	a
flabberga	s
flabbergas	t
flabbergast	e
flabbergaste	d
flabbi	eln
flabbie	rs
flabbies	t
flabbil	y
flabbin	e
flabbine	s
flabbines	s
flabbiness	e
flabbinesse	s
flac	ck
flacc	i
flacci	d
flaccid	iln
flaccidi	t
flaccidit	iy
flacciditi	e
flacciditie	s
flaccidl	y
flaccidn	e
flaccidne	s
flaccidnes	s
flaccidness	e
flaccidnesse	s
flad	v
flag	begilmoprs
flagb	o
flagbo	a
flagboa	t
flage	lo
flagel	l
flagell	aiu
flagella	t
flagellat	ei
flagellati	o
flagellatio	n
flagelli	f
flagellif	o
flagellifo	r
flagellifor	m
flagellu	m
flageo	l
flageol	e
flageole	t
flagg	eiy
flagge	dr
flagger	s
flaggi	n
flaggin	g
flagi	t
flagit	i
flagiti	o
flagitio	u
flagitiou	s
flagl	e
flagle	rst
flagles	s
flagm	a
flagma	n
flago	n
flagp	o
flagpo	l
flagpol	e
flagr	a
flagra	n
flagran	ct
flagranc	y
flagrant	ln
flagrantl	y
flagrantn	e
flagrantne	s
flagrantnes	s
flagrantness	e
flagrantnesse	s
flags	ht
flagsh	i
flagshi	p
flagst	ao
flagsta	f
flagstaf	f
flagsto	n
flagston	e
flai	lr
flail	eis
flaile	d
flaili	n
flailin	g
flair	s
flak	eisy
flake	dlrs
flakel	ei
flakele	s
flakeles	s
flakeli	k
flakelik	e
flaker	s
flaki	n
flakin	g
flam	bdeimy
flamb	eo
flambe	a
flambea	u
flambo	y
flamboy	a
flamboya	n
flamboyan	ct
flamboyanc	e
flamboyant	ls
flamboyantl	y
flamd	o
flamdo	o
flamdoo	d
flamdood	l
flamdoodl	e
flame	dlnoprst
flamel	ei
flamele	st
flameles	s
flameli	k
flamelik	e
flamen	c
flamenc	ao
flamenca	n
flamenco	s
flameo	u
flameou	t
flamep	r
flamepr	o
flamepro	o
flameproo	f
flamer	es
flamere	s
flameres	i
flameresi	s
flameresis	t
flameresist	a
flameresista	n
flameresistan	t
flames	h
flamesh	o
flamesho	t
flamet	h
flameth	r
flamethr	o
flamethro	w
flamethrow	e
flamethrowe	r
flami	n
flamin	gi
flaming	lo
flamingl	y
flamingo	es
flamingoe	s
flamini	c
flaminic	a
flaminica	l
flamm	a
flamma	b
flammab	il
flammabi	l
flammabil	i
flammabili	t
flammabilit	y
flammabl	e
flammable	s
flan	adegkns
flana	g
flanag	a
flanaga	n
fland	e
flande	r
flander	s
flane	s
flang	e
flange	d
flank	eis
flanke	dr
flanki	n
flankin	g
flann	e
flanne	l
flannel	eils
flannele	d
flanneli	n
flannelin	g
flannell	eiy
flannelle	d
flannelli	n
flannellin	g
flap	djlps
flapd	o
flapdo	o
flapdoo	d
flapdood	l
flapdoodl	e
flapj	a
flapja	c
flapjac	k
flapl	e
flaple	s
flaples	s
flapp	ei
flappe	d
flappi	n
flappin	g
flar	ei
flare	dls
flarel	e
flarele	s
flareles	s
flari	n
flarin	g
flas	hk
flash	bceilnosty
flashb	au
flashba	c
flashbac	k
flashback	s
flashbu	l
flashbul	b
flashc	u
flashcu	b
flashcub	e
flashe	drs
flasher	s
flashes	t
flashi	eln
flashie	rs
flashies	t
flashil	y
flashin	eg
flashine	s
flashines	s
flashiness	e
flashinesse	s
flashing	l
flashingl	y
flashl	eiy
flashle	s
flashles	s
flashli	g
flashlig	h
flashligh	t
flashlight	s
flashn	e
flashne	s
flashnes	s
flasho	v
flashov	e
flashove	r
flasht	u
flashtu	b
flashtub	e
flask	s
flat	bcfhilnpstuw
flatb	eo
flatbe	d
flatbo	a
flatboa	t
flatc	a
flatca	r
flatf	io
flatfi	s
flatfis	h
flatfish	e
flatfishe	s
flatfo	o
flatfoo	t
flath	e
flathe	a
flathea	d
flati	r
flatir	o
flatiro	n
flatl	ey
flatle	t
flatn	e
flatne	s
flatnes	s
flatness	e
flatnesse	s
flatp	a
flatpa	k
flatt	eio
flatte	dnrs
flatten	eis
flattene	dr
flattener	s
flatteni	n
flattenin	g
flatter	aeisy
flattera	b
flatterab	l
flatterabl	e
flattere	dr
flatterer	s
flatteri	en
flatterie	s
flatterin	g
flattering	l
flatteringl	y
flattes	t
flatti	ns
flattin	g
flattis	h
flatto	p
flatu	ls
flatul	e
flatule	n
flatulen	t
flatw	ao
flatwa	r
flatwar	e
flatwo	r
flatwor	km
flau	nt
flaun	t
flaunt	eis
flaunte	dr
flaunter	s
flaunti	en
flauntie	rs
flaunties	t
flauntin	g
flaunting	l
flauntingl	y
flaut	i
flauti	s
flautis	t
flautist	s
flav	eio
flave	s
flaves	c
flavesc	e
flavesce	n
flavescen	t
flavi	n
flavo	ru
flavor	eis
flavore	d
flavori	n
flavorin	g
flavoring	s
flavou	r
flavour	eilsy
flavoure	dr
flavouri	n
flavourin	g
flavouring	s
flavourl	e
flavourle	s
flavourles	s
flavourless	n
flavourlessn	e
flavourlessne	s
flavourlessnes	s
flaw	eilsy
flawe	d
flawi	en
flawie	rs
flawies	t
flawin	g
flawl	e
flawle	s
flawles	s
flawless	ln
flawlessl	y
flawlessn	e
flawlessne	s
flawlessnes	s
flawlessness	e
flawlessnesse	s
flax	es
flaxe	n
flaxs	e
flaxse	e
flaxsee	d
flb	fv
flbf	v
flc	l
flcl	a
flcla	s
flclas	h
fld	h
fle	abcdeimnostwx
flea	bmpsy
fleab	ai
fleaba	gn
fleaban	e
fleabi	t
fleabit	e
fleam	a
fleama	r
fleamar	k
fleamark	e
fleamarke	t
fleamarket	e
fleamarkete	r
fleap	i
fleapi	t
fleas	o
fleaso	m
fleasom	e
flec	hkt
flech	e
fleck	eilsy
flecke	d
flecki	en
fleckie	rs
fleckies	t
fleckin	g
fleckl	e
fleckle	s
fleckles	s
fleckless	l
flecklessl	y
flect	i
flecti	o
flectio	n
fled	eg
flede	r
fleder	m
flederm	a
flederma	u
fledermau	s
fledg	eil
fledge	dl
fledgel	i
fledgeli	n
fledgelin	g
fledgeling	s
fledgi	n
fledgin	g
fledgl	i
fledgli	n
fledglin	g
fledgling	s
flee	cirst
fleec	eiy
fleece	dlrs
fleecel	ei
fleecele	s
fleeceles	s
fleeceli	k
fleecelik	e
fleecer	s
fleeci	n
fleecin	eg
fleecine	s
fleecines	s
fleei	n
fleein	g
fleet	eilns
fleete	drs
fleetes	t
fleeti	n
fleetin	g
fleetl	y
fleetn	e
fleetne	s
fleetnes	s
fleetness	e
fleetnesse	s
flei	s
fleis	ch
fleisc	h
fleisch	m
fleischm	a
fleischma	n
fleish	e
fleishe	r
flem	i
flemi	ns
flemin	g
fleming	s
flemis	h
flemish	ei
flemishe	ds
flemishi	n
flemishin	g
flen	c
flenc	h
fles	h
flesh	ehilpy
fleshe	dnrs
fleshh	o
fleshho	o
fleshhoo	d
fleshi	n
fleshin	eg
fleshine	s
fleshines	s
fleshl	ey
fleshle	s
fleshles	s
fleshp	o
fleshpo	t
fleshpot	s
flet	c
fletc	h
fletch	e
fletche	r
fletcher	i
fletcheri	z
fletcheriz	e
fletcherize	s
flex	eiotu
flexe	drs
flexi	bnt
flexib	il
flexibi	l
flexibil	i
flexibili	t
flexibilit	iy
flexibiliti	e
flexibilitie	s
flexibl	ey
flexible	ns
flexiblen	e
flexiblene	s
flexiblenes	s
flexibleness	e
flexiblenesse	s
flexin	g
flexit	i
flexiti	m
flexitim	e
flexo	r
flext	i
flexti	m
flextim	e
flexu	r
flexur	ae
flexura	l
flf	brw
flfb	v
flh	foptvz
flhz	v
fli	bcegmnprtvx
flib	b
flibb	e
flibbe	r
flibber	t
flibbert	i
flibberti	g
flibbertig	i
flibbertigi	b
flibbertigib	b
flibbertigibb	e
flibbertigibbe	t
flic	k
flick	eirsy
flicke	dr
flicker	eisy
flickere	d
flickeri	n
flickerin	g
flickering	l
flickeringl	y
flicki	n
flickin	g
flie	drs
flier	s
flies	t
flig	h
fligh	t
flight	eilsy
flighte	d
flighti	ln
flightil	y
flightin	eg
flightine	s
flightines	s
flightl	e
flightle	s
flightles	s
flightless	n
flightlessn	e
flightlessne	s
flightlessnes	s
flim	fs
flimf	l
flimfl	a
flimfla	m
flims	iy
flimsi	eln
flimsie	rs
flimsies	t
flimsil	y
flimsin	e
flimsine	s
flimsines	s
flimsiness	e
flimsinesse	s
flin	cdgkt
flinc	h
flinch	ei
flinche	drs
flincher	s
flinchi	n
flinchin	g
flinching	l
flinchingl	y
flind	e
flinde	r
flinder	s
fling	eis
flinge	r
flinger	s
flingi	n
flingin	g
flint	eilsy
flinte	d
flinti	ln
flintil	y
flintin	eg
flintine	s
flintines	s
flintl	eio
flintle	s
flintles	s
flintli	k
flintlik	e
flintlo	c
flintloc	k
flip	fps
flipf	l
flipfl	o
flipflo	p
flipp	aeiy
flippa	n
flippan	ct
flippanc	y
flippe	drs
flipper	s
flippes	t
flippi	n
flippin	g
flir	t
flirt	aeisy
flirta	t
flirtat	i
flirtati	o
flirtatio	nu
flirtation	als
flirtationa	l
flirtationl	e
flirtationle	s
flirtationles	s
flirtatiou	s
flirtatious	ln
flirtatiousl	y
flirtatiousn	e
flirtatiousne	s
flirtatiousnes	s
flirtatiousness	e
flirtatiousnesse	s
flirte	dr
flirter	s
flirti	ens
flirtie	rs
flirties	t
flirtin	g
flirting	l
flirtingl	y
flirtis	h
flit	est
flitt	ei
flitte	dr
flitti	n
flittin	g
flitting	l
flittingl	y
fliv	v
flivv	e
flivve	r
flk	v
fll	v
fln	ort
flno	v
flo	aceghkmoprstuvwyz
floa	t
float	aeis
floata	bt
floatab	l
floatabl	e
floatat	i
floatati	v
floatativ	e
floate	dr
floati	n
floatin	g
floating	ls
floatingl	y
floc	ck
flocc	iou
flocco	s
floccos	e
floccu	ls
floccul	eiu
floccule	n
flocculen	c
flocculenc	e
flocculu	s
flock	eilsy
flocke	d
flocki	n
flockin	g
flockl	e
flockle	s
flockles	s
floe	s
flog	gs
flogg	aei
flogga	b
floggab	l
floggabl	e
flogge	dr
flogger	s
floggi	n
floggin	g
flom	o
floo	derz
flood	aegilmpswy
flooda	b
floodab	l
floodabl	e
floode	dr
flooder	s
floodg	a
floodga	t
floodgat	e
floodi	n
floodin	g
floodl	ei
floodle	s
floodles	s
floodli	gkt
floodlig	h
floodligh	t
floodlight	eis
floodlighte	d
floodlighti	n
floodlightin	g
floodlik	e
floodm	a
floodma	r
floodmar	k
floodp	l
floodpl	a
floodpla	i
floodplai	n
floodw	a
floodwa	ty
floodwat	e
floodwate	r
flooe	y
floor	abeilmpsw
floora	g
floorag	e
floorb	o
floorbo	a
floorboa	r
floorboar	d
floorboard	eis
floorboarde	d
floorboardi	n
floorboardin	g
floore	dr
floorer	s
floori	n
floorin	g
flooring	s
floorl	e
floorle	s
floorles	s
floorm	a
floorma	n
floorw	a
floorwa	l
floorwal	k
floorwalk	e
floorwalke	r
flooz	y
flop	ops
flopo	v
flopov	e
flopove	r
flopp	eiy
floppe	dr
flopper	s
floppi	eln
floppie	rs
floppies	t
floppil	y
floppin	eg
floppine	s
floppines	s
floppiness	e
floppinesse	s
floppy	d
floppyd	i
floppydi	s
floppydis	k
floppydisk	s
flor	aeiv
flora	els
floral	ls
florall	y
flore	nst
floren	ct
florenc	e
florent	i
florenti	n
florentin	e
flores	c
floresc	e
floresce	n
florescen	ct
florescenc	e
flori	dfns
florid	ai
floridi	a
floridia	n
floridian	s
florif	e
florife	r
florifer	o
florifero	u
floriferou	s
floris	t
florist	rs
floristr	i
floristri	e
floristrie	s
flos	sv
floss	eiy
flosse	ds
flossi	n
flossin	g
flot	ais
flota	gt
flotag	e
flotat	i
flotati	o
flotatio	n
flotation	s
floti	l
flotil	l
flotill	a
flots	a
flotsa	m
flou	nrt
floun	cd
flounc	e
flound	e
flounde	r
flounder	eis
floundere	dr
flounderi	n
flounderin	g
floundering	l
flounderingl	y
flour	eils
floure	d
flouri	ns
flourin	g
flouris	h
flourish	eimy
flourishe	drs
flourisher	s
flourishi	n
flourishin	g
flourishing	l
flourishingl	y
flourishm	e
flourishme	n
flourishmen	t
flourl	e
flourle	s
flourles	s
flout	eis
floute	dr
flouter	s
flouti	n
floutin	g
flouting	l
floutingl	y
flow	aceimnsu
flowa	bg
flowab	il
flowabi	l
flowabil	i
flowabili	t
flowabilit	iy
flowabiliti	e
flowabilitie	s
flowabl	e
flowag	e
flowc	h
flowch	a
flowcha	r
flowchar	t
flowchart	is
flowcharti	n
flowchartin	g
flowe	dr
flower	befilpsy
flowerb	e
flowerbe	d
flowere	drt
flowerer	s
flowerf	u
flowerfu	l
floweri	eln
flowerie	rs
floweries	t
floweril	y
flowerin	eg
flowerine	s
flowerines	s
floweriness	e
flowerinesse	s
flowerl	ei
flowerle	s
flowerles	s
flowerless	n
flowerlessn	e
flowerlessne	s
flowerlessnes	s
flowerli	k
flowerlik	e
flowerp	o
flowerpo	t
flowerpot	s
flowi	n
flowin	g
flowing	l
flowingl	y
flowm	e
flowme	t
flowmet	e
flowmete	r
flowu	s
floy	d
flp	uv
flq	rv
flr	bfruv
flu	bcefiklmnorstvx
flub	d
flubd	u
flubdu	b
fluc	t
fluct	u
fluctu	a
fluctua	nt
fluctuan	t
fluctuat	ei
fluctuate	ds
fluctuati	no
fluctuatin	g
fluctuatio	n
fluctuation	as
fluctuationa	l
flue	dlnsy
fluel	e
fluele	s
flueles	s
fluen	ct
fluenc	y
fluent	eilnu
fluente	rs
fluentes	t
fluenti	a
fluentia	l
fluentl	y
fluentn	e
fluentne	s
fluentnes	s
fluentness	e
fluentnesse	s
fluentu	i
fluf	f
fluff	eisy
fluffe	dr
fluffer	s
fluffi	eln
fluffie	rs
fluffies	t
fluffil	y
fluffin	eg
fluffine	s
fluffines	s
fluffiness	e
fluffinesse	s
flui	d
fluid	aeilnos
fluida	l
fluidal	l
fluidall	y
fluide	rs
fluides	t
fluidi	cft
fluidic	s
fluidif	y
fluidit	y
fluidl	iy
fluidli	k
fluidlik	e
fluidn	e
fluidne	s
fluidnes	s
fluidness	e
fluidnesse	s
fluido	u
fluidou	n
fluidoun	c
fluidounc	e
fluk	eiy
fluke	dls
flukel	e
flukele	s
flukeles	s
fluki	n
flukin	g
flum	emp
flumm	eo
flumme	r
flummer	y
flummo	x
flun	gk
flunk	ey
flunke	d
fluo	r
fluor	eio
fluore	rs
fluores	c
fluoresc	e
fluoresce	n
fluorescen	ct
fluorescenc	e
fluorescent	ls
fluorescentl	y
fluori	cdnt
fluorid	e
fluoride	s
fluorin	e
fluorine	s
fluorit	e
fluoro	ms
fluorom	e
fluorome	t
fluoromet	e
fluoromete	r
fluoros	c
fluorosc	o
fluorosco	p
fluoroscop	ey
flur	r
flurr	iy
flurri	e
flurrie	ds
flurried	l
flurriedl	y
flurry	i
flurryi	n
flurryin	g
flus	ht
flush	einy
flushe	drs
flusher	s
flushes	t
flushi	n
flushin	g
flushing	l
flushingl	y
flushn	e
flushne	s
flushnes	s
flushness	e
flushnesse	s
flust	e
fluste	r
fluster	eis
flustere	d
flustered	l
flusteredl	y
flusteri	n
flusterin	g
flut	eity
flute	dlnrs
flutel	i
fluteli	k
flutelik	e
fluten	i
fluteni	s
flutenis	t
fluter	s
fluti	ens
flutie	rs
fluties	t
flutin	g
flutis	t
flutt	e
flutte	r
flutter	aeilsy
fluttera	bt
flutterab	l
flutterabl	e
flutterat	i
flutterati	o
flutteratio	n
fluttere	dr
flutterer	s
flutteri	n
flutterin	g
fluttering	l
flutteringl	y
flutterl	e
flutterle	s
flutterles	s
fluv	i
fluvi	a
fluvia	l
fluvial	i
fluviali	s
fluvialis	t
flux	ei
fluxe	ds
fluxi	no
fluxin	g
fluxio	n
flx	v
fly	abceilmnopstw
flya	bw
flyab	il
flyabi	l
flyabil	i
flyabili	t
flyabilit	iy
flyabiliti	e
flyabilitie	s
flyabl	e
flyaw	a
flyawa	y
flyb	lo
flybl	o
flyblo	w
flyblow	n
flybo	a
flyboa	t
flyc	a
flyca	t
flycat	c
flycatc	h
flycatch	e
flycatche	r
flye	rs
flyer	s
flyes	t
flyi	n
flyin	g
flying	s
flyl	e
flyle	as
flylea	f
flyles	s
flym	ae
flyma	n
flyn	en
flyne	s
flynes	s
flyo	v
flyov	e
flyove	r
flyover	s
flyp	ay
flypa	p
flypap	e
flypape	r
flys	p
flysp	e
flyspe	c
flyspec	k
flyt	r
flytr	a
flytra	p
flyw	aeh
flywa	y
flywe	i
flywei	g
flyweig	h
flyweigh	t
flywh	e
flywhe	e
flywhee	l
flz	p
fm	bcefghijklmnopqtuwx
fmb	fv
fmc	s
fmcs	v
fme	e
fmf	v
fmi	it
fmj	s
fml	bft
fmlb	rv
fmm	fv
fmmv	v
fmn	fgo
fmw	rv
fn	abcdefghijlmnopqrsuvwy
fna	m
fnb	befioq
fnbf	v
fnbo	rv
fnc	dfilprsuv
fnd	chlsv
fne	deo
fnee	v
fnf	blrv
fng	hnrv
fni	dv
fnj	rsv
fnl	mv
fnm	d
fnn	dhvw
fno	blosv
fnp	d
fnr	fioqr
fnro	v
fns	k
fnsk	u
fnu	f
fnw	v
fo	abcdefgijlmnopqrstuvwxy
foa	lmv
foal	eis
foale	d
foali	n
foalin	g
foam	aeilsy
foama	b
foamab	l
foamabl	e
foame	dr
foamer	s
foami	ln
foamil	y
foamin	g
foaming	l
foamingl	y
foaml	ei
foamle	s
foamles	s
foamli	k
foamlik	e
fob	bfrsv
fobb	ei
fobbe	d
fobbi	n
fobbin	g
fobf	rv
foc	ailouv
foca	l
focal	il
focali	sz
focalis	ae
focalisa	t
focalisat	i
focalisati	o
focalisatio	n
focaliz	ae
focaliza	t
focalizat	i
focalizati	o
focalizatio	n
focall	y
focl	v
foco	m
focom	e
focome	t
focomet	e
focomete	r
focu	s
focus	aeils
focusa	b
focusab	l
focusabl	e
focuse	drs
focuser	s
focusi	n
focusin	g
focusl	e
focusle	s
focusles	s
focuss	ei
focusse	ds
focussi	n
focussin	g
fod	dhrv
fodd	e
fodde	r
fodder	eis
foddere	dr
fodderi	n
fodderin	g
foe	hmst
foeh	n
foem	a
foema	n
foet	au
foeta	l
foetu	s
foetus	e
foetuse	s
fof	u
fog	abghlsy
foga	r
fogar	t
fogart	y
fogb	ao
fogba	n
fogban	k
fogbo	w
fogg	eiy
fogge	d
foggi	eln
foggie	rs
foggies	t
foggil	y
foggin	eg
foggine	s
foggines	s
fogginess	e
fogginesse	s
fogh	o
fogho	r
foghor	n
fogl	e
fogy	i
fogyi	s
fogyis	hm
foi	bls
foib	l
foibl	e
foil	aeis
foila	b
foilab	l
foilabl	e
foile	dr
foili	ns
foilin	g
foilis	t
fois	t
foist	eis
foiste	d
foisti	n
foistin	g
foj	v
fol	defiklos
fold	aeilos
folda	bw
foldab	l
foldabl	e
foldaw	a
foldawa	y
folde	dr
folder	os
foldero	l
foldi	n
foldin	g
folding	s
foldl	e
foldle	s
foldles	s
foldo	u
foldou	t
fole	y
foli	ao
folia	cgrt
foliac	e
foliace	o
foliaceo	u
foliaceou	s
foliag	e
foliage	s
foliat	ei
foliati	o
foliatio	n
folio	eis
folioe	d
folioi	n
folioin	g
folk	elnstw
folke	rs
folkes	t
folkl	o
folklo	r
folklor	ei
folklore	s
folklori	cs
folkloris	t
folklorist	is
folkloristi	c
folkloristic	s
folkn	i
folkni	k
folks	oy
folkso	n
folkson	g
folkt	a
folkta	l
folktal	e
folkw	a
folkwa	y
foll	ioy
folli	ce
follic	lu
follicl	e
follicle	s
follicu	l
follicul	a
follicula	rt
folliculat	e
folliculate	d
follie	s
follo	w
follow	aeis
followa	b
followab	l
followabl	e
followe	dr
follower	s
followi	n
followin	g
following	s
fols	o
folso	m
fom	abeo
foma	l
fomal	h
fomalh	a
fomalha	u
fomalhau	t
fome	n
fomen	t
foment	a
fomenta	t
fomentat	i
fomentati	o
fomentatio	n
fon	dot
fond	aeilns
fonda	n
fondan	t
fonde	drs
fondes	t
fondi	ns
fondin	g
fondis	h
fondl	eiy
fondle	drs
fondler	s
fondli	n
fondlin	g
fondling	l
fondlingl	y
fondn	e
fondne	s
fondnes	s
font	afs
fonta	iln
fontai	n
fontain	e
fontaine	b
fontaineb	l
fontainebl	e
fontaineble	a
fontaineblea	u
fontan	a
fontf	u
fontfu	l
foo	dfijlorstuvwz
food	fils
foodf	u
foodfu	l
foodi	e
foodie	s
foodl	e
foodle	s
foodles	s
foodless	n
foodlessn	e
foodlessne	s
foodlessnes	s
foodlessness	e
foodlessnesse	s
foods	t
foodst	u
foodstu	f
foodstuf	f
foodstuff	s
foof	a
foofa	r
foofar	a
foofara	w
fooi	v
fooj	v
fool	ehips
foole	dr
fooler	y
foolh	a
foolha	r
foolhar	d
foolhard	iy
foolhardi	eln
foolhardie	rs
foolhardies	t
foolhardil	y
foolhardin	e
foolhardine	s
foolhardines	s
foolhardiness	e
foolhardinesse	s
fooli	ns
foolin	g
foolis	h
foolish	elmn
foolishe	rs
foolishes	t
foolishl	y
foolishm	e
foolishme	n
foolishmen	t
foolishn	e
foolishne	s
foolishnes	s
foolp	r
foolpr	o
foolpro	o
foolproo	f
fools	h
foolsh	i
foolshi	p
fooo	v
foot	abefghijlmnprswy
foota	g
footag	e
footage	s
footb	aor
footba	l
footbal	l
football	es
footballe	dr
footballer	s
footbo	ay
footboa	r
footboar	d
footbr	i
footbri	d
footbrid	g
footbridg	e
footbridge	s
foote	dr
footer	s
footf	a
footfa	l
footfal	l
footg	e
footge	a
footgea	r
footh	io
foothi	l
foothil	l
foothill	s
footho	l
foothol	d
foothold	s
footi	n
footin	g
footing	s
footj	o
footjo	b
footl	eio
footle	s
footles	s
footli	gk
footlig	h
footligh	t
footlik	e
footlo	co
footloc	k
footlock	e
footlocke	r
footloo	s
footloos	e
footm	a
footma	nr
footmar	k
footn	o
footno	t
footnot	ei
footnote	ds
footnoti	n
footnotin	g
footp	ar
footpa	dt
footpat	h
footpath	s
footpr	i
footpri	n
footprin	t
footprint	s
footr	aeo
footra	c
footrac	i
footraci	n
footracin	g
footre	s
footres	t
footro	p
footrop	e
foots	ilot
footsi	e
footsl	o
footslo	g
footso	r
footsor	e
footst	eo
footste	p
footstep	s
footsto	o
footstoo	l
footw	aeo
footwa	y
footwe	a
footwea	r
footwear	s
footwo	r
footwor	k
foou	rv
foow	v
fooz	l
foozl	e
fop	lopv
fopl	i
fopli	n
foplin	g
fopp	ei
foppe	r
fopper	y
foppi	s
foppis	h
foq	v
for	abcdefgiklmnrstuw
fora	gmy
forag	ei
forage	drs
forager	s
foragi	n
foragin	g
foram	ei
forame	n
forami	n
foramin	i
foramini	f
foraminif	e
foraminife	r
foraminifer	a
foray	s
forb	aei
forba	d
forbad	e
forbe	as
forbea	r
forbear	as
forbeara	n
forbearan	c
forbearanc	e
forbi	dt
forbid	ds
forbidd	aei
forbidda	l
forbidde	nr
forbidder	s
forbiddi	n
forbiddin	g
forbidding	ln
forbiddingl	y
forbiddingn	e
forbiddingne	s
forbiddingnes	s
forbiddingness	e
forbiddingnesse	s
forc	aei
forca	s
forcas	t
force	adfprst
forcea	b
forceab	l
forceabl	e
forced	l
forcedl	y
forcef	u
forcefu	l
forceful	ln
forcefull	y
forcefuln	e
forcefulne	s
forcefulnes	s
forcefulness	e
forcefulnesse	s
forcep	s
forceps	el
forcepse	s
forcepsl	i
forcepsli	k
forcepslik	e
forcer	s
forcet	o
forceto	u
forcetou	c
forcetouc	h
forci	bnp
forcib	il
forcibi	l
forcibil	i
forcibili	t
forcibilit	i
forcibiliti	e
forcibilitie	s
forcibl	ey
forcible	n
forciblen	e
forciblene	s
forciblenes	s
forcibleness	e
forciblenesse	s
forcin	g
forcing	l
forcingl	y
forcip	ei
forcipe	s
forcipi	a
forcipia	l
ford	aehiost
forda	b
fordab	l
fordabl	e
forde	d
fordh	a
fordha	m
fordi	n
fordin	g
fordt	r
fordtr	a
fordtra	n
fordtran	s
fordtrans	i
fordtransi	t
fore	abcdfghijklmnopqrstuvwxy
forea	cr
foreac	ht
forear	m
forearm	eis
forearme	d
forearmi	n
forearmin	g
foreb	eior
forebe	al
forebea	r
forebear	s
forebel	l
forebi	t
forebit	t
forebitt	e
forebitte	r
forebo	dw
forebod	ei
forebodi	n
forebodin	g
foreboding	lns
forebodingl	y
forebodingn	e
forebodingne	s
forebodingnes	s
forebodingness	e
forebodingnesse	s
forebr	ae
forebra	i
forebrai	n
forebre	a
forebrea	s
forebreas	t
forec	alo
foreca	blrs
forecab	i
forecabi	n
forecal	l
forecar	r
forecarr	i
forecarri	a
forecarria	g
forecarriag	e
forecas	t
forecast	aeils
forecasta	b
forecastab	l
forecastabl	e
forecaste	dr
forecaster	s
forecasti	n
forecastin	g
forecasting	l
forecastingl	y
forecastl	e
forecl	o
foreclo	s
foreclos	eu
foreclosu	r
foreclosur	e
foreclosure	s
foreco	nu
forecon	c
foreconc	e
foreconce	i
foreconcei	v
foreconceiv	e
forecou	r
forecour	t
forecourt	s
fored	aeo
foreda	wy
foredaw	n
forede	s
foredes	t
foredest	i
foredesti	n
foredestin	ey
foredo	o
foredoo	mr
foref	aior
forefa	t
forefat	h
forefath	e
forefathe	r
forefather	ls
forefatherl	y
forefi	egn
forefie	l
forefiel	d
forefig	h
forefigh	t
forefight	e
forefighte	r
forefin	g
forefing	e
forefinge	r
forefinger	s
forefo	o
forefoo	t
forefr	o
forefro	n
forefron	t
forefront	s
foreg	aioru
forega	imnt
foregai	n
foregain	s
foregains	t
foregam	e
foregan	g
foregang	e
foregange	r
foregat	e
foregi	f
foregif	t
forego	ein
foregoe	rs
foregoer	s
foregoi	n
foregoin	g
foregon	e
foregone	n
foregonen	e
foregonene	s
foregonenes	s
foregoneness	e
foregonenesse	s
foregr	o
foregro	u
foregrou	n
foregroun	d
foreground	eis
foregrounde	d
foregroundi	n
foregroundin	g
foregu	e
foregue	s
foregues	s
foreh	aeo
foreha	mn
foreham	m
forehamm	e
forehamme	r
forehan	d
forehand	es
forehande	dr
forehe	an
forehea	dr
forehead	els
foreheade	d
foreheadl	e
foreheadle	s
foreheadles	s
forehen	t
foreho	r
forehor	s
forehors	e
forei	gn
foreig	n
foreign	elns
foreigne	r
foreigner	s
foreignl	y
foreignn	e
foreignne	s
foreignnes	s
foreignness	e
foreignnesse	s
forein	t
foreint	e
foreinte	n
foreinten	d
forej	u
foreju	d
forejud	g
forejudg	e
forek	n
forekn	o
forekno	w
foreknow	l
foreknowl	e
foreknowle	d
foreknowled	g
foreknowledg	e
forel	aeio
forela	n
forelan	d
forele	gn
foreleg	s
forelen	d
foreli	efmv
forelif	t
forelim	b
foreliv	e
forelo	ac
foreloa	d
foreload	e
foreloade	r
foreloc	k
forem	aeo
forema	ns
foremas	t
foreme	an
foremea	n
foremen	t
forement	i
forementi	o
forementio	n
foremo	st
foremos	t
foremost	l
foremostl	y
foremot	h
foremoth	e
foremothe	r
foren	aos
forena	m
forenam	e
forename	ds
foreno	o
forenoo	n
forens	i
forensi	c
forensic	as
forensica	l
forensical	il
forensicali	t
forensicalit	iy
forensicaliti	e
forensicalitie	s
forensicall	y
foreo	ar
foreoa	t
foreoat	h
foreor	d
foreord	aei
foreorda	i
foreordai	n
foreorde	r
foreordi	n
foreordin	a
foreordina	t
foreordinat	i
foreordinati	o
foreordinatio	n
forep	aelu
forepa	rw
forepar	t
forepe	a
forepea	k
forepl	a
forepla	n
foreplan	e
forepu	r
forepur	p
forepurp	o
forepurpo	s
forepurpos	e
foreq	u
forequ	a
forequa	r
forequar	t
forequart	e
forequarte	r
forer	aiu
forera	n
foreran	k
foreri	bd
forerid	e
foreride	r
foreru	n
forerun	n
forerunn	e
forerunne	r
forerunner	s
fores	aehikltu
foresa	iw
foresai	l
forese	aei
foresea	t
foresee	ainrs
foreseea	b
foreseeab	il
foreseeabi	l
foreseeabil	i
foreseeabili	t
foreseeabilit	iy
foreseeabiliti	e
foreseeabilitie	s
foreseeabl	ey
foreseei	n
foreseein	g
foreseer	s
foresei	z
foreseiz	e
foresh	aeio
foresha	d
foreshad	o
foreshado	w
foreshadow	i
foreshadowi	n
foreshadowin	g
foreshe	e
foreshee	t
foreshi	n
foreshin	e
foresho	prw
foreshor	et
foreshore	s
foreshort	e
foreshorte	n
foresi	g
foresig	hn
foresigh	t
foresight	efls
foresighte	d
foresighted	ln
foresightedl	y
foresightedn	e
foresightedne	s
foresightednes	s
foresightedness	e
foresightednesse	s
foresightf	u
foresightfu	l
foresightl	e
foresightle	s
foresightles	s
foresign	i
foresigni	f
foresignif	y
foresk	i
foreski	nr
foreskin	s
foreskir	t
foresl	e
foresle	e
foreslee	v
foresleev	e
forest	aefilors
foresta	lty
forestal	lm
forestall	eims
forestalle	dr
forestaller	s
forestalli	n
forestallin	g
forestallm	e
forestallme	n
forestallmen	t
forestallment	s
forestalm	e
forestalme	n
forestalmen	t
forestalment	s
forestat	i
forestati	o
forestatio	n
forestation	s
foreste	dr
forester	s
forestf	u
forestfu	l
foresti	acn
forestia	l
forestic	k
forestin	g
forestl	ei
forestle	s
forestles	s
forestli	k
forestlik	e
foresto	n
foreston	e
forestr	ioy
forestri	e
forestrie	s
forestro	k
forestrok	e
foresu	f
foresuf	f
foresuff	e
foresuffe	r
foret	aehio
foreta	cs
foretac	k
foretas	t
foretast	e
forete	al
foretea	c
foreteac	h
foretel	l
foretell	is
foretelli	n
foretellin	g
foreth	o
foretho	u
forethou	g
forethoug	h
forethough	t
forethought	s
foreti	m
foretim	e
foreto	klp
foretok	e
foretoke	n
foretol	d
foreu	t
foreut	t
foreutt	e
foreutte	r
forev	e
foreve	r
forever	s
forew	aehor
forewa	r
forewar	n
forewarn	eis
forewarne	d
forewarni	n
forewarnin	g
forewarning	s
forewe	n
forewen	t
forewh	e
forewhe	e
forewhee	l
forewo	mr
forewom	a
forewoma	n
forewor	dl
foreword	s
foreworl	d
forewr	i
forewri	t
forewrit	e
forey	a
foreya	r
foreyar	d
forf	e
forfe	in
forfei	t
forfeit	aeisu
forfeita	b
forfeitab	l
forfeitabl	e
forfeite	dr
forfeiter	s
forfeiti	n
forfeitin	g
forfeitu	r
forfeitur	e
forfen	d
forg	aeio
forga	tv
forgat	h
forgath	e
forgathe	r
forgav	e
forge	adfrst
forgea	b
forgeab	i
forgeabi	l
forgeabil	i
forgeabili	t
forgeabilit	iy
forgeabiliti	e
forgeabilitie	s
forgef	u
forgefu	l
forger	eiy
forgere	r
forgeri	e
forgerie	s
forget	fnst
forgetf	u
forgetfu	l
forgetful	ln
forgetfull	y
forgetfuln	e
forgetfulne	s
forgetfulnes	s
forgetfulness	e
forgetfulnesse	s
forgetn	e
forgetne	s
forgetnes	s
forgett	aei
forgetta	b
forgettab	l
forgettabl	ey
forgette	r
forgetter	s
forgetti	n
forgettin	g
forgi	nv
forgin	g
forgiv	aei
forgiva	b
forgivab	l
forgivabl	ey
forgivable	n
forgivablen	e
forgivablene	s
forgivablenes	s
forgive	nrs
forgiven	e
forgivene	s
forgivenes	s
forgiver	s
forgivi	n
forgivin	g
forgiving	ln
forgivingl	y
forgivingn	e
forgivingne	s
forgivingnes	s
forgivingness	e
forgivingnesse	s
forgo	eint
forgoe	rs
forgoer	s
forgoi	n
forgoin	g
forgon	e
forgot	t
forgott	e
forgotte	n
fori	n
forin	t
fork	efilsy
forke	dr
forked	ln
forkedl	y
forkedn	e
forkedne	s
forkednes	s
forkedness	e
forkednesse	s
forker	s
forkf	u
forkfu	l
forkful	s
forki	n
forkin	g
forkl	ei
forkle	s
forkles	s
forkli	fk
forklif	t
forklik	e
forks	f
forksf	u
forksfu	l
forl	o
forlo	r
forlor	n
forlorn	eiln
forlorne	rs
forlornes	t
forlorni	t
forlornit	y
forlornl	y
forlornn	e
forlornne	s
forlornnes	s
forlornness	e
forlornnesse	s
form	aefilosu
forma	blnt
formab	il
formabi	l
formabil	i
formabili	t
formabilit	iy
formabiliti	e
formabilitie	s
formabl	ey
formal	dilns
formald	e
formalde	h
formaldeh	y
formaldehy	d
formaldehyd	e
formaldehyde	s
formali	nstz
formalis	emt
formalism	s
formalist	i
formalisti	c
formalit	iy
formaliti	e
formalitie	s
formaliz	aei
formaliza	t
formalizat	i
formalizati	o
formalizatio	n
formalization	s
formalize	ds
formalizi	n
formalizin	g
formall	y
formaln	e
formalne	s
formalnes	s
formalness	e
formalnesse	s
forman	t
formant	s
format	ist
formati	ov
formatio	n
formation	as
formationa	l
formational	l
formationall	y
formativ	e
formative	lns
formativel	y
formativen	e
formativene	s
formativenes	s
formativeness	e
formativenesse	s
formatt	ei
formatte	dr
formatter	s
formatti	n
formattin	g
forme	dr
former	ls
formerl	y
formf	ei
formfe	e
formfee	d
formfi	t
formfit	t
formfitt	i
formfitti	n
formfittin	g
formi	cdn
formic	a
formica	rs
formicar	y
formid	a
formida	b
formidab	il
formidabi	l
formidabil	i
formidabili	t
formidabilit	i
formidabiliti	e
formidabilitie	s
formidabl	ey
formidable	n
formidablen	e
formidablene	s
formidablenes	s
formidableness	e
formidablenesse	s
formin	g
forml	e
formle	s
formles	s
formo	s
formos	a
formosa	n
formu	l
formul	ai
formula	eirst
formulai	c
formulaic	a
formulaica	l
formulaical	l
formulaicall	y
formular	y
formulat	eio
formulate	ds
formulati	no
formulatin	g
formulatio	n
formulation	s
formulato	r
formulator	s
formuli	s
formulis	mt
forn	i
forni	c
fornic	a
fornica	t
fornicat	eio
fornicati	o
fornicatio	n
fornicato	r
forr	e
forre	s
forres	t
forrest	e
forreste	r
fors	aopwy
forsa	k
forsak	ei
forsake	nrs
forsaker	s
forsaki	n
forsakin	g
forso	o
forsoo	kt
forsoot	h
forsp	e
forspe	n
forspen	t
forsw	eo
forswe	a
forswea	r
forswo	r
forswor	n
forsy	t
forsyt	h
forsyth	ei
forsythi	a
fort	ehinrsuy
forte	s
fortes	c
fortesc	u
fortescu	e
forth	crw
forthc	o
forthco	m
forthcom	i
forthcomi	n
forthcomin	g
forthcoming	ns
forthcomingn	e
forthcomingne	s
forthcomingnes	s
forthcomingness	e
forthcomingnesse	s
forthr	i
forthri	g
forthrig	h
forthrigh	t
forthright	lns
forthrightl	y
forthrightn	e
forthrightne	s
forthrightnes	s
forthrightness	e
forthrightnesse	s
forthw	i
forthwi	t
forthwit	h
forti	efot
fortie	rst
forties	t
fortiet	h
fortieth	s
fortif	iy
fortifi	ce
fortific	a
fortifica	t
fortificat	i
fortificati	o
fortificatio	n
fortification	s
fortifie	drs
fortifier	s
fortify	i
fortifyi	n
fortifyin	g
fortifying	l
fortifyingl	y
fortio	r
fortior	i
fortit	u
fortitu	d
fortitud	e
fortn	i
fortni	g
fortnig	h
fortnigh	t
fortnight	ls
fortnightl	iy
fortnightli	e
fortnightlie	s
fortr	ae
fortra	n
fortre	s
fortres	s
fortress	el
fortresse	s
fortressl	i
fortressli	k
fortresslik	e
fortu	in
fortui	t
fortuit	o
fortuito	u
fortuitou	s
fortuitous	l
fortuitousl	y
fortun	aei
fortuna	t
fortunat	e
fortunate	lns
fortunatel	y
fortunaten	e
fortunatene	s
fortunatenes	s
fortunateness	e
fortunatenesse	s
fortune	ds
fortuni	n
fortunin	g
forty	f
fortyf	o
fortyfo	l
fortyfol	d
foru	m
forum	s
forw	ae
forwa	r
forwar	d
forward	aeilns
forwarda	b
forwardab	l
forwardabl	e
forwarde	drs
forwardes	t
forwardi	n
forwardin	g
forwardl	y
forwardn	e
forwardne	s
forwardnes	s
forwardness	e
forwardnesse	s
forwe	n
forwen	t
fos	st
foss	aei
fossi	l
fossil	adeilos
fossila	t
fossilat	ei
fossilati	o
fossilatio	n
fossild	o
fossildo	m
fossile	d
fossili	sz
fossilis	eit
fossilise	ds
fossilisi	n
fossilisin	g
fossiliz	aei
fossiliza	bt
fossilizab	l
fossilizabl	e
fossilizat	i
fossilizati	o
fossilizatio	n
fossilization	s
fossilize	ds
fossilizi	n
fossilizin	g
fossill	i
fossilli	k
fossillik	e
fossilo	g
fossilog	y
fost	e
foste	r
foster	aeis
fostera	bg
fosterab	l
fosterabl	e
fosterag	e
fostere	dr
fosterer	s
fosteri	n
fosterin	g
fostering	l
fosteringl	y
fou	aglnrvz
foua	frsvw
foug	h
fough	t
foul	aeilmns
foula	r
foular	d
foule	drs
foules	t
fouli	n
foulin	g
foull	y
foulm	o
foulmo	u
foulmou	t
foulmout	h
fouln	e
foulne	s
foulnes	s
foun	dt
found	aeilrs
founda	t
foundat	i
foundati	o
foundatio	n
foundation	aels
foundationa	lr
foundational	l
foundationall	y
foundationar	y
foundatione	r
foundationl	e
foundationle	s
foundationles	s
foundationless	n
foundationlessn	e
foundationlessne	s
foundationlessnes	s
founde	dr
founder	eis
foundere	d
founderi	n
founderin	g
founders	h
foundersh	i
foundershi	p
foundi	n
foundin	g
foundl	i
foundli	n
foundlin	g
foundr	eiy
foundre	s
foundres	s
foundri	e
foundrie	s
fount	as
founta	i
fountai	n
fountain	ehils
fountaine	de
fountainee	r
fountainh	e
fountainhe	a
fountainhea	d
fountaini	n
fountainin	g
fountainl	ei
fountainle	s
fountainles	s
fountainli	k
fountainlik	e
four	efipst
foure	rs
foures	t
fourf	lo
fourfl	u
fourflu	s
fourflus	h
fourflush	e
fourflushe	r
fourfo	l
fourfol	d
fouri	e
fourie	r
fourp	e
fourpe	n
fourpen	c
fourpenc	e
fours	coq
foursc	o
foursco	r
fourscor	et
fourscort	h
fourso	m
foursom	e
foursq	u
foursqu	a
foursqua	r
foursquar	e
fourt	eh
fourte	e
fourtee	n
fourteen	st
fourteent	h
fourteenth	s
fourth	els
fourthe	rs
fourthes	t
fourthl	y
fouz	frsvw
fov	e
fove	a
fow	l
fowl	eis
fowle	dr
fowler	s
fowli	n
fowlin	g
fox	ceghilmprstvy
foxc	o
foxco	n
foxcon	n
foxe	drs
foxer	y
foxg	l
foxgl	o
foxglo	v
foxglov	e
foxh	ao
foxha	l
foxhal	l
foxho	lu
foxhol	e
foxhou	n
foxhoun	d
foxi	n
foxin	eg
foxine	s
foxines	s
foxl	i
foxli	k
foxlik	e
foxm	a
foxma	i
foxmai	l
foxp	r
foxpr	o
foxs	h
foxsh	i
foxshi	p
foxt	ar
foxta	i
foxtai	l
foxtr	o
foxtro	t
foy	e
foye	r
foyer	s
fp	abdefgilmnoqrstuvwxz
fpa	v
fpb	b
fpd	koprt
fpdr	v
fpf	jrsvw
fpg	a
fpi	emv
fpm	h
fpn	delo
fpo	bhrv
fpq	g
fpt	v
fpx	v
fpz	w
fq	aefhijknortuw
fqe	r
fqf	y
fqi	v
fqj	qrsv
fqjq	v
fqn	v
fqo	v
fqr	bjq
fqrj	v
fqrq	v
fr	abcdefijklmnopqrsuvxy
fra	cdgimnpqrstuvxyz
frac	at
fraca	s
fract	iu
fracti	o
fractio	nu
fraction	aeis
fractiona	lr
fractional	il
fractionali	sz
fractionalis	e
fractionaliz	e
fractionall	y
fractionar	y
fractione	d
fractioni	n
fractionin	g
fractiou	s
fractu	r
fractur	aei
fractura	bl
fracturab	l
fracturabl	e
fracture	drs
fracturer	s
fracturi	n
fracturin	g
frag	imr
fragi	l
fragil	ei
fragile	ln
fragilel	y
fragilen	e
fragilene	s
fragilenes	s
fragileness	e
fragilenesse	s
fragili	t
fragilit	iy
fragiliti	e
fragilitie	s
fragm	e
fragme	n
fragmen	t
fragment	aeis
fragmenta	rt
fragmentar	y
fragmentat	i
fragmentati	o
fragmentatio	n
fragmente	d
fragmenti	nsz
fragmentin	g
fragmentis	a
fragmentisa	t
fragmentisat	i
fragmentisati	o
fragmentisatio	n
fragmentiz	a
fragmentiza	t
fragmentizat	i
fragmentizati	o
fragmentizatio	n
fragr	a
fragra	n
fragran	ct
fragranc	e
fragrance	ds
fragrant	ln
fragrantl	y
fragrantn	e
fragrantne	s
fragrantnes	s
fragrantness	e
fragrantnesse	s
frai	l
frail	elnst
fraile	rs
frailes	t
fraill	y
frailn	e
frailne	s
frailnes	s
frailness	e
frailnesse	s
frailt	iy
frailti	e
frailtie	s
fram	aei
frama	b
framab	l
framabl	e
framable	n
framablen	e
framablene	s
framablenes	s
framableness	e
framablenesse	s
frame	adlrsw
framea	b
frameab	l
frameabl	e
frameable	n
frameablen	e
frameablene	s
frameablenes	s
frameableness	e
frameablenesse	s
framel	e
framele	s
frameles	s
framer	s
framew	o
framewo	r
framewor	k
framework	s
frami	n
framin	g
fran	cgkntz
franc	aehios
franca	i
francai	s
francais	e
france	s
frances	c
francesc	ao
franch	i
franchi	s
franchis	aei
franchisa	bl
franchisab	il
franchisabi	l
franchisabil	i
franchisabili	t
franchisabilit	iy
franchisabiliti	e
franchisabilitie	s
franchisabl	e
franchise	dems
franchisem	e
franchiseme	n
franchisemen	t
franchisement	s
franchisi	n
franchisin	g
franci	ensuz
francin	e
francis	c
francisc	ao
francisca	n
franciscan	s
franciu	m
franciz	e
francize	s
franco	i
francoi	s
francois	e
frang	i
frangi	bp
frangib	il
frangibi	l
frangibil	i
frangibili	t
frangibilit	y
frangibl	e
frangip	a
frangipa	n
frangipan	i
frank	adefilns
franka	b
frankab	l
frankabl	e
frankd	e
frankde	l
frankdel	o
frankdelo	u
frankdelou	p
frankdeloup	e
franke	dlrs
franker	s
frankes	t
frankf	ou
frankfo	r
frankfor	t
frankfort	e
frankforte	r
frankforter	s
frankfu	r
frankfur	t
frankfurt	es
frankfurte	r
frankfurter	s
franki	ens
frankin	cg
frankinc	e
frankince	n
frankincen	s
frankincens	e
frankis	h
frankl	iy
frankli	n
franklin	i
franklini	z
frankliniz	a
frankliniza	t
franklinizat	i
franklinizati	o
franklinizatio	n
franklinization	s
frankn	e
frankne	s
franknes	s
frankness	e
franknesse	s
frann	y
frant	i
franti	c
frantic	an
frantica	l
frantical	l
franticall	y
franticn	e
franticne	s
franticnes	s
franticness	e
franticnesse	s
fras	e
frase	r
frat	er
frate	r
frater	n
fratern	ai
fraterna	l
fraternal	ils
fraternali	s
fraternalis	m
fraternalism	s
fraternall	y
fraterni	stz
fraternis	e
fraternit	iy
fraterniti	e
fraternitie	s
fraterniz	ae
fraterniza	t
fraternizat	i
fraternizati	o
fraternizatio	n
fratr	i
fratri	c
fratric	i
fratrici	d
fratricid	ae
fratricida	l
frau	dg
fraud	flsu
fraudf	u
fraudfu	l
fraudful	l
fraudfull	y
fraudl	e
fraudle	s
fraudles	s
fraudu	l
fraudul	e
fraudule	n
fraudulen	ct
fraudulenc	ei
fraudulenci	e
fraudulencie	s
fraudulent	ln
fraudulentl	y
fraudulentn	e
fraudulentne	s
fraudulentnes	s
fraudulentness	e
fraudulentnesse	s
fraug	h
fraugh	t
fraught	aeis
fraughta	g
fraughtag	e
fraughte	drs
fraughtes	t
fraughti	n
fraughtin	g
frax	i
fraxi	n
fraxin	e
fraxine	l
fraxinel	l
fraxinell	a
fray	eins
fraye	d
frayi	n
frayin	g
frayn	e
fraz	iz
frazi	e
frazie	r
frazz	l
frazzl	e
frb	bdv
frc	forv
frd	nv
fre	abcdeimnoqstuvy
frea	dk
freak	deis
freakd	o
freakdo	m
freake	drs
freakes	t
freaki	s
freakis	h
frec	k
freck	l
freckl	eiy
freckle	ds
freckli	en
frecklie	rs
frecklies	t
frecklin	g
fred	dehr
fredd	iy
freddi	e
frede	r
freder	i
frederi	c
frederic	kot
frederick	s
fredericks	b
fredericksb	u
fredericksbu	r
fredericksbur	g
frederict	o
fredericto	n
fredh	o
fredho	l
fredhol	m
fredr	i
fredri	c
fredric	k
fredrick	s
fredricks	o
fredrickso	n
free	bdefhilmnprstwz
freeb	eios
freebe	e
freebee	s
freebi	e
freebie	s
freebo	aor
freeboa	r
freeboar	d
freeboo	t
freeboot	e
freeboote	r
freebor	n
freebs	d
freed	mow
freedm	a
freedma	n
freedo	m
freedom	s
freedw	o
freedwo	m
freedwom	a
freedwoma	n
freee	n
freeen	t
freeent	e
freeente	r
freeenter	p
freeenterp	r
freeenterpr	i
freeenterpri	s
freeenterpris	i
freeenterprisi	n
freeenterprisin	g
freef	i
freefi	l
freefil	e
freefile	s
freefiles	y
freefilesy	n
freefilesyn	c
freeh	ao
freeha	n
freehan	d
freeho	l
freehol	d
freehold	es
freeholde	r
freeholder	s
freei	n
freein	g
freeing	s
freel	aioy
freela	n
freelan	c
freelanc	ei
freelance	ds
freelanci	n
freelancin	g
freeli	s
freelis	t
freelist	s
freelo	a
freeloa	d
freem	a
freema	ns
freemas	o
freemaso	n
freemason	irs
freemasoni	c
freemasonr	y
freen	e
freene	s
freenes	s
freeness	e
freenesse	s
freep	o
freepo	r
freepor	t
freer	s
frees	it
freesi	a
freest	y
freesty	l
freestyl	e
freet	eho
freete	l
freeth	i
freethi	n
freethin	k
freethink	ei
freethinke	r
freethinki	n
freethinkin	g
freeto	w
freetow	n
freew	ahi
freewa	ry
freewar	e
freeware	s
freeway	s
freewh	e
freewhe	e
freewhee	l
freewi	l
freewil	l
freez	aeiy
freeza	b
freezab	il
freezabi	l
freezabil	i
freezabili	t
freezabilit	iy
freezabiliti	e
freezabilitie	s
freezabl	e
freeze	rs
freezer	s
freezi	n
freezin	g
freezing	l
freezingl	y
frei	dg
freid	a
freig	h
freigh	t
freight	aeils
freighta	g
freightag	e
freighte	dr
freighter	s
freighti	n
freightin	g
freightl	e
freightle	s
freightles	s
frem	o
fremo	n
fremon	t
fren	cez
frenc	h
french	bhimwy
frenchb	r
frenchbr	e
frenchbre	a
frenchbrea	d
frenchh	o
frenchho	r
frenchhor	n
frenchhorn	s
frenchi	ez
frenchiz	e
frenchize	s
frenchm	ae
frenchma	n
frenchme	n
frenchw	io
frenchwi	n
frenchwin	d
frenchwind	o
frenchwindo	w
frenchwo	m
frenchwom	a
frenchwoma	n
frene	t
frenet	i
freneti	c
frenz	iy
frenzi	el
frenzie	ds
frenzil	y
frenzy	i
frenzyi	n
frenzyin	g
freo	n
freq	u
frequ	e
freque	n
frequen	ct
frequenc	iy
frequenci	e
frequencie	s
frequent	aeilns
frequenta	bt
frequentab	l
frequentabl	e
frequentat	i
frequentati	o
frequentatio	n
frequentation	s
frequente	drs
frequenter	s
frequentes	t
frequenti	n
frequentin	g
frequentl	y
frequentn	e
frequentne	s
frequentnes	s
frequentness	e
frequentnesse	s
fres	chn
fresc	o
fresco	e
frescoe	s
fresh	eilmnw
freshe	dnrs
freshen	eis
freshene	dr
freshener	s
fresheni	n
freshenin	g
fresher	s
freshes	t
freshi	ns
freshin	g
freshis	h
freshl	y
freshm	ae
freshma	n
freshman	s
freshmans	h
freshmansh	i
freshmanshi	p
freshmanship	s
freshme	n
freshn	e
freshne	s
freshnes	s
freshness	e
freshnesse	s
freshw	a
freshwa	t
freshwat	e
freshwate	r
freshwater	s
fresn	eo
fresne	l
fret	flstw
fretf	u
fretfu	l
fretful	ln
fretfull	y
fretfuln	e
fretfulne	s
fretfulnes	s
fretl	e
fretle	s
fretles	s
frets	a
fretsa	w
fretsaw	s
frett	ei
frette	dr
fretter	s
fretti	n
frettin	g
fretting	l
frettingl	y
fretw	io
fretwi	s
fretwis	e
fretwo	r
fretwor	k
fretwork	es
fretworke	d
freu	d
freud	i
freudi	a
freudia	n
freudian	is
freudiani	s
freudianis	m
freudianism	s
frey	a
frf	r
fri	abcdeglnpqstvz
fria	br
friab	il
friabi	l
friabil	i
friabili	t
friabilit	y
friabl	e
friar	s
frib	b
fribb	l
fribbl	e
fric	akt
frica	nst
frican	d
fricand	e
fricande	a
fricandea	u
fricas	s
fricass	e
fricasse	e
fricat	i
fricati	v
fricativ	e
fricative	s
frict	i
fricti	o
frictio	n
friction	ils
frictioni	z
frictioniz	e
frictionl	e
frictionle	s
frictionles	s
frictionless	l
frictionlessl	y
frid	ag
frida	y
friday	s
fridg	e
fridge	s
frie	dnsz
fried	emr
friede	rs
friedes	t
friedm	a
friedma	n
friedr	i
friedri	c
friedric	h
frien	d
friend	eils
friende	d
friendi	n
friendin	g
friendl	eiy
friendle	s
friendles	s
friendless	n
friendlessn	e
friendlessne	s
friendlessnes	s
friendlessness	e
friendlessnesse	s
friendli	eln
friendlie	rs
friendlies	t
friendlil	y
friendlin	e
friendline	s
friendlines	s
friendliness	e
friendlinesse	s
friends	h
friendsh	i
friendshi	p
friendship	s
fries	l
friesl	a
friesla	n
frieslan	d
friez	e
frieze	s
frig	aeghios
friga	t
frigat	e
frigate	s
frige	s
frigg	ai
friggi	n
friggin	g
frigh	t
fright	efisy
frighte	dn
frighten	aeis
frightena	b
frightenab	l
frightenabl	e
frightene	d
frightened	l
frightenedl	y
frighteni	n
frightenin	g
frightening	l
frighteningl	y
frightf	u
frightfu	l
frightful	ln
frightfull	ey
frightfulle	rs
frightfulles	t
frightfuln	e
frightfulne	s
frightfulnes	s
frightfulness	e
frightfulnesse	s
frighti	n
frightin	g
frigi	d
frigid	ailn
frigida	i
frigidai	r
frigidair	e
frigidi	t
frigidit	y
frigidl	y
frigidn	e
frigidne	s
frigidnes	s
frigidness	e
frigidnesse	s
frigo	r
frigor	i
frigori	f
frigorif	i
frigorifi	c
fril	l
frill	eis
frille	r
friller	sy
frilli	en
frillie	rs
frillies	t
frillin	g
frin	g
fring	eiy
fringe	dls
fringel	ei
fringele	s
fringeles	s
fringeli	k
fringelik	e
fringi	en
fringie	rs
fringies	t
fringin	g
frip	p
fripp	e
frippe	r
fripper	y
fris	bik
frisb	e
frisbe	e
frisi	a
frisia	n
frisk	eisy
friske	dr
frisker	s
friski	en
friskie	rs
friskies	t
friskin	eg
friskine	s
friskines	s
friskiness	e
friskinesse	s
frisking	l
friskingl	y
frit	hotz
fritt	ei
fritte	r
fritter	eis
frittere	dr
fritterer	s
fritteri	n
fritterin	g
fritti	n
frittin	g
friv	o
frivo	l
frivol	io
frivoli	t
frivolit	iy
frivoliti	e
frivolitie	s
frivolo	u
frivolou	s
frivolous	ln
frivolousl	y
frivolousn	e
frivolousne	s
frivolousnes	s
frivolousness	e
frivolousnesse	s
friz	z
frizz	ly
frizzl	e
frj	q
frl	v
frm	s
frn	abdefh
frnd	a
frnda	m
frndam	e
frndame	n
frndamen	t
frndament	a
frndamenta	l
fro	cghklmnrstuvwz
froc	k
frock	eils
frocke	d
frocki	n
frockin	g
frockl	e
frockle	s
frockles	s
frog	fglms
frogf	i
frogfi	s
frogfis	h
frogg	eiy
frogge	dr
frogger	y
froggi	s
froggis	h
frogl	i
frogli	kn
froglik	e
froglin	g
frogm	ae
frogma	n
frogme	n
frogs	p
frogsp	a
frogspa	w
frogspaw	n
frol	i
froli	c
frolic	s
frolics	o
frolicso	m
frolicsom	e
from	k
fromk	e
fromke	y
fromkey	s
fron	dt
frond	els
fronde	d
frondl	e
frondle	st
frondles	s
front	aegilsw
fronta	gl
frontag	e
frontage	rs
frontal	ils
frontali	t
frontalit	y
frontall	y
fronte	drs
frontes	t
frontg	a
frontga	t
frontgat	e
fronti	ens
frontie	r
frontier	eils
frontiere	s
frontieres	s
frontieri	s
frontieris	m
frontierl	ei
frontierle	s
frontierles	s
frontierli	k
frontierlik	e
frontiers	m
frontiersm	ae
frontiersma	n
frontiersme	n
frontin	g
frontis	p
frontisp	i
frontispi	e
frontispie	c
frontispiec	e
frontl	i
frontli	n
frontlin	e
frontw	ai
frontwa	ry
frontwar	d
frontward	s
frontway	s
frontwi	s
frontwis	e
fror	e
fros	ht
frost	befilswy
frostb	ei
frostbe	l
frostbel	t
frostbi	t
frostbit	et
frostbite	s
frostbitt	e
frostbitte	n
froste	d
frosted	s
frostf	i
frostfi	s
frostfis	h
frosti	aeln
frostia	n
frostie	rs
frosties	t
frostil	y
frostin	eg
frostine	s
frostines	s
frostiness	e
frostinesse	s
frosting	s
frostl	ei
frostle	s
frostles	s
frostli	k
frostlik	e
frostw	o
frostwo	r
frostwor	k
frot	h
froth	eisy
frothe	dr
frother	s
frothi	ln
frothil	y
frothin	g
frou	f
frouf	r
froufr	o
froufro	u
frow	ansz
frowa	r
frowar	d
frown	eils
frowne	dr
frowner	s
frowni	n
frownin	g
frowning	l
frowningl	y
frownl	e
frownle	s
frownles	s
frows	t
frowst	y
frowz	iy
frowzi	ln
frowzil	y
frowzin	e
frowzine	s
frowzines	s
froz	e
froze	n
frozen	ln
frozenl	y
frozenn	e
frozenne	s
frozennes	s
frozenness	e
frozennesse	s
frq	cu
frr	jq
frs	bst
frsb	v
frss	rv
frst	v
fru	cegimnsvy
fruc	t
fruct	io
fructi	f
fructif	y
fructo	s
fructos	e
fructose	s
frue	h
frueh	a
frueha	u
fruehau	f
frug	a
fruga	l
frugal	iln
frugali	t
frugalit	iy
frugaliti	e
frugalitie	s
frugall	y
frugaln	e
frugalne	s
frugalnes	s
frugalness	e
frugalnesse	s
frui	t
fruit	acefilsy
fruita	r
fruitar	i
fruitari	a
fruitaria	n
fruitc	a
fruitca	k
fruitcak	e
fruite	dr
fruiter	e
fruitere	r
fruitf	u
fruitfu	l
fruitful	ln
fruitfull	ey
fruitfulle	rs
fruitfulles	t
fruitfuln	e
fruitfulne	s
fruitfulnes	s
fruitfulness	e
fruitfulnesse	s
fruiti	no
fruitin	g
fruitio	n
fruition	s
fruitl	ei
fruitle	s
fruitles	s
fruitless	ln
fruitlessl	y
fruitlessn	e
fruitlessne	s
fruitlessnes	s
fruitlessness	e
fruitlessnesse	s
fruitli	k
fruitlik	e
frum	p
frump	i
frumpi	s
frumpis	h
frun	d
frund	l
frundl	e
frundle	s
frus	t
frust	ru
frustr	a
frustra	t
frustrat	eio
frustrate	drs
frustrated	l
frustratedl	y
frustrater	s
frustrati	nov
frustratin	g
frustratio	n
frustration	s
frustrativ	e
frustrato	r
frustrator	y
frustu	m
frv	fgr
frvf	v
frx	ho
fry	aeip
frya	b
fryab	l
fryabl	e
fryi	n
fryin	g
fryp	a
frypa	n
fs	abfilnopqrtuvz
fsa	v
fsf	s
fsi	s
fsl	v
fsn	f
fsnf	v
fso	su
fsp	ox
fsq	t
fst	bv
fsu	ahkmv
fsv	vw
fsz	ju
ft	aimnopstuvw
fta	v
fti	v
ftm	b
ftmb	v
ftn	bdrvw
ftp	rv
ftw	m
fu	abcdefgijklmnoqrstuvwxyz
fua	fpt
fub	apsz
fubs	y
fuc	ahkz
fuch	s
fuchs	i
fuchsi	a
fuck	eis
fucke	dr
fucker	s
fucki	nt
fuckin	g
fuckit	y
fud	dg
fudd	l
fuddl	e
fudg	eiy
fudge	ds
fudgi	n
fudgin	g
fue	lv
fuel	eils
fuele	dr
fueler	s
fueli	n
fuelin	g
fuell	ei
fuelle	drs
fueller	s
fuelles	s
fuelli	n
fuellin	g
fug	agiuz
fuga	cl
fugac	i
fugaci	ot
fugacio	u
fugaciou	s
fugacit	y
fugg	y
fugi	t
fugit	i
fugiti	v
fugitiv	ei
fugitive	lns
fugitivel	y
fugitiven	e
fugitivene	s
fugitivenes	s
fugitiveness	e
fugitivenesse	s
fugitivi	t
fugitivit	iy
fugitiviti	e
fugitivitie	s
fugu	e
fuj	i
fuji	fty
fujif	i
fujifi	l
fujifil	m
fujit	s
fujits	u
fujiy	a
fujiya	m
fujiyam	a
ful	bcfglmstv
fulb	r
fulbr	i
fulbri	g
fulbrig	h
fulbrigh	t
fulbright	s
fulc	r
fulcr	au
fulcra	l
fulcru	m
fulcrum	eis
fulcrume	d
fulcrumi	n
fulcrumin	g
fulf	i
fulfi	l
fulfil	lms
fulfill	eims
fulfille	d
fulfilli	n
fulfillin	g
fulfillm	e
fulfillme	n
fulfillmen	t
fulfillment	s
fulfilm	e
fulfilme	n
fulfilmen	t
fulg	eu
fulge	n
fulgen	t
fulgu	r
fulgur	a
fulgura	t
fulgurat	e
full	behinsy
fullb	a
fullba	c
fullbac	k
fulle	drs
fuller	t
fullert	o
fullerto	n
fulles	t
fullh	o
fullho	u
fullhou	s
fullhous	e
fulli	n
fullin	g
fulln	e
fullne	s
fullnes	s
fulm	i
fulmi	n
fulmin	ai
fulmina	nt
fulminan	t
fulminat	eio
fulminati	o
fulminatio	n
fulminato	r
fulminator	y
fulmini	c
fuls	o
fulso	m
fulsom	e
fult	o
fulto	n
fulv	o
fulvo	u
fulvou	s
fum	abeixyz
fuma	tv
fumat	o
fumato	r
fumator	y
fumb	l
fumbl	ei
fumble	drs
fumbler	s
fumbli	n
fumblin	g
fumbling	ln
fumblingl	y
fumblingn	e
fumblingne	s
fumblingnes	s
fumblingness	e
fumblingnesse	s
fume	dlrs
fumel	ei
fumele	s
fumeles	s
fumeli	k
fumelik	e
fumer	s
fumi	egnt
fumie	rs
fumies	t
fumig	a
fumiga	nt
fumigan	t
fumigat	eio
fumigate	ds
fumigati	no
fumigatin	g
fumigatio	n
fumigation	s
fumigato	r
fumigator	sy
fumin	g
fumit	o
fumito	r
fumitor	y
fumz	v
fun	acdefgikmnstz
funa	i
func	t
funct	io
functi	o
functio	n
function	aeils
functiona	lr
functional	ils
functionali	st
functionalis	m
functionalit	iy
functionaliti	e
functionalitie	s
functionall	y
functionar	y
functione	d
functioni	n
functionin	g
functionl	e
functionle	s
functionles	s
functo	r
functor	s
fund	aehirs
funda	bm
fundab	l
fundabl	e
fundam	e
fundame	n
fundamen	t
fundament	a
fundamenta	l
fundamental	ilns
fundamentali	st
fundamentalis	mt
fundamentalit	i
fundamentaliti	e
fundamentalitie	s
fundamentall	y
fundamentaln	e
fundamentalne	s
fundamentalnes	s
fundamentalness	e
fundamentalnesse	s
funde	dr
funder	s
fundh	o
fundho	l
fundhol	d
fundhold	e
fundholde	r
fundi	n
fundin	g
fundr	a
fundra	i
fundrai	s
fundrais	ei
fundraise	r
fundraisi	n
fundraisin	g
fune	r
funer	ae
funera	lr
funeral	s
funerar	y
funere	a
funerea	l
funf	a
funfa	i
funfai	r
funfair	s
fung	aiou
funga	l
fungi	bcf
fungib	l
fungibl	e
fungic	i
fungici	d
fungicid	ae
fungicida	l
fungicide	s
fungif	o
fungifo	r
fungifor	m
fungo	u
fungou	s
fungu	s
fungus	el
funguse	s
fungusl	i
fungusli	k
funguslik	e
funi	c
funic	u
funicu	l
funicul	a
funicula	r
funk	eisy
funke	dr
funker	s
funki	eln
funkie	rs
funkies	t
funkil	y
funkin	eg
funkine	s
funkines	s
funkiness	e
funkinesse	s
funky	ae
funkya	s
funkyas	s
funkye	rs
funkyes	t
funn	eiy
funne	dlrs
funnel	eils
funnele	d
funneli	n
funnelin	g
funnell	ei
funnelle	d
funnelli	kn
funnellik	e
funnellin	g
funnes	t
funni	eln
funnie	rs
funnies	t
funnil	y
funnin	eg
funnine	s
funnines	s
funniness	e
funninesse	s
funt	o
funto	u
funtou	c
funtouc	h
funtouch	o
funtoucho	s
fuo	w
fuq	anz
fur	abfiklmnoprstuvyz
fura	n
furb	i
furbi	s
furbis	h
furf	u
furfu	r
furi	eo
furie	s
furio	u
furiou	s
furious	eln
furiouse	r
furiousl	y
furiousn	e
furiousne	s
furiousnes	s
furiousness	e
furiousnesse	s
furk	i
furki	d
furl	eo
furle	s
furles	s
furlo	nu
furlon	g
furlou	g
furloug	h
furm	a
furma	n
furn	aei
furna	c
furnac	ei
furnace	dls
furnacel	i
furnaceli	k
furnacelik	e
furnaci	n
furnacin	g
furne	s
furnes	s
furni	st
furnis	h
furnish	eim
furnishe	drs
furnisher	s
furnishi	n
furnishin	g
furnishing	s
furnishm	e
furnishme	n
furnishmen	t
furnit	u
furnitu	r
furnitur	e
furniture	ls
furniturel	e
furniturele	s
furnitureles	s
furo	r
furr	eioy
furre	d
furri	eln
furrie	rs
furrier	y
furries	t
furril	y
furrin	eg
furrine	s
furrines	s
furriness	e
furrinesse	s
furro	w
furrow	eilsy
furrowe	dr
furrower	s
furrowi	n
furrowin	g
furrowl	ei
furrowle	s
furrowles	s
furrowli	k
furrowlik	e
furt	hi
furth	e
furthe	rs
further	aeims
furthera	n
furtheran	c
furtheranc	e
furthere	drs
furtherer	s
furtheres	t
furtheri	n
furtherin	g
furtherm	o
furthermo	rs
furthermor	e
furthermos	t
furthers	t
furthes	t
furti	v
furtiv	e
furtive	ln
furtivel	y
furtiven	e
furtivene	s
furtivenes	s
furtiveness	e
furtivenesse	s
furu	n
furun	c
furunc	l
furuncl	e
furz	ey
fus	ceiost
fusc	o
fusco	u
fuscou	s
fuse	dels
fusel	aei
fusela	g
fuselag	e
fuselage	s
fusele	s
fuseles	s
fuseli	k
fuselik	e
fusi	bflno
fusib	l
fusibl	e
fusif	o
fusifo	r
fusifor	m
fusil	l
fusill	a
fusilla	d
fusillad	e
fusin	g
fusio	n
fusion	s
fuss	abeipy
fussa	t
fussat	i
fussati	o
fussatio	n
fussb	u
fussbu	d
fussbud	g
fussbudg	e
fussbudge	t
fusse	drs
fusser	s
fussi	efln
fussie	rs
fussies	t
fussif	iy
fussifi	c
fussific	a
fussifica	t
fussificat	i
fussificati	o
fussificatio	n
fussil	y
fussin	eg
fussine	s
fussines	s
fussiness	e
fussinesse	s
fussp	o
fusspo	t
fust	iy
fusti	acgn
fustia	n
fustig	a
fustiga	t
fustigat	i
fustigati	o
fustigatio	n
fustin	e
fustine	s
fustines	s
fut	bhioru
futi	l
futil	ei
futile	ln
futilel	y
futilen	e
futilene	s
futilenes	s
futileness	e
futilenesse	s
futili	tz
futilit	y
futiliz	e
futo	n
futon	s
futu	nr
futun	a
futur	eio
future	lns
futurel	y
futuren	e
futurene	s
futurenes	s
futuri	sz
futuris	mt
futurist	i
futuristi	c
futuristic	a
futuristica	l
futuristical	l
futuristicall	y
futuriz	e
futuro	l
futurol	o
futurolo	g
futurolog	y
fuu	fuv
fuuf	v
fuw	u
fuz	z
fuzz	biy
fuzzb	a
fuzzba	l
fuzzbal	l
fuzzi	eln
fuzzie	rs
fuzzies	t
fuzzil	y
fuzzin	e
fuzzine	s
fuzzines	s
fuzziness	e
fuzzinesse	s
fv	abcdefjklmnoprstvwyz
fva	dptv
fvb	w
fvc	fs
fvd	abefghimnosuvwz
fvde	rsv
fvdf	v
fvdi	v
fve	rv
fvf	bv
fvj	n
fvk	buv
fvkb	v
fvl	emn
fvm	q
fvn	el
fvo	m
fvr	bv
fvs	u
fvt	bs
fvv	df
fvy	z
fvz	w
fw	adfjnoptvwx
fwa	v
fwn	v
fwo	sv
fwp	t
fwt	b
fww	k
fx	defijlnoruwxz
fxi	v
fxn	f
fxr	u
fxru	v
fxw	v
fxx	nv
fxz	u
fy	bdefijlmnopruwy
fyb	fgipw
fyd	o
fyf	bf
fyl	f
fylf	o
fylfo	t
fyn	ef
fyo	ko
fyp	adkuz
fyu	fv
fyuf	v
fyy	aprv
fz	acdlmnoqvz
fzc	mx
fzd	j
fzdj	v
fzl	v
fzm	r
fzo	v
fzq	fh
fzz	v
