g	abcdefghijklmnopqrstuvwxyz
ga	bcdefgijklmnopqrstuvwxyz
gab	abeflor
gaba	r
gabar	d
gabard	i
gabardi	n
gabardin	e
gabb	aeily
gabba	n
gabban	a
gabbe	r
gabbi	n
gabbin	g
gabbl	e
gabe	r
gaber	o
gabero	n
gaberon	e
gaberone	s
gabf	e
gabfe	s
gabfes	t
gabl	ei
gable	dlrs
gablel	i
gableli	k
gablelik	e
gabli	n
gablin	g
gabo	nr
gabor	o
gaboro	n
gaboron	e
gabr	i
gabri	e
gabrie	l
gabriel	l
gabriell	e
gad	abfgkorv
gada	br
gadab	o
gadabo	u
gadabou	t
gadar	e
gadare	n
gadaren	e
gadf	l
gadfl	y
gadg	e
gadge	t
gadget	aersy
gadgeta	r
gadgetar	y
gadgete	e
gadgetee	r
gadgeteer	s
gadgetr	iy
gadgetri	e
gadgetrie	s
gado	l
gadol	i
gadoli	n
gadolin	i
gadolini	u
gadoliniu	m
gae	l
gael	i
gaeli	c
gaelic	is
gaelici	z
gaeliciz	ae
gaeliciza	t
gaelicizat	i
gaelicizati	o
gaelicizatio	n
gaelicization	s
gaelicize	s
gaf	f
gaff	e
gaffe	r
gag	acegims
gage	drs
gager	s
gagg	eil
gagge	dr
gagger	s
gaggi	n
gaggin	g
gaggl	e
gagi	n
gagin	g
gagm	a
gagma	n
gags	t
gagst	e
gagste	r
gai	elntv
gaie	rst
gaies	t
gaiet	iy
gaieti	e
gaietie	s
gail	y
gain	aefils
gaina	b
gainab	l
gainabl	e
gaine	drs
gainer	s
gaines	v
gainesv	i
gainesvi	l
gainesvil	l
gainesvill	e
gainf	u
gainfu	l
gaini	n
gainin	g
gainl	y
gains	a
gainsa	y
gait	ehis
gaite	dr
gaiter	s
gaith	e
gaithe	r
gaither	s
gaithers	b
gaithersb	u
gaithersbu	r
gaithersbur	g
gaiti	n
gaitin	g
gak	km
gakk	i
gal	abegilostuvw
gala	chpstx
galac	t
galact	i
galacti	c
galah	a
galaha	d
galap	a
galapa	g
galapag	o
galapago	s
galat	ei
galate	a
galatea	n
galatean	s
galati	a
galatia	n
galatian	s
galax	iy
galaxi	e
galaxie	s
galb	r
galbr	e
galbre	a
galbrea	t
galbreat	h
gale	ns
galen	i
galeni	c
galg	a
galga	m
galgam	e
gali	lp
galil	e
galile	aeo
galilea	n
galip	o
galipo	t
gall	abefinosuy
galla	gn
gallag	h
gallagh	e
gallaghe	r
gallan	t
gallant	eilnrs
gallante	d
gallanti	n
gallantin	g
gallantl	y
gallantn	e
gallantne	s
gallantnes	s
gallantness	e
gallantnesse	s
gallantr	iy
gallantri	e
gallantrie	s
gallb	l
gallbl	a
gallbla	d
gallblad	d
gallbladd	e
gallbladde	r
galle	dry
galler	iy
galleri	e
gallerie	ds
gallery	il
galleryi	t
galleryit	e
galleryite	s
galleryl	ei
galleryle	s
galleryles	s
galleryli	k
gallerylik	e
galley	ls
galleyl	i
galleyli	k
galleylik	e
gallf	l
gallfl	y
galli	cmnuv
gallic	i
gallici	s
gallicis	m
gallim	a
gallima	u
gallimau	f
gallimauf	r
gallimaufr	y
gallin	giu
gallini	p
gallinip	p
gallinipp	e
gallinippe	r
gallinu	l
gallinul	e
galliu	m
galliv	a
galliva	n
gallivan	t
galln	u
gallnu	t
gallo	nopw
gallon	s
galloo	n
gallop	aeips
gallopa	d
gallopad	e
gallope	dr
galloper	s
gallopi	n
gallopin	g
gallopp	ei
galloppe	d
galloppi	n
galloppin	g
gallow	as
gallowa	y
gallows	e
gallowse	s
galls	t
gallst	o
gallsto	n
gallston	e
gallstone	s
gallu	ps
gallus	e
galluse	s
galo	iors
galoi	s
galoo	t
galor	e
galos	h
galosh	e
galoshe	s
galu	m
galum	p
galump	h
galv	aei
galva	n
galvan	io
galvani	csz
galvanis	eimt
galvanise	ds
galvanisi	n
galvanisin	g
galvaniz	aei
galvaniza	t
galvanizat	i
galvanizati	o
galvanizatio	n
galvanization	s
galvanize	drs
galvanizer	s
galvanizi	n
galvanizin	g
galvano	m
galvanom	e
galvanome	t
galvanomet	er
galvanomete	r
galvanometr	i
galvanometri	c
galve	s
galves	t
galvest	o
galvesto	n
galvi	n
galw	a
galwa	y
gam	beimuy
gamb	ailor
gamba	d
gambad	e
gambi	at
gambia	n
gambl	ei
gamble	drs
gambler	s
gambli	n
gamblin	g
gambo	l
gambr	e
gambre	l
game	bcdfklnprst
gameb	o
gamebo	y
gameboy	ac
gameboya	d
gameboyad	v
gameboyadv	a
gameboyadva	n
gameboyadvan	c
gameboyadvanc	e
gameboyc	o
gameboyco	l
gameboycol	o
gameboycolo	r
gamec	ou
gameco	c
gamecoc	k
gamecu	b
gamecub	e
gamef	ai
gamefa	q
gamefaq	s
gamek	e
gameke	e
gamekee	p
gamekeep	ei
gamekeepe	r
gamekeeper	s
gamekeepi	n
gamekeepin	g
gamekeeping	s
gamel	iy
gameli	k
gamelik	e
gamen	e
gamene	s
gamenes	s
gameness	e
gamenesse	s
gamep	l
gamepl	a
gamepla	y
gamer	s
games	mpt
gamesm	a
gamesma	n
gamesman	s
gamesmans	h
gamesmansh	i
gamesmanshi	p
gamesp	oy
gamespo	t
gamest	e
gameste	r
gamet	aeio
gameta	l
gamete	s
gameti	c
gametic	a
gametica	l
gametical	l
gameticall	y
gameto	p
gametop	h
gametoph	y
gametophy	t
gametophyt	e
gami	n
gamin	g
gamm	aeo
gamma	s
gamme	r
gammo	n
gammon	es
gammone	dr
gammoner	s
gamu	t
gan	degknotvy
gand	eh
gande	r
gander	eis
gandere	d
ganderi	n
ganderin	g
gandh	i
gandhi	a
gandhia	n
gane	f
gang	bdeilprsuw
gangb	au
gangba	n
gangban	g
gangbu	s
gangbus	t
gangbust	e
gangbuste	r
gangbuster	s
gangd	o
gangdo	m
gange	drs
gangi	n
gangin	g
gangl	ai
gangla	n
ganglan	d
gangland	s
gangli	kno
ganglik	e
ganglin	g
ganglio	n
gangp	l
gangpl	ao
gangpla	n
gangplan	k
gangplo	w
gangr	e
gangre	n
gangren	aeio
gangrena	t
gangrenat	e
gangrene	ds
gangreni	n
gangrenin	g
gangreno	u
gangrenou	s
gangs	t
gangst	e
gangste	r
gangster	dis
gangsterd	o
gangsterdo	m
gangsterdom	s
gangsteri	s
gangsteris	hm
gangsterism	s
gangu	e
gangw	a
gangwa	y
gangway	es
gangwaye	d
gann	e
ganne	t
gannet	t
gano	i
ganoi	d
gant	r
gantr	iy
gantri	e
gantrie	s
gany	m
ganym	e
ganyme	d
ganymed	e
gao	belr
gaol	e
gaole	r
gap	eilps
gape	dsw
gapew	o
gapewo	r
gapewor	m
gapi	n
gapin	g
gaping	ls
gapingl	y
gapl	e
gaple	s
gaples	s
gapp	i
gappi	e
gappie	rs
gappies	t
gaq	dgjnxy
gar	abcdefgilmnrtuvy
gara	g
garag	ei
garage	ads
garagea	b
garageab	l
garageabl	e
garagi	n
garagin	g
garb	aeils
garba	g
garbag	ei
garbage	ds
garbagi	n
garbagin	g
garbe	d
garbi	n
garbin	g
garbl	e
garble	ds
garbles	s
garc	i
garci	a
gard	en
garde	n
garden	aefils
gardena	bg
gardenab	l
gardenabl	e
gardenag	e
gardene	dr
gardener	s
gardenf	u
gardenfu	l
gardenful	s
gardeni	ans
gardenin	g
gardenis	t
gardenl	ei
gardenle	s
gardenles	s
gardenli	k
gardenlik	e
gardn	e
gardne	r
gare	fn
garef	o
garefo	w
garefow	l
garen	a
garf	iu
garfi	es
garfie	l
garfiel	d
garfis	h
garfu	n
garfun	k
garfunk	e
garfunke	l
garg	al
garga	n
gargan	t
gargant	u
gargantu	a
gargantua	n
gargl	ei
gargle	drs
gargler	s
gargli	n
garglin	g
gari	bs
garib	a
gariba	l
garibal	d
garibald	i
garis	h
garish	ln
garishl	y
garishn	e
garishne	s
garishnes	s
garishness	e
garishnesse	s
garl	ai
garla	n
garlan	d
garland	eils
garlande	d
garlandi	n
garlandin	g
garlandl	ei
garlandle	s
garlandles	s
garlandli	k
garlandlik	e
garli	c
garlic	ks
garlick	ey
garlicke	d
garm	ei
garme	n
garmen	t
garment	eils
garmente	d
garmenti	n
garmentin	g
garmentl	e
garmentle	s
garmentles	s
garmi	n
garn	ei
garne	rt
garner	e
garnere	d
garnet	t
garni	st
garnis	h
garnish	aeim
garnisha	b
garnishab	l
garnishabl	e
garnishe	ders
garnisher	s
garnishi	n
garnishin	g
garnishm	e
garnishme	n
garnishmen	t
garnit	u
garnitu	r
garnitur	e
garr	eiouy
garre	t
garret	et
garrete	e
garretee	r
garri	s
garris	o
garriso	n
garrison	eis
garrisone	d
garrisoni	an
garrisonia	n
garrisonin	g
garro	t
garrot	t
garrott	e
garru	l
garrul	io
garruli	t
garrulit	y
garrulo	u
garrulou	s
gart	ehn
garte	r
garter	s
gartn	e
gartne	r
garu	w
garuw	o
garuwo	o
garuwoo	d
garv	e
garve	y
gas	bcehiklopstw
gasb	a
gasba	g
gasc	o
gasco	n
gascon	y
gase	ios
gasei	t
gaseit	i
gaseiti	e
gaseitie	s
gaseo	u
gaseou	s
gaseous	ln
gaseousl	y
gaseousn	e
gaseousne	s
gaseousnes	s
gaseousness	e
gaseousnesse	s
gash	eio
gashe	drs
gashes	t
gashi	n
gashin	g
gasho	u
gashou	s
gashous	e
gasi	f
gasif	oy
gasifo	r
gasifor	m
gask	e
gaske	t
gasket	s
gasl	i
gasli	gt
gaslig	h
gasligh	t
gaso	hl
gasoh	o
gasoho	l
gasol	ei
gasole	n
gasolen	e
gasolene	s
gasoli	n
gasolin	ei
gasoline	ls
gasolinel	e
gasolinele	s
gasolineles	s
gasolini	c
gasp	eis
gaspe	der
gaspi	n
gaspin	g
gass	eiy
gasse	drst
gassi	n
gassin	eg
gassine	s
gassines	s
gassing	s
gast	ior
gasti	g
gastig	h
gastigh	t
gasto	n
gastr	iou
gastri	ct
gastrit	i
gastriti	cds
gastritid	e
gastritide	s
gastritis	e
gastritise	s
gastro	eilnp
gastroe	n
gastroen	t
gastroent	e
gastroente	r
gastroenter	io
gastroenteri	t
gastroenterit	i
gastroenteriti	s
gastroentero	l
gastroenterol	o
gastroenterolo	g
gastroenterolog	y
gastroi	n
gastroin	t
gastroint	e
gastrointe	s
gastrointes	t
gastrointest	i
gastrointesti	n
gastrointestin	a
gastrointestina	l
gastrol	o
gastrolo	g
gastrolog	iy
gastrologi	s
gastrologis	t
gastron	o
gastrono	m
gastronom	eiy
gastronomi	c
gastronomic	a
gastronomica	l
gastronomical	l
gastronomicall	y
gastrop	o
gastropo	d
gastropod	as
gastropoda	n
gastru	l
gastrul	a
gasw	o
gaswo	r
gaswor	k
gaswork	s
gat	ehilostw
gate	acdfklmpsw
gatea	u
gateau	x
gatec	r
gatecr	a
gatecra	s
gatecras	h
gatecrash	ei
gatecrashe	drs
gatecrashi	n
gatecrashin	g
gatef	o
gatefo	l
gatefol	d
gatek	e
gateke	e
gatekee	p
gatekeep	e
gatekeepe	r
gatel	ei
gatele	s
gateles	s
gateli	k
gatelik	e
gatem	a
gatema	n
gatep	o
gatepo	s
gatepos	t
gatepost	s
gatew	a
gatewa	y
gateway	s
gath	e
gathe	r
gather	aeis
gathera	b
gatherab	l
gatherabl	e
gathere	dr
gatherer	s
gatheri	n
gatherin	g
gathering	s
gati	n
gatin	g
gatl	i
gatli	n
gatlin	b
gatlinb	u
gatlinbu	r
gatlinbur	g
gato	r
gats	b
gatsb	y
gatw	i
gatwi	c
gatwic	k
gau	cdglnrstz
gauc	h
gauch	eo
gauche	lnrs
gauchel	y
gauchen	e
gauchene	s
gauchenes	s
gaucheness	e
gauchenesse	s
gaucher	i
gaucheri	e
gauches	t
gaud	iy
gaudi	eln
gaudie	rs
gaudies	t
gaudil	y
gaudin	e
gaudine	s
gaudines	s
gaudiness	e
gaudinesse	s
gaug	eiu
gauge	adrs
gaugea	b
gaugeab	l
gaugeabl	ey
gaugi	n
gaugin	g
gaugu	i
gaugui	n
gaul	ils
gauli	s
gaulis	h
gaull	e
gaun	t
gaunt	eln
gaunte	rs
gauntes	t
gauntl	eiy
gauntle	ty
gauntli	e
gauntlie	rs
gauntlies	t
gauntn	e
gauntne	s
gauntnes	s
gauntness	e
gauntnesse	s
gaur	v
gaus	s
gauss	i
gaussi	a
gaussia	n
gaut	ae
gauta	m
gautam	a
gaute	n
gauten	g
gauz	eiy
gauze	dls
gauzel	i
gauzeli	k
gauzelik	e
gauzi	ln
gauzil	y
gauzin	g
gav	ei
gave	l
gavel	k
gavelk	i
gavelki	n
gavelkin	d
gavi	an
gavia	l
gaw	akp
gawa	i
gawai	n
gawk	iy
gawki	s
gawkis	h
gawp	eis
gawpe	dr
gawper	s
gawpi	n
gawpin	g
gax	ux
gay	delnosv
gayd	o
gaydo	m
gaye	rst
gayes	t
gayet	y
gayl	oy
gaylo	r
gaylor	d
gayn	eo
gayne	s
gaynes	s
gayness	e
gaynesse	s
gayno	r
gaz	aeio
gaze	bdflmrst
gazeb	o
gazef	u
gazefu	l
gazel	el
gazele	s
gazeles	s
gazell	e
gazem	e
gazeme	n
gazemen	t
gazer	s
gazet	t
gazett	e
gazette	e
gazettee	r
gazi	n
gazin	g
gazing	l
gazingl	y
gazo	g
gazog	e
gazoge	n
gazogen	e
gb	abcdehijklnopqrstuvwxz
gbb	eo
gbd	v
gbe	fhrw
gbh	iov
gbi	flrstvw
gbk	diov
gbki	v
gbn	p
gbo	ar
gboa	r
gboar	d
gbp	ds
gbq	jp
gbqj	v
gbt	o
gbw	f
gbwf	v
gbx	u
gc	acdefgijlmnopqrstuvwy
gca	dqrv
gcad	v
gce	bcw
gceb	v
gcf	dkv
gci	v
gcj	o
gcl	ruv
gcm	rv
gcn	lmv
gcp	v
gcq	n
gcr	ors
gcs	erv
gct	hoy
gcty	v
gcu	as
gcv	z
gcw	cu
gcy	u
gd	bcdefgijmnoprtvxy
gdb	s
gdc	ars
gdcs	v
gdd	qr
gde	mz
gdf	uv
gdj	k
gdm	b
gdn	b
gdp	pr
gdpp	e
gdppe	r
gdpper	c
gdpperc	a
gdpperca	p
gdppercap	i
gdppercapi	t
gdppercapit	a
gdr	k
gdt	o
gdv	m
ge	abcdefghijklmnopqrstuvwxyz
gea	cderstvwyz
gead	rv
gear	beisy
gearb	o
gearbo	x
gearbox	e
gearboxe	s
geare	drs
geares	t
geari	n
gearin	g
gears	ht
gearsh	i
gearshi	f
gearshif	t
gearst	i
gearsti	c
gearstic	k
gec	k
geck	o
gecko	s
ged	eor
gee	cdikmprsvz
geei	n
geein	g
geek	bns
geekb	e
geekbe	n
geekben	c
geekbenc	h
geekn	o
geekno	t
geeknot	e
geep	v
gees	e
geev	v
geez	e
geeze	r
gef	fo
gefo	r
gefor	c
geforc	e
geg	uv
geh	er
gehe	n
gehen	n
gehenn	a
gehr	i
gehri	g
gei	gs
geig	ey
geige	r
geiger	c
geigerc	o
geigerco	u
geigercou	n
geigercoun	t
geigercount	e
geigercounte	r
geis	h
geish	a
gek	p
gel	adgils
gela	bt
gelab	l
gelabl	e
gelat	i
gelati	no
gelatin	eios
gelatine	s
gelatini	sz
gelatinis	e
gelatiniz	e
gelatino	u
gelatinou	s
gelatio	n
geli	dg
gelig	n
gelign	i
geligni	t
gelignit	e
gelignite	s
gell	ei
gelle	d
gelli	n
gellin	g
gem	ailmos
gema	r
gemar	a
gemi	n
gemin	ai
gemina	t
geminat	e
gemini	ads
geminia	n
geml	ei
gemle	s
gemles	s
gemli	k
gemlik	e
gemm	aeioy
gemme	d
gemmi	np
gemmin	g
gemmip	a
gemmipa	r
gemmipar	o
gemmiparo	u
gemmiparou	s
gemmo	l
gemmol	o
gemmolo	g
gemmolog	iy
gemmologi	c
gemmologic	a
gemmologica	l
gemo	l
gemol	o
gemolo	g
gemolog	iy
gemologi	c
gemologic	a
gemologica	l
gems	bt
gemsb	o
gemsbo	k
gemst	o
gemsto	n
gemston	e
gemstone	s
gen	bdeinoprstu
genb	a
genba	n
genban	k
gend	e
gende	r
gender	ils
genderi	n
genderin	g
genderl	e
genderle	s
genderles	s
gene	alrstv
genea	l
geneal	o
genealo	g
genealog	iy
genealogi	cs
genealogic	a
genealogica	l
genealogis	t
genel	i
geneli	k
genelik	e
gener	aio
genera	lt
general	ilns
generali	stz
generalis	aeist
generalisa	t
generalisat	i
generalisati	o
generalisatio	n
generalisation	s
generalise	ds
generalisi	n
generalisin	g
generaliss	i
generalissi	m
generalissim	o
generalist	s
generalit	iy
generaliti	e
generalitie	s
generaliz	aei
generaliza	bt
generalizab	i
generalizabi	l
generalizabil	i
generalizabili	t
generalizabilit	iy
generalizabiliti	e
generalizabilitie	s
generalizat	i
generalizati	o
generalizatio	n
generalization	s
generalize	drs
generalizer	s
generalizi	n
generalizin	g
generall	y
generaln	e
generalne	s
generalnes	s
generalness	e
generalnesse	s
generals	h
generalsh	i
generalshi	p
generat	eior
generate	ds
generati	nov
generatin	g
generatio	n
generation	aisx
generationa	l
generational	l
generationall	y
generationi	s
generationis	m
generativ	e
generato	r
generator	s
generatr	i
generatri	x
generi	c
generic	ains
generica	l
generical	ln
genericall	y
genericaln	e
genericalne	s
genericalnes	s
genericalness	e
genericalnesse	s
generici	z
genericiz	e
genericn	e
genericne	s
genericnes	s
genericness	e
genericnesse	s
genero	su
generos	i
generosi	t
generosit	iy
generositi	e
generositie	s
generou	s
generous	ln
generousl	y
generousn	e
generousne	s
generousnes	s
generousness	e
generousnesse	s
genes	cei
genesc	o
genese	s
genesi	ast
genesia	c
genesiac	a
genesiaca	l
genesis	e
genesise	s
genesit	i
genesiti	c
genet	i
geneti	c
genetic	ais
genetica	l
genetical	l
geneticall	y
genetici	s
geneticis	t
geneticist	s
genetics	e
geneticse	s
genev	ai
geneva	n
genevi	e
genevie	v
geneviev	e
geni	aetu
genia	l
genial	iln
geniali	t
genialit	iy
genialiti	e
genialitie	s
geniall	y
genialn	e
genialne	s
genialnes	s
genialness	e
genialnesse	s
genit	aio
genita	l
genital	is
genitali	a
geniti	v
genitiv	e
genitive	ls
genitivel	y
genito	u
genitou	r
genitour	i
genitouri	n
genitourin	a
genitourina	r
genitourinar	y
geniu	s
genius	e
geniuse	s
genn	e
genne	r
genner	i
genneri	c
genneric	n
gennericn	e
gennericne	s
gennericnes	s
geno	acemt
genoc	i
genoci	d
genocid	ae
genocida	l
genocide	s
genoe	s
genoes	e
genom	eis
genome	s
genomi	c
genomic	s
genot	y
genoty	p
genotyp	e
genr	e
genre	s
gens	p
gensp	a
genspa	r
genspar	k
gent	eilors
gente	elr
gentee	l
genteel	eiln
genteele	rs
genteeles	t
genteeli	s
genteelis	hm
genteell	y
genteeln	e
genteelne	s
genteelnes	s
genteelness	e
genteelnesse	s
genti	al
gentia	n
gentil	ei
gentili	t
gentilit	y
gentl	eiy
gentle	dmnrsw
gentlem	ae
gentlema	n
gentleman	hl
gentlemanh	o
gentlemanho	o
gentlemanhoo	d
gentlemanl	iy
gentlemanli	k
gentlemanlik	e
gentlemanlike	n
gentlemanliken	e
gentlemanlikene	s
gentlemanlikenes	s
gentlemanlikeness	e
gentlemanlikenesse	s
gentleme	n
gentlen	e
gentlene	s
gentlenes	s
gentles	t
gentlew	o
gentlewo	m
gentlewom	a
gentlewoma	n
gentli	n
gentlin	g
gento	o
gentr	y
genu	fis
genuf	l
genufl	e
genufle	c
genuflec	t
genuflect	i
genuflecti	o
genuflectio	n
genui	n
genuin	e
genuine	ln
genuinel	y
genuinen	e
genuinene	s
genuinenes	s
genuineness	e
genuinenesse	s
genus	e
genuse	s
geo	bcdfgilmprst
geob	o
geobo	t
geobot	a
geobota	n
geobotan	y
geoc	aeh
geoca	c
geocac	h
geocach	e
geocache	r
geoce	n
geocen	t
geocent	r
geocentr	i
geocentri	c
geoch	e
geoche	m
geochem	i
geochemi	cs
geochemic	a
geochemica	l
geochemis	t
geochemist	r
geochemistr	y
geod	eu
geode	st
geodes	iy
geodesi	c
geodet	i
geodeti	c
geodu	c
geoduc	k
geof	f
geoff	r
geoffr	e
geoffre	y
geog	r
geogr	a
geogra	p
geograp	h
geograph	eiy
geographe	r
geographer	s
geographi	ce
geographic	a
geographica	l
geographical	l
geographicall	y
geographie	s
geoi	p
geol	o
geolo	g
geolog	eiy
geologe	r
geologi	aces
geologia	n
geologic	a
geologica	l
geological	l
geologicall	y
geologie	s
geologis	t
geologist	s
geom	aeo
geoma	gn
geomag	n
geomagn	e
geomagne	t
geomagnet	i
geomagneti	cs
geomagnetis	m
geoman	ct
geomanc	y
geomant	i
geomanti	c
geome	mt
geomem	b
geomemb	r
geomembr	a
geomembra	n
geomembran	e
geomet	er
geomete	r
geometr	iy
geometri	ce
geometric	ais
geometrica	l
geometrical	l
geometricall	y
geometrici	a
geometricia	n
geometrie	s
geomo	r
geomor	p
geomorp	h
geomorph	o
geomorpho	l
geomorphol	o
geomorpholo	g
geomorpholog	y
geop	hlo
geoph	oy
geopho	n
geophon	e
geophy	s
geophys	i
geophysi	c
geophysic	ais
geophysica	l
geophysici	s
geophysicis	t
geopl	a
geopla	n
geoplan	a
geoplana	r
geoplanar	i
geoplanari	a
geoplanaria	n
geopo	l
geopol	i
geopoli	t
geopolit	i
geopoliti	c
geopolitic	s
geor	g
georg	ei
george	st
georget	o
georgeto	w
georgetow	n
georgi	ac
georgia	n
georgian	s
geos	cpty
geosc	i
geosci	e
geoscie	n
geoscien	c
geoscienc	e
geosp	a
geospa	c
geospac	e
geost	a
geosta	t
geostat	i
geostati	o
geostatio	n
geostation	a
geostationa	r
geostationar	y
geosy	n
geosyn	c
geosync	h
geosynch	r
geosynchr	o
geosynchro	n
geosynchron	o
geosynchrono	u
geosynchronou	s
geot	ehr
geote	cx
geotec	h
geotech	n
geotechn	o
geotechno	l
geotechnol	o
geotechnolo	g
geotechnolog	y
geotex	t
geotext	i
geotexti	l
geotextil	e
geoth	e
geothe	r
geother	m
geotherm	ai
geotherma	l
geothermal	l
geothermall	y
geothermi	c
geothermic	s
geotr	o
geotro	p
geotrop	i
geotropi	cs
geotropis	m
geq	ceu
ger	abhimoprstu
gera	lnr
geral	dt
gerald	i
geraldi	n
geraldin	e
geran	i
gerani	u
geraniu	m
gerar	d
gerb	ei
gerbe	r
gerber	a
gerbi	l
gerh	a
gerha	r
gerhar	d
gerhard	t
geri	a
geria	t
geriat	r
geriatr	i
geriatri	c
geriatric	s
germ	aefils
germa	n
german	eimosty
germani	acu
germaniu	m
germanm	e
germanme	a
germanmea	s
germanmeas	l
germanmeasl	e
germanmeasle	s
germano	p
germanop	h
germanoph	o
germanopho	b
germanophob	i
germanophobi	a
germans	h
germansh	e
germanshe	p
germanshep	h
germansheph	e
germanshephe	r
germanshepher	d
germanshepherd	s
germant	o
germanto	w
germantow	n
germe	nrs
germes	t
germf	r
germfr	e
germfre	e
germi	cn
germic	i
germici	d
germicid	ae
germicida	l
germin	a
germina	lnt
germinan	t
germinat	eio
germinate	ds
germinati	nov
germinatin	g
germinatio	n
germination	s
germinativ	e
germinato	r
germinator	s
germl	i
germli	k
germlik	e
gero	mn
gerom	e
geron	t
geront	o
geronto	cl
gerontoc	r
gerontocr	a
gerontocra	c
gerontocrac	y
gerontol	o
gerontolo	g
gerontolog	y
gerr	y
gerry	m
gerrym	a
gerryma	n
gerryman	d
gerrymand	e
gerrymande	r
gerrymander	eis
gerrymandere	dr
gerrymanderer	s
gerrymanderi	n
gerrymanderin	g
gers	h
gersh	w
gershw	i
gershwi	n
gershwin	s
gert	r
gertr	u
gertru	d
gertrud	e
geru	n
gerun	d
gerund	is
gerundi	a
gerundia	l
gerundial	l
gerundiall	y
ges	irstv
gess	o
gest	aiu
gesta	pt
gestap	o
gestat	ei
gestati	o
gestatio	n
gestation	as
gestationa	l
gesti	cm
gestic	u
gesticu	l
gesticul	a
gesticula	t
gesticulat	eio
gesticulate	ds
gesticulati	no
gesticulatin	g
gesticulating	l
gesticulatingl	y
gesticulatio	n
gesticulato	r
gesticulator	s
gestim	e
gestime	r
gestu	r
gestur	aei
gestura	l
gesture	dlrs
gesturel	e
gesturele	s
gestureles	s
gesturer	s
gesturi	n
gesturin	g
get	ahrst
geta	tw
getat	a
getata	b
getatab	l
getatabl	e
getaw	a
getawa	y
getaway	s
geth	s
geths	e
gethse	m
gethsem	a
gethsema	n
gethseman	e
gett	aeiy
getta	b
gettab	l
gettabl	e
gette	r
getter	s
getti	n
gettin	g
getty	s
gettys	b
gettysb	u
gettysbu	r
gettysbur	g
geu	m
gev	o
gew	fgu
gewf	v
gewg	a
gewga	w
gey	s
geys	e
geyse	r
geyser	aeis
geysera	l
geysere	d
geyseri	cn
geyserin	g
gez	fv
gf	befijklmnoprsuvwxy
gfb	u
gfe	k
gff	rstvy
gfi	dl
gfk	a
gfl	d
gfm	r
gfn	dh
gfo	o
gfr	ho
gfs	u
gfv	hz
gfw	l
gfwl	i
gfwli	s
gfwlis	t
gfy	gv
gg	befgijlnoqrtuxyz
gge	v
ggg	rv
ggi	uv
ggj	rvy
ggl	bv
ggn	fhor
ggo	rsv
ggt	v
ggx	rv
ggz	u
gh	aegikmnoprsuxz
gha	nsz
ghan	ai
ghani	a
ghania	n
ghas	t
ghast	il
ghasti	l
ghastil	y
ghastl	iy
ghastli	eln
ghastlie	rs
ghastlies	t
ghastlil	y
ghastlin	e
ghastline	s
ghastlines	s
ghastliness	e
ghastlinesse	s
ghaz	i
ghe	enrt
ghen	t
gher	k
gherk	i
gherki	n
gherkin	s
ghet	t
ghett	o
ghetto	eirs
ghettoe	ds
ghettoi	nsz
ghettoin	g
ghettois	e
ghettoiz	a
ghettoiza	t
ghettoizat	i
ghettoizati	o
ghettoizatio	n
ghettor	i
ghettori	z
ghettoriz	e
ghi	b
ghib	l
ghibl	i
ghm	b
gho	su
ghos	t
ghost	ehilnostw
ghoste	ds
ghostes	st
ghosth	o
ghostho	o
ghosthoo	d
ghosti	els
ghostie	rs
ghosties	t
ghostil	y
ghostis	h
ghostish	l
ghostishl	y
ghostl	eiy
ghostle	s
ghostles	s
ghostli	eln
ghostlie	rs
ghostlies	t
ghostlil	y
ghostlin	e
ghostline	s
ghostlines	s
ghostliness	e
ghostlinesse	s
ghostn	o
ghostno	t
ghostnot	e
ghosto	l
ghostol	o
ghostolo	g
ghostolog	y
ghosts	h
ghostsh	i
ghostshi	p
ghostt	iy
ghostti	l
ghosttil	e
ghostw	r
ghostwr	i
ghostwri	t
ghostwrit	e
ghostwrite	r
ghou	l
ghoul	i
ghouli	s
ghoulis	h
ghoulish	l
ghoulishl	y
gi	abdefgilmnopqrstuvwxz
gia	cno
giac	o
giaco	m
giacom	o
gian	t
giant	ehilrs
giante	rs
giantes	st
gianth	o
giantho	o
gianthoo	d
gianti	sz
giantis	hm
giantiz	e
giantl	y
giantr	y
giants	h
giantsh	i
giantshi	p
giao	u
giaou	r
gib	belrs
gibb	eosy
gibbe	rt
gibber	i
gibberi	s
gibberis	h
gibberish	e
gibberishe	s
gibbo	nsu
gibbon	eis
gibbone	s
gibbones	q
gibbonesq	u
gibbonesqu	e
gibboni	a
gibbonia	n
gibbos	i
gibbosi	t
gibbosit	y
gibbou	s
gibl	e
gible	t
giblet	s
gibr	a
gibra	l
gibral	t
gibralt	a
gibralta	r
gibs	o
gibso	n
gid	de
gidd	iy
giddi	eln
giddie	drs
giddies	t
giddil	y
giddin	eg
giddine	s
giddines	s
giddiness	e
giddinesse	s
gidding	s
giddy	i
giddyi	n
giddyin	g
gide	o
gideo	n
gif	bfst
gifb	r
gifbr	e
gifbre	w
gifbrew	e
gifbrewe	r
gifbrewer	y
giff	go
giffg	a
giffga	f
giffgaf	f
giffo	r
giffor	d
gift	eils
gifte	de
gifted	ln
giftedl	y
giftedn	e
giftedne	s
giftednes	s
giftedness	e
giftednesse	s
giftee	s
gifti	n
giftin	g
giftl	e
giftle	s
giftles	s
gig	agosu
giga	bchnvw
gigab	iy
gigabi	t
gigabit	s
gigaby	t
gigabyt	e
gigabyte	s
gigac	y
gigacy	c
gigacyc	l
gigacycl	e
gigah	e
gigahe	r
gigaher	t
gigahert	z
gigan	t
gigant	i
giganti	c
gigantic	an
gigantica	l
gigantical	l
giganticall	y
giganticn	e
giganticne	s
giganticnes	s
giganticness	e
giganticnesse	s
gigav	o
gigavo	l
gigavol	t
gigaw	a
gigawa	t
gigawat	t
gigg	eil
gigge	d
giggi	ns
giggin	g
giggis	h
giggl	ei
giggle	drs
giggler	s
giggli	en
gigglie	rs
gigglies	t
gigglin	eg
giggline	s
gigglines	s
giggling	l
gigglingl	y
gigo	h
gigoh	m
gil	bcdeklmt
gilb	e
gilbe	r
gilber	t
gilbert	s
gilberts	o
gilbertso	n
gilc	h
gilch	r
gilchr	i
gilchri	s
gilchris	t
gild	eis
gilde	d
gildi	n
gildin	g
gile	as
gilea	d
gilk	s
gilks	o
gilkso	n
gill	eils
gille	drst
giller	s
gilles	p
gillesp	i
gillespi	e
gillet	t
gillett	e
gilli	gn
gillig	a
gilliga	n
gillin	g
gilll	e
gillle	s
gillles	s
gilm	o
gilmo	r
gilmor	e
gilt	s
gim	bclmp
gimb	ae
gimba	l
gimbe	l
gimc	r
gimcr	a
gimcra	c
gimcrac	k
giml	e
gimle	t
gimm	ei
gimmi	c
gimmic	k
gimmick	eilsy
gimmicke	dr
gimmicker	s
gimmicki	n
gimmickin	g
gimmickl	e
gimmickle	s
gimmickles	s
gin	agknos
ging	ehi
ginge	r
ginger	beilsy
gingerb	r
gingerbr	e
gingerbre	a
gingerbrea	d
gingerbread	es
gingerbreade	d
gingere	d
gingeri	n
gingerin	g
gingerl	iy
gingerli	n
gingerlin	e
gingerline	s
gingerlines	s
gingerliness	e
gingerlinesse	s
gingers	n
gingersn	a
gingersna	p
gingh	a
gingha	m
gingham	s
gingi	v
gingiv	ai
gingiva	l
gingivi	t
gingivit	i
gingiviti	s
ginn	ei
ginne	dr
ginner	sy
ginni	en
ginnie	rs
ginnies	t
ginnin	g
gins	be
ginsb	eu
ginsbe	r
ginsber	g
ginsbu	r
ginsbur	g
ginse	n
ginsen	g
ginseng	s
gio	crv
gioc	o
gioco	n
giocon	d
giocond	a
gior	g
giorg	i
giorgi	os
giorgis	y
giorgisy	s
giorgisys	t
giorgisyst	e
giorgisyste	m
giov	a
giova	n
giovan	n
giovann	i
gip	ps
gipp	o
gips	eiy
gipse	i
gipsei	a
gipseia	n
gipsi	e
gipsie	rs
gipsies	t
gipsy	dehil
gipsyd	o
gipsydo	m
gipsydom	s
gipsye	s
gipsyes	q
gipsyesq	u
gipsyesqu	e
gipsyh	o
gipsyho	o
gipsyhoo	d
gipsyhood	s
gipsyi	s
gipsyis	m
gipsyism	s
gipsyl	i
gipsyli	k
gipsylik	e
giq	ik
gir	adlotu
gira	fn
giraf	f
giraff	eio
giraffe	s
giraffi	ds
giraffis	h
giraffo	i
giraffoi	d
giran	d
girand	o
girando	l
girandol	e
gird	el
girde	r
girder	ls
girderl	e
girderle	s
girderles	s
girdl	e
girdle	c
girdlec	a
girdleca	k
girdlecak	e
girl	defghis
girld	o
girldo	m
girle	e
girlee	n
girlf	r
girlfr	i
girlfri	e
girlfrie	n
girlfrien	d
girlfriend	s
girlg	u
girlgu	i
girlgui	d
girlguid	e
girlh	o
girlho	o
girlhoo	d
girlhood	s
girli	es
girlis	h
girlish	ln
girlishl	y
girlishn	e
girlishne	s
girlishnes	s
girlishness	e
girlishnesse	s
giro	ns
giron	d
girond	ei
girondi	s
girondis	t
girt	h
girth	eis
girthe	d
girthi	n
girthin	g
giru	v
gis	t
gist	s
git	abehilt
gita	d
gitad	d
gitb	ou
gitbo	o
gitboo	k
gitbu	ct
gitbuc	k
gitbuck	e
gitbucke	t
gitbut	l
gitbutl	e
gitbutle	r
gite	ae
gitee	p
giteep	a
giteepa	g
giteepag	e
giteepage	s
gith	u
githu	b
github	acp
githuba	c
githubac	t
githubact	i
githubacti	o
githubactio	n
githubaction	s
githubc	o
githubco	p
githubcop	i
githubcopi	l
githubcopil	o
githubcopilo	t
githubcopilot	cx
githubcopilotc	hl
githubcopilotch	a
githubcopilotcha	t
githubcopilotcl	i
githubp	a
githubpa	g
githubpag	e
githubpage	s
giti	gm
gitig	n
gitign	o
gitigno	r
gitignor	e
gitl	a
gitla	b
gitt	ei
gitte	r
gitter	n
gitti	n
giu	blsw
giul	i
giuli	a
giulia	n
giulian	o
gius	e
giuse	p
giusep	p
giusepp	e
giv	aei
giva	b
givab	l
givabl	e
givable	s
give	aenrst
givea	bw
giveab	l
giveabl	e
giveable	s
giveaw	a
giveawa	y
giveaway	s
givee	s
given	ns
givenn	e
givenne	s
givennes	s
giver	s
givet	h
givi	n
givin	g
giz	mz
gizm	o
gizz	a
gizza	r
gizzar	d
gizzard	s
gj	bcdejmnopqruvz
gjc	bips
gje	z
gjj	bstwy
gjm	b
gjn	grvy
gjo	glru
gjq	abs
gjqs	v
gjz	v
gk	abdefijlrw
gkb	l
gke	b
gkf	v
gki	v
gkj	v
gkl	brv
gkr	l
gl	abdehijlnopqrstuvwxy
gla	bcdimnrsuz
glab	r
glabr	o
glabro	u
glabrou	s
glac	i
glaci	aeo
glacia	lt
glacial	l
glaciall	y
glaciat	ei
glaciate	d
glaciati	o
glaciatio	n
glacie	r
glacier	eis
glaciere	d
glacieri	z
glacieriz	a
glacieriza	t
glacierizat	i
glacierizati	o
glacierizatio	n
glacio	l
glaciol	o
glaciolo	g
glaciolog	iy
glaciologi	s
glaciologis	t
glad	deilnsy
gladd	ei
gladde	dnrs
gladden	eis
gladdene	dr
gladdener	s
gladdeni	n
gladdenin	g
gladdes	t
gladdi	n
gladdin	g
glade	ls
gladel	i
gladeli	k
gladelik	e
gladi	aeo
gladia	t
gladiat	o
gladiato	r
gladiator	isy
gladiatori	as
gladiatoria	ln
gladiatoris	m
gladiators	h
gladiatorsh	i
gladiatorshi	p
gladie	rs
gladies	t
gladio	l
gladiol	u
gladiolu	s
gladl	eiy
gladle	s
gladles	s
gladli	e
gladlie	rs
gladlies	t
gladn	e
gladne	s
gladnes	s
gladness	e
gladnesse	s
glads	ot
gladso	m
gladsom	e
gladst	o
gladsto	n
gladston	e
glady	s
glai	rv
glaiv	e
glam	o
glamo	ru
glamor	ios
glamori	sz
glamoris	ei
glamorise	drs
glamorisi	n
glamorisin	g
glamoriz	aei
glamoriza	t
glamorizat	i
glamorizati	o
glamorizatio	n
glamorization	s
glamorize	drs
glamorizer	s
glamorizi	n
glamorizin	g
glamoro	u
glamorou	s
glamou	r
glamour	eils
glamoure	d
glamouri	nsz
glamourin	g
glamouris	ei
glamourise	ds
glamourisi	n
glamourisin	g
glamouriz	ei
glamourize	ds
glamourizi	n
glamourizin	g
glamourl	e
glamourle	s
glamourles	s
glan	cds
glanc	ei
glance	drs
glancer	s
glanci	n
glancin	g
glancing	s
gland	ilsu
glandi	f
glandif	o
glandifo	r
glandifor	m
glandl	ei
glandle	s
glandles	s
glandli	k
glandlik	e
glandu	l
glandul	a
glandula	r
glar	eiy
glare	dls
glarel	e
glarele	s
glareles	s
glari	n
glarin	g
glaring	ln
glaringl	y
glaringn	e
glaringne	s
glaringnes	s
glaringness	e
glaringnesse	s
glas	gsw
glasg	o
glasgo	w
glass	befhilmnwy
glassb	l
glassbl	o
glassblo	w
glassblow	e
glassblowe	r
glasse	drs
glasses	t
glassf	u
glassfu	l
glassful	s
glassh	o
glassho	u
glasshou	s
glasshous	e
glasshouse	s
glassi	eln
glassie	rs
glassies	t
glassil	y
glassin	eg
glassine	s
glassines	s
glassiness	e
glassinesse	s
glassl	i
glassli	k
glasslik	e
glassm	a
glassma	k
glassmak	ei
glassmake	r
glassmaki	n
glassmakin	g
glassn	o
glassno	d
glassnod	e
glassw	ao
glasswa	r
glasswar	e
glasswo	r
glasswor	kt
glasw	e
glaswe	g
glasweg	i
glaswegi	a
glaswegia	n
glau	cm
glauc	o
glauco	mu
glaucom	a
glaucoma	st
glaucomat	io
glaucomati	c
glaucomato	u
glaucomatou	s
glaucou	s
glaz	eiy
glaze	drs
glazer	s
glazi	en
glazie	r
glazier	is
glazieri	e
glazierie	s
glazin	eg
glazine	s
glazines	s
glaziness	e
glazinesse	s
glb	df
gld	hj
gle	abenqw
glea	mns
gleam	eilsy
gleame	d
gleami	en
gleamie	rs
gleamies	t
gleamin	g
gleaming	l
gleamingl	y
gleaml	e
gleamle	s
gleamles	s
glean	aeis
gleana	b
gleanab	l
gleanabl	e
gleane	dr
gleaner	s
gleani	n
gleanin	g
gleaning	s
gleas	o
gleaso	n
gleb	e
glee	fimst
gleef	u
gleefu	l
gleeful	l
gleefull	y
gleei	n
gleein	g
gleem	a
gleema	n
glen	dglnos
glend	a
glenda	l
glendal	e
gleng	a
glenga	r
glengar	r
glengarr	y
glenl	i
glenli	k
glenlik	e
gleno	i
glenoi	d
gleq	v
glh	t
gli	abdmnst
glia	l
glib	bln
glibb	e
glibbe	rs
glibbes	t
glibl	y
glibn	e
glibne	s
glibnes	s
glibness	e
glibnesse	s
glid	dei
glidd	e
glidde	n
glide	dlrs
glidel	e
glidele	s
glideles	s
glider	s
glidi	n
glidin	g
gliding	ls
glidingl	y
glim	mp
glimm	e
glimme	r
glimmer	eilsy
glimmere	d
glimmeri	n
glimmerin	g
glimmerl	e
glimmerle	s
glimmerles	s
glimp	s
glimps	ei
glimpse	drs
glimpser	s
glimpsi	n
glimpsin	g
glin	t
glint	eis
glinte	d
glinti	n
glintin	g
glis	st
gliss	a
glissa	dn
glissad	e
glissan	d
glissand	io
glissando	s
glist	e
gliste	n
glisten	eis
glistene	d
glisteni	n
glistenin	g
glistening	l
glisteningl	y
glit	ct
glitc	h
glitt	e
glitte	r
glitter	eilsy
glittere	dr
glitteri	n
glitterin	g
glittering	ls
glitteringl	y
glitterl	e
glitterle	s
glitterles	s
glj	k
gljk	v
gll	bv
gln	fnorstv
glnf	v
glo	abcekmorstuvwxz
gloa	mt
gloam	i
gloami	n
gloamin	g
gloat	eis
gloate	dr
gloater	s
gloati	n
gloatin	g
gloating	l
gloatingl	y
glob	aeiou
globa	lt
global	il
globali	sz
globalis	aeit
globalisa	t
globalisat	i
globalisati	o
globalisatio	n
globalise	ds
globalisi	n
globalisin	g
globaliz	aei
globaliza	t
globalizat	i
globalizati	o
globalizatio	n
globalize	drs
globalizi	n
globalizin	g
globall	y
globat	e
globe	dflst
globef	l
globefl	o
globeflo	w
globeflow	e
globeflowe	r
globel	i
globeli	k
globelik	e
globet	r
globetr	o
globetro	t
globetrot	t
globetrott	e
globetrotte	r
globi	n
globin	g
globo	s
globos	ei
globosi	t
globosit	y
globu	l
globul	aei
globula	r
globular	i
globulari	t
globularit	y
globule	s
globuli	n
gloc	k
glock	e
glocke	n
glocken	s
glockens	p
glockensp	i
glockenspi	e
glockenspie	l
glok	v
glom	e
glome	r
glomer	u
glomeru	l
glomerul	e
gloo	m
gloom	efilsy
gloome	d
gloomf	u
gloomfu	l
gloomful	l
gloomfull	y
gloomi	eln
gloomie	rs
gloomies	t
gloomil	y
gloomin	eg
gloomine	s
gloomines	s
gloominess	e
gloominesse	s
glooml	e
gloomle	s
gloomles	s
glor	iy
glori	aefo
gloria	n
glorian	a
glorie	ds
glorif	iy
glorifi	ace
glorifia	b
glorifiab	l
glorifiabl	e
glorific	a
glorifica	t
glorificat	i
glorificati	o
glorificatio	n
glorification	s
glorifie	drs
glorifier	s
glorify	i
glorifyi	n
glorifyin	g
glorio	u
gloriou	s
glorious	ln
gloriousl	y
gloriousn	e
gloriousne	s
gloriousnes	s
gloriousness	e
gloriousnesse	s
glory	hi
gloryh	o
gloryho	l
gloryhol	e
gloryi	n
gloryin	g
glorying	l
gloryingl	y
glos	s
gloss	aeiloy
glossa	lr
glossar	iy
glossari	ae
glossaria	l
glossarial	l
glossariall	y
glossarie	s
glosse	drs
glossi	elns
glossie	rs
glossies	t
glossil	y
glossin	eg
glossine	s
glossines	s
glossiness	e
glossinesse	s
glossing	l
glossingl	y
glossis	t
glossl	e
glossle	s
glossles	s
glosso	g
glossog	r
glossogr	a
glossogra	p
glossograp	h
glossograph	e
glossographe	r
glot	t
glott	ai
glotta	l
glotti	ds
glottid	e
glottide	as
glottidea	n
glottis	e
glottise	s
glou	c
glouc	e
glouce	s
glouces	t
gloucest	e
glouceste	r
gloucester	s
gloucesters	h
gloucestersh	i
gloucestershi	r
gloucestershir	e
glov	ei
glove	dlrs
glovel	ei
glovele	s
gloveles	s
gloveli	k
glovelik	e
glover	s
glovi	n
glovin	g
glow	eisw
glowe	dr
glower	eis
glowere	d
gloweri	n
glowerin	g
glowering	l
gloweringl	y
glowi	n
glowin	g
glowing	l
glowingl	y
gloww	o
glowwo	r
glowwor	m
glox	i
gloxi	n
gloxin	i
gloxini	a
gloz	e
glp	qs
glr	f
glt	stuvw
gltu	v
gltw	v
glu	ceimt
gluc	o
gluco	s
glucos	ei
glucose	s
glucosi	cdn
glucosid	e
glucosin	o
glucosino	l
glucosinol	a
glucosinola	t
glucosinolat	e
glue	dilprswy
gluei	n
gluein	g
gluel	i
glueli	k
gluelik	e
gluep	o
gluepo	t
gluer	s
gluew	a
gluewa	t
gluewat	e
gluewate	r
glui	elns
gluie	rs
gluies	t
gluil	y
gluin	g
gluis	h
glum	elmn
gluml	y
glumm	ey
glumme	rs
glummes	t
glumn	e
glumne	s
glumnes	s
glumness	e
glumnesse	s
glut	aeist
gluta	m
glutam	i
glutami	n
glutamin	e
glute	nu
gluten	os
gluteno	u
glutenou	s
gluteu	s
gluti	n
glutin	o
glutino	su
glutinos	i
glutinosi	t
glutinosit	y
glutinou	s
glutt	eio
glutte	d
glutti	n
gluttin	g
glutting	l
gluttingl	y
glutto	n
glutton	eiosy
gluttone	s
gluttones	s
gluttoni	es
gluttonie	s
gluttonis	h
gluttono	u
gluttonou	s
glv	d
glw	hv
gly	cnpy
glyc	eo
glyce	r
glycer	io
glyceri	n
glycerin	ae
glycerina	t
glycerinat	e
glycero	l
glyco	glps
glycog	e
glycoge	n
glycop	r
glycopr	o
glycopro	t
glycoprot	e
glycoprote	i
glycoprotei	n
glycos	iu
glycosi	d
glycosid	e
glycosu	r
glycosur	i
glycosuri	a
glyn	n
glyp	ht
glyph	io
glyphi	c
glypho	g
glyphog	r
glyphogr	a
glyphogra	p
glyphograp	h
glypt	i
glypti	c
glyptic	s
gm	abcefjnqrstuvx
gma	i
gmai	l
gmb	gh
gmc	s
gmcs	v
gmj	sv
gmn	v
gmr	uv
gmt	v
gn	abcdefghijklmnoprstuvwyz
gna	rstvw
gnar	l
gnarl	e
gnarle	d
gnas	h
gnash	ei
gnashe	drs
gnashi	n
gnashin	g
gnashing	l
gnashingl	y
gnat	hlst
gnath	i
gnathi	c
gnatl	i
gnatli	k
gnatlik	e
gnatt	iy
gnatti	e
gnattie	rs
gnatties	t
gnaw	aeis
gnawa	b
gnawab	l
gnawabl	e
gnawe	dr
gnawer	s
gnawi	n
gnawin	g
gnawing	s
gnb	dov
gnc	abprsv
gncs	v
gnd	luv
gne	eioqvz
gnee	v
gnei	s
gneis	s
gneiss	eoy
gneisse	s
gneisso	s
gneissos	i
gneissosi	t
gneissosit	y
gnf	frsvw
gng	cv
gngc	v
gnh	t
gni	iv
gnk	b
gnl	kp
gnm	bq
gnn	befrsv
gnne	v
gnnf	v
gno	dflmoprsuv
gnom	aeio
gnoma	e
gnome	ls
gnomel	i
gnomeli	k
gnomelik	e
gnomi	cs
gnomis	h
gnomo	n
gnos	t
gnost	i
gnosti	c
gnostic	i
gnostici	s
gnosticis	m
gnp	b
gnr	rsv
gns	bv
gnw	rsv
gny	o
go	abdefghijklmnopqrstuvwxyz
goa	dglrt
goad	eils
goade	d
goadi	n
goadin	g
goadl	i
goadli	k
goadlik	e
goag	e
goage	n
goagen	t
goagent	x
goal	eiklpsw
goale	d
goali	en
goalin	g
goalk	e
goalke	e
goalkee	p
goalkeep	ei
goalkeepe	r
goalkeeper	s
goalkeepi	n
goalkeepin	g
goalkeeping	s
goall	e
goalle	s
goalles	s
goalp	o
goalpo	s
goalpos	t
goalpost	s
goals	c
goalsc	o
goalsco	r
goalscor	i
goalscori	n
goalscorin	g
goalw	a
goalwa	r
goalwar	d
goalward	s
goat	ehls
goate	e
goatee	ds
goath	e
goathe	r
goather	d
goatl	i
goatli	k
goatlik	e
goats	k
goatsk	i
goatski	n
gob	bfilsy
gobb	el
gobbe	t
gobbl	ei
gobble	drs
gobbled	ey
gobblede	g
gobbledeg	o
gobbledego	o
gobbledegoo	k
gobbledy	g
gobbledyg	o
gobbledygo	o
gobbledygoo	k
gobbler	s
gobbli	n
gobblin	g
gobf	v
gobl	ei
goble	t
goblet	s
gobli	n
goblin	es
gobline	s
goblines	q
goblinesq	u
goblinesqu	e
gobs	m
gobsm	a
gobsma	c
gobsmac	k
gobsmack	ei
gobsmacke	d
gobsmacki	n
gobsmackin	g
god	acdfhklmnopswz
goda	d
godad	d
godadd	y
godc	h
godch	i
godchi	l
godchil	d
godchild	rs
godchildr	e
godchildre	n
godd	aei
godda	mru
goddam	n
goddamn	e
goddamne	d
goddar	d
goddau	g
goddaug	h
goddaugh	t
goddaught	e
goddaughte	r
godde	ds
goddes	s
goddess	ehls
goddesse	s
goddessh	o
goddessho	o
goddesshoo	d
goddesshood	s
goddessl	i
goddessli	k
goddesslik	e
goddesss	h
goddesssh	i
goddessshi	p
goddessship	s
goddi	nz
goddin	g
goddiz	e
godf	aor
godfa	t
godfat	h
godfath	e
godfathe	r
godfather	ehils
godfathere	d
godfatherh	o
godfatherho	o
godfatherhoo	d
godfatheri	n
godfatherin	g
godfatherl	y
godfathers	h
godfathersh	i
godfathershi	p
godfo	r
godfor	s
godfors	a
godforsa	k
godforsak	e
godforsake	n
godforsaken	ln
godforsakenl	y
godforsakenn	e
godforsakenne	s
godforsakennes	s
godfr	e
godfre	y
godh	eo
godhe	a
godhea	d
godho	o
godhoo	d
godk	i
godki	n
godl	eiy
godle	s
godles	s
godli	kn
godlik	e
godlin	e
godline	s
godlines	s
godm	o
godmo	t
godmot	h
godmoth	e
godmothe	r
godmother	s
godn	e
godne	s
godnes	s
godo	tw
godot	e
godote	n
godoten	g
godoteng	i
godotengi	n
godotengin	e
godow	n
godp	a
godpa	r
godpar	e
godpare	n
godparen	t
gods	ehmop
godse	n
godsen	d
godsend	s
godsh	i
godshi	p
godsm	a
godsma	c
godsmac	k
godso	n
godsp	e
godspe	e
godspee	d
godw	i
godwi	nt
godz	i
godzi	l
godzil	l
godzill	a
goe	dfhrstv
goed	v
goer	s
goet	h
goeth	e
gof	efru
gofe	r
gofer	s
goff	e
goffe	r
gofr	a
gofra	m
gofram	e
gog	fghnosv
gogg	l
goggl	e
goggle	s
gogh	rv
gogn	v
gogo	r
gogor	o
goh	v
goi	dn
goid	e
goide	l
goidel	i
goideli	c
goin	g
going	es
goinge	rs
goinges	t
goj	ov
gok	bd
gokb	v
gol	acdefgilrsuv
gola	n
golan	dg
golc	o
golco	n
golcon	d
golcond	a
gold	abefimsw
goldb	eru
goldbe	ar
goldbea	t
goldbeat	e
goldbeate	r
goldber	g
goldbr	i
goldbri	c
goldbric	k
goldbu	g
golde	nrsy
golden	delnrs
goldend	i
goldendi	c
goldendic	t
goldene	rs
goldenes	t
goldenl	y
goldenn	e
goldenne	s
goldennes	s
goldenness	e
goldennesse	s
goldenr	o
goldenro	d
goldes	t
goldey	e
goldf	i
goldfi	ens
goldfie	l
goldfiel	d
goldfin	c
goldfinc	h
goldfis	h
goldfish	e
goldfishe	s
goldi	ns
goldin	g
goldis	h
goldm	a
goldma	nr
goldmar	k
golds	mt
goldsm	i
goldsmi	t
goldsmit	h
goldst	ei
goldste	i
goldstei	n
goldsti	n
goldstin	e
goldw	a
goldwa	t
goldwat	e
goldwate	r
gole	t
golet	a
golf	eis
golfe	dr
golfer	s
golfi	n
golfin	g
golg	o
golgo	t
golgot	h
golgoth	a
goli	a
golia	t
goliat	h
goll	iy
golli	ew
gollie	s
golliw	o
golliwo	g
golu	p
golup	t
golupt	i
golupti	o
goluptio	u
goluptiou	s
gom	e
gome	z
gon	abdefginovyz
gona	d
gonad	o
gonado	t
gonadot	r
gonadotr	o
gonadotro	p
gonadotrop	i
gonadotropi	c
gonb	v
gond	ow
gondo	l
gondol	ai
gondoli	e
gondolie	r
gondw	a
gondwa	n
gondwan	a
gondwana	l
gondwanal	a
gondwanala	n
gondwanalan	d
gone	nr
gonen	e
gonene	s
gonenes	s
gonf	av
gonfa	l
gonfal	o
gonfalo	n
gong	cs
gongc	h
gongch	a
goni	mo
gonim	e
gonime	t
gonimet	e
gonimete	r
gonio	m
goniom	e
goniome	t
goniomet	e
goniomete	r
gonn	a
gono	cr
gonoc	o
gonoco	c
gonococ	c
gonococc	u
gonococcu	s
gonor	r
gonorr	h
gonorrh	eo
gonorrhe	a
gonorrho	e
gonorrhoe	a
gonz	a
gonza	l
gonzal	e
gonzale	sz
goo	bdefgijknpstv
goob	e
goobe	r
good	befilmnrswy
goodb	y
goodby	e
goodbye	s
goodf	r
goodfr	i
goodfri	d
goodfrid	a
goodfrida	y
goodi	ens
goodie	rs
goodies	t
goodin	e
goodine	s
goodines	s
goodis	h
goodl	ioy
goodli	n
goodlin	e
goodline	s
goodlines	s
goodlo	o
goodloo	k
goodlook	i
goodlooki	n
goodlookin	g
goodm	a
goodma	n
goodn	ae
goodna	t
goodnat	u
goodnatu	r
goodnatur	e
goodnature	d
goodne	s
goodnes	s
goodness	e
goodnesse	s
goodr	i
goodri	c
goodric	h
goods	e
goodse	l
goodsel	v
goodselv	e
goodselve	s
goodw	i
goodwi	fln
goodwif	e
goodwil	l
goodwill	es
goodwille	d
goody	e
goodye	a
goodyea	r
gooe	y
gooey	n
gooeyn	e
gooeyne	s
gooeynes	s
gooeyness	e
gooeynesse	s
goof	eisy
goofe	d
goofi	n
goofin	g
goog	l
googl	ey
google	abcdgkmoptvw
googlea	dnu
googlead	s
googleads	e
googleadse	n
googleadsen	s
googleadsens	e
googlean	a
googleana	l
googleanal	y
googleanaly	t
googleanalyt	i
googleanalyti	c
googleanalytic	s
googleau	t
googleaut	h
googleauth	e
googleauthe	n
googleauthen	t
googleauthent	i
googleauthenti	c
googleauthentic	a
googleauthentica	t
googleauthenticat	o
googleauthenticato	r
googleb	ao
googleba	r
googlebar	d
googlebo	t
googlec	ah
googleca	l
googlecal	e
googlecale	n
googlecalen	d
googlecalend	a
googlecalenda	r
googlech	r
googlechr	o
googlechro	m
googlechrom	e
googled	eor
googlede	e
googledee	p
googledeep	m
googledeepm	i
googledeepmi	n
googledeepmin	d
googledo	c
googledoc	s
googledr	i
googledri	v
googledriv	e
googleg	e
googlege	m
googlegem	i
googlegemi	n
googlegemin	i
googlek	e
googleke	e
googlekee	p
googlem	a
googlema	p
googlemap	s
googleo	n
googleon	e
googlep	hil
googleph	o
googlepho	t
googlephot	o
googlephoto	s
googlepi	x
googlepix	e
googlepixe	l
googlepl	a
googlepla	y
googleplay	m
googleplaym	u
googleplaymu	s
googleplaymus	i
googleplaymusi	c
googlet	v
googlev	o
googlevo	i
googlevoi	c
googlevoic	e
googlew	o
googlewo	r
googlewor	k
googlework	s
googleworks	p
googleworksp	a
googleworkspa	c
googleworkspac	e
gooi	el
gooie	rs
gooies	t
gooil	y
gooj	v
goos	ei
goose	bdfls
gooseb	e
goosebe	r
gooseber	r
gooseberr	iy
gooseberri	e
gooseberrie	s
goosef	l
goosefl	e
goosefle	s
goosefles	h
goosel	i
gooseli	k
gooselik	e
goosi	n
goosin	g
gop	fhr
goph	ev
gophe	r
gopr	o
gor	acdeghikmosty
gora	l
gorc	o
gorco	c
gorcoc	k
gord	io
gordi	a
gordia	n
gordo	n
gore	dnst
goret	e
gorete	x
gorg	eio
gorge	adorst
gorgea	b
gorgeab	l
gorgeabl	e
gorged	l
gorgedl	y
gorgeo	u
gorgeou	s
gorgeous	ln
gorgeousl	y
gorgeousn	e
gorgeousne	s
gorgeousnes	s
gorgeousness	e
gorgeousnesse	s
gorger	s
gorgi	n
gorgin	g
gorgo	n
gorgon	z
gorgonz	o
gorgonzo	l
gorgonzol	a
gorh	a
gorha	m
gori	eln
gorie	rs
gories	t
goril	ly
gorill	a
gorilla	lsz
gorillal	i
gorillali	k
gorillalik	e
gorin	eg
gorine	s
gorines	s
goriness	e
gorinesse	s
gork	y
gorm	al
gorma	n
gorman	d
gormand	i
gormandi	sz
gormandis	e
gormandise	r
gormandiz	e
gormandize	r
gorml	e
gormle	s
gormles	s
goro	u
gorou	t
gorout	i
gorouti	n
goroutin	e
goroutine	s
gors	ey
gort	o
gorto	n
gos	hlps
gosh	ae
gosha	w
goshaw	k
goshe	s
gosl	i
gosli	n
goslin	g
gosling	s
gosp	e
gospe	l
gospel	els
gospele	r
gospeler	s
gospell	y
goss	ai
gossa	m
gossam	e
gossame	r
gossi	p
gossip	dehimprsy
gossipd	o
gossipdo	m
gossipe	dr
gossiper	s
gossiph	o
gossipho	o
gossiphoo	d
gossipi	n
gossipin	g
gossiping	l
gossipingl	y
gossipm	o
gossipmo	n
gossipmon	g
gossipmong	e
gossipmonge	r
gossipp	ei
gossippe	dr
gossipper	s
gossippi	n
gossippin	g
gossipr	i
gossipri	e
gossiprie	s
got	bchlotv
gotc	h
gotch	a
goth	ai
gotha	m
gothi	c
gothic	ai
gothica	l
gothical	l
gothicall	y
gothici	sz
gothicis	m
gothiciz	ei
gothicize	drs
gothicizer	s
gothicizi	n
gothicizin	g
gotl	a
gotla	n
gotlan	d
gotland	e
gotlande	r
goto	s
gott	aef
gotte	n
gottf	r
gottfr	i
gottfri	e
gottfrie	d
gou	acdglnrt
goua	c
gouac	h
gouach	e
gouc	h
gouch	e
gouche	r
goud	a
goug	ei
gouge	drs
gouger	s
gougi	n
gougin	g
goul	ad
goula	s
goulas	h
goulash	e
goulashe	s
goun	d
gour	dm
gourd	els
gourdl	i
gourdli	k
gourdlik	e
gourm	ae
gourma	n
gourman	d
gourmand	is
gourmandi	sz
gourmandis	m
gourmandism	s
gourmandiz	ei
gourmandize	ds
gourmandizi	n
gourmandizin	g
gourme	t
gourmet	s
gout	isy
gouti	e
goutie	rs
gouties	t
gov	etv
gove	r
gover	n
govern	aeimos
governa	bn
governab	il
governabi	l
governabil	i
governabili	t
governabilit	iy
governabiliti	e
governabilitie	s
governabl	ey
governable	n
governablen	e
governablene	s
governablenes	s
governableness	e
governablenesse	s
governan	c
governanc	e
governe	ds
governes	s
governi	n
governin	g
governm	e
governme	n
governmen	t
government	as
governmenta	l
governmental	il
governmentali	z
governmentaliz	ei
governmentalize	ds
governmentalizi	n
governmentalizin	g
governmentall	y
governo	r
governor	as
governora	t
governorat	e
governorate	s
gow	aknv
gowa	n
gown	eis
gowne	d
gowni	n
gownin	g
gowns	m
gownsm	a
gownsma	n
gox	rsv
goz	v
gp	adefgijklmnopqrstuvwxyz
gpa	qz
gpd	fhknopr
gpf	dk
gpi	bo
gpl	ruv
gpm	hr
gpn	blmo
gpo	bt
gpob	v
gpq	gnu
gpr	oru
gps	r
gpt	hosy
gpty	v
gpu	bs
gpv	z
gpw	u
gpx	rsv
gpy	u
gpz	w
gq	abdefhjklmnostuw
gqa	v
gqb	bv
gqd	fghrv
gqdf	v
gqe	rv
gqf	dv
gqfd	v
gql	w
gqm	m
gqn	uv
gqw	d
gr	abcdefgijlmnopqrstuvwxy
gra	bcdfhimnpstvyz
grab	bs
grabb	aeiy
grabba	b
grabbab	l
grabbabl	e
grabbe	dr
grabber	s
grabbi	n
grabbin	g
grabbing	s
grac	eiky
grace	dfls
gracef	u
gracefu	l
graceful	ln
gracefull	ey
gracefulle	rs
gracefulles	t
gracefuln	e
gracefulne	s
gracefulnes	s
gracefulness	e
gracefulnesse	s
gracel	ei
gracele	s
graceles	s
graceless	ln
gracelessl	y
gracelessn	e
gracelessne	s
gracelessnes	s
gracelessness	e
gracelessnesse	s
graceli	k
gracelik	e
graci	elno
gracil	e
gracin	g
gracio	su
gracios	i
graciosi	t
graciosit	iy
graciositi	e
graciositie	s
graciou	s
gracious	ln
graciousl	y
graciousn	e
graciousne	s
graciousnes	s
graciousness	e
graciousnesse	s
grack	l
grackl	e
grad	aeilsuy
grada	t
gradat	ei
gradati	o
gradatio	n
gradation	as
gradationa	l
grade	dlrs
gradel	e
gradele	s
gradeles	s
grader	s
gradi	en
gradie	n
gradien	t
gradient	s
gradin	g
grading	s
gradl	e
gradu	as
gradua	lt
gradual	ilns
graduali	st
gradualis	m
gradualit	y
graduall	y
gradualn	e
gradualne	s
gradualnes	s
gradualness	e
gradualnesse	s
graduat	eio
graduate	ds
graduates	h
graduatesh	i
graduateshi	p
graduati	no
graduatin	g
graduatio	n
graduation	s
graduato	r
graduator	s
graf	aft
grafa	n
grafan	a
graff	il
graffi	t
graffit	io
graffl	e
graft	aeios
grafta	b
graftab	l
grafte	dr
grafter	s
grafti	n
graftin	g
grafto	n
grah	a
graha	m
graham	s
grai	ln
grain	efilsy
graine	dr
grainer	is
graineri	n
grainerin	g
grainf	i
grainfi	e
grainfie	l
grainfiel	d
graini	n
grainin	eg
grainine	s
grainines	s
grainl	e
grainle	s
grainles	s
gram	aemos
grame	r
gramer	c
gramerc	y
gramm	aey
gramma	lrt
grammal	o
grammalo	g
grammalog	u
grammalogu	e
grammar	ils
grammari	a
grammaria	n
grammarian	s
grammarl	e
grammarle	s
grammarles	s
grammat	i
grammati	c
grammatic	a
grammatica	l
grammatical	iln
grammaticali	t
grammaticalit	i
grammaticaliti	e
grammaticalitie	s
grammaticall	y
grammaticaln	e
grammaticalne	s
grammaticalnes	s
grammaticalness	e
grammaticalnesse	s
gramme	s
gramo	p
gramop	h
gramoph	o
gramopho	n
gramophon	e
gran	adginostuv
grana	dr
granad	a
granar	iy
granari	e
granarie	s
grand	acdefilmnpstu
granda	du
grandad	s
grandau	n
grandaun	t
grandc	h
grandch	i
grandchi	l
grandchil	d
grandchild	rs
grandchildr	e
grandchildre	n
grandd	au
grandda	du
granddau	g
granddaug	h
granddaugh	t
granddaught	e
granddaughte	r
granddu	c
grandduc	a
grandduca	l
grande	ersu
grandes	t
grandeu	r
grandeur	s
grandf	a
grandfa	t
grandfat	h
grandfath	e
grandfathe	r
grandfather	s
grandi	lo
grandil	o
grandilo	q
grandiloq	u
grandiloqu	e
grandiloque	n
grandiloquen	ct
grandiloquenc	e
grandio	s
grandios	ei
grandiose	ln
grandiosel	y
grandiosen	e
grandiosene	s
grandiosenes	s
grandioseness	e
grandiosenesse	s
grandiosi	t
grandiosit	iy
grandiositi	e
grandiositie	s
grandl	y
grandm	ao
grandma	s
grandmo	t
grandmot	h
grandmoth	e
grandmothe	r
grandmother	s
grandn	ei
grandne	ps
grandnep	h
grandneph	e
grandnephe	w
grandnes	s
grandness	e
grandnesse	s
grandni	e
grandnie	c
grandniec	e
grandp	alr
grandpa	rs
grandpar	e
grandpare	n
grandparen	t
grandparent	ahis
grandparenta	gl
grandparentag	e
grandparenth	o
grandparentho	o
grandparenthoo	d
grandparenthood	s
grandparenti	n
grandparentin	g
grandparenting	s
grandpl	a
grandpla	y
grandpr	i
grandpri	x
grands	iot
grandsi	r
grandsir	e
grandso	n
grandson	s
grandst	a
grandsta	n
grandstan	d
grandstand	eis
grandstande	dr
grandstander	s
grandstandi	n
grandstandin	g
grandt	ho
grandth	e
grandthe	f
grandthef	t
grandtheft	a
grandthefta	u
grandtheftau	t
grandtheftaut	o
grandtheftauto	v
grandto	t
grandtot	a
grandtota	l
grandu	n
grandun	c
grandunc	l
granduncl	e
grang	e
grange	r
grani	ft
granif	e
granife	r
granifer	o
granifero	u
graniferou	s
granit	ei
granite	lsw
granitel	i
graniteli	k
granitelik	e
granitew	a
granitewa	r
granitewar	e
graniti	c
grann	iy
granni	e
grannie	rs
grannies	t
grano	l
granol	a
grant	aeios
granta	b
grantab	l
grantabl	e
grante	der
granted	l
grantedl	y
granter	s
granti	n
grantin	g
granto	r
grantor	s
granu	l
granul	aeo
granula	rt
granular	il
granulari	t
granularit	iy
granulariti	e
granularitie	s
granularl	y
granulat	ei
granulate	ds
granulati	no
granulatin	g
granulatio	n
granule	s
granulo	s
granulos	e
granv	i
granvi	l
granvil	l
granvill	e
grap	ehinpy
grape	dflrsv
grapef	r
grapefr	u
grapefru	i
grapefrui	t
grapefruit	s
grapel	ei
grapele	t
grapeli	k
grapelik	e
graper	y
grapes	ht
grapesh	o
grapesho	t
grapest	o
grapesto	n
grapeston	e
grapev	i
grapevi	n
grapevin	e
graph	eioqs
graphe	dmn
graphem	e
graphen	e
graphi	cnt
graphic	ans
graphica	l
graphical	ln
graphicall	y
graphicaln	e
graphicalne	s
graphicalnes	s
graphicalness	e
graphicalnesse	s
graphicn	e
graphicne	s
graphicnes	s
graphicness	e
graphicnesse	s
graphin	g
graphit	ei
graphite	ds
graphiti	csz
graphitis	a
graphitisa	bt
graphitisab	l
graphitisabl	e
graphitisat	i
graphitisati	o
graphitisatio	n
graphitiz	a
graphitiza	bt
graphitizab	l
graphitizabl	e
graphitizat	i
graphitizati	o
graphitizatio	n
grapho	l
graphol	o
grapholo	g
grapholog	iy
graphologi	s
graphologis	t
graphq	l
grapi	n
grapin	g
grapn	e
grapne	l
grapp	l
grappl	ei
grapple	dmrs
grapplem	e
grappleme	n
grapplemen	t
grappler	s
grappli	n
grapplin	g
gras	ps
grasp	aeils
graspa	b
graspab	l
graspabl	e
graspe	dr
grasper	s
graspi	n
graspin	g
grasping	ln
graspingl	y
graspingn	e
graspingne	s
graspingnes	s
graspingness	e
graspingnesse	s
graspl	e
grasple	s
grasples	s
grass	cehilprwy
grassc	y
grasscy	c
grasscyc	l
grasscycl	e
grasse	drs
grasser	s
grassh	o
grassho	p
grasshop	p
grasshopp	e
grasshoppe	r
grasshopper	sy
grassi	en
grassie	rs
grassies	t
grassin	eg
grassine	s
grassines	s
grassiness	e
grassinesse	s
grassl	aei
grassla	n
grasslan	d
grassland	s
grassle	s
grassles	s
grassli	k
grasslik	e
grassp	l
grasspl	o
grassplo	t
grassr	o
grassro	o
grassroo	t
grassroot	s
grassw	a
grasswa	r
grasswar	d
grassward	s
grat	eiu
grate	dflrs
gratef	u
gratefu	l
grateful	ln
gratefull	ey
gratefulle	rs
gratefulles	t
gratefuln	e
gratefulne	s
gratefulnes	s
gratefulness	e
gratefulnesse	s
gratel	ei
gratele	s
grateles	s
grateli	k
gratelik	e
grater	s
grati	cfnst
gratic	u
graticu	l
graticul	e
gratif	iy
gratifi	ace
gratifia	b
gratifiab	l
gratifiabl	e
gratific	a
gratifica	t
gratificat	i
gratificati	o
gratificatio	n
gratifie	drs
gratified	l
gratifiedl	y
gratifier	s
gratify	i
gratifyi	n
gratifyin	g
gratin	g
grating	ls
gratingl	y
gratit	u
gratitu	d
gratitud	e
gratitude	s
gratu	il
gratui	t
gratuit	eioy
gratuiti	e
gratuitie	s
gratuito	u
gratuitou	s
gratuitous	ln
gratuitousl	y
gratuitousn	e
gratuitousne	s
gratuitousnes	s
gratuitousness	e
gratuitousnesse	s
gratul	a
gratula	t
gratulat	o
gratulato	r
gratulator	y
grav	aeiuy
grava	mt
gravam	e
gravame	n
gravat	a
gravata	r
grave	dlnrswy
gravel	eilsy
gravele	d
graveli	kns
gravelik	e
gravelin	g
gravelis	h
gravell	eiy
gravelle	r
gravelli	n
gravellin	g
graven	e
gravene	s
gravenes	s
graveness	e
gravenesse	s
graves	t
gravest	o
gravesto	n
graveston	e
gravestone	s
gravew	a
gravewa	r
gravewar	d
graveward	s
gravey	a
graveya	r
graveyar	d
graveyard	s
gravi	demnt
gravid	i
gravidi	t
gravidit	y
gravie	s
gravim	e
gravime	t
gravimet	e
gravimete	r
gravin	g
gravit	aiy
gravita	st
gravitat	ei
gravitate	drs
gravitater	s
gravitati	no
gravitatin	g
gravitatio	n
gravitation	a
gravitationa	l
graviti	e
gravitie	s
gravu	r
gravur	e
gray	beilnsw
grayb	e
graybe	a
graybea	r
graybear	d
graye	drs
grayes	t
grayi	ns
grayin	g
grayis	h
grayl	iy
grayli	n
graylin	g
grayn	e
grayne	s
graynes	s
grayness	e
graynesse	s
grays	o
grayso	n
grayw	a
graywa	c
graywac	k
graywack	e
graz	aei
graza	b
grazab	l
grazabl	e
graze	adrs
grazea	b
grazeab	l
grazeabl	e
grazer	s
grazi	en
grazie	r
grazin	g
grazing	l
grazingl	y
grb	bv
grc	rv
grd	d
gre	abcegmnprstvwy
grea	stv
greas	eiy
grease	dlpsw
greasel	e
greasele	s
greaseles	s
greaseless	n
greaselessn	e
greaselessne	s
greaselessnes	s
greaselessness	e
greaselessnesse	s
greasep	ar
greasepa	i
greasepai	n
greasepain	t
greasepr	o
greasepro	o
greaseproo	f
greasew	o
greasewo	o
greasewoo	d
greasi	eln
greasie	rs
greasies	t
greasil	y
greasin	eg
greasine	s
greasines	s
greasiness	e
greasinesse	s
greasy	f
greasyf	o
greasyfo	r
greasyfor	k
great	befilns
greatb	r
greatbr	i
greatbri	t
greatbrit	a
greatbrita	i
greatbritai	n
greate	nrs
greater	n
greatern	e
greaterne	s
greaternes	s
greates	t
greatf	i
greatfi	r
greatfir	e
greatfire	w
greatfirew	a
greatfirewa	l
greatfirewal	l
greati	s
greatis	h
greatl	y
greatn	e
greatne	s
greatnes	s
greatness	e
greatnesse	s
greav	e
greave	s
greb	e
grec	i
greci	asz
grecia	n
grecian	i
greciani	z
grecianiz	e
grecianize	s
grecis	e
greciz	e
gree	cdknrt
greec	e
greed	ilsy
greedi	eln
greedie	rs
greedies	t
greedil	y
greedin	e
greedine	s
greedines	s
greediness	e
greedinesse	s
greedl	e
greedle	s
greedles	s
greeds	o
greedso	m
greedsom	e
greek	is
greeki	z
greekiz	e
greekize	s
green	abcefghilnstvwy
greena	g
greenag	e
greenage	s
greenb	aelr
greenba	c
greenbac	k
greenbe	lr
greenbel	t
greenber	g
greenbl	a
greenbla	t
greenblat	t
greenbr	i
greenbri	a
greenbria	r
greenc	a
greenca	r
greencar	d
greencard	e
greencarde	r
greene	drs
greener	iy
greeneri	e
greenerie	s
greenes	t
greenf	eil
greenfe	l
greenfel	d
greenfi	en
greenfie	l
greenfiel	d
greenfin	c
greenfinc	h
greenfl	iy
greenfli	e
greenflie	s
greeng	ar
greenga	g
greengag	e
greengage	s
greengr	o
greengro	c
greengroc	e
greengroce	r
greengrocer	is
greengroceri	e
greengrocerie	s
greenh	o
greenho	ru
greenhor	n
greenhou	s
greenhous	e
greenhouse	s
greeni	ens
greenie	rs
greenies	t
greenin	g
greenis	h
greenish	n
greenishn	e
greenishne	s
greenishnes	s
greenishness	e
greenishnesse	s
greenl	aiy
greenla	n
greenlan	d
greenli	e
greenlie	rs
greenlies	t
greenn	e
greenne	s
greennes	s
greenness	e
greennesse	s
greens	btvw
greensb	o
greensbo	r
greensbor	o
greenst	o
greensto	n
greenston	e
greensv	i
greensvi	l
greensvil	l
greensvill	e
greensw	a
greenswa	r
greenswar	d
greent	r
greentr	e
greentre	e
greenv	i
greenvi	l
greenvil	l
greenvill	e
greenw	aio
greenwa	r
greenwar	e
greenwi	c
greenwic	h
greenwich	m
greenwichm	e
greenwichme	a
greenwichmea	n
greenwichmean	t
greenwichmeant	i
greenwichmeanti	m
greenwichmeantim	e
greenwo	o
greenwoo	d
greet	eisy
greete	dr
greeter	s
greeti	n
greetin	g
greeting	ls
greetingl	ey
greetingle	s
greetingles	s
greg	ago
grega	r
gregar	i
gregari	o
gregario	u
gregariou	s
gregarious	ln
gregariousl	y
gregariousn	e
gregariousne	s
gregariousnes	s
gregariousness	e
gregariousnesse	s
grego	r
gregor	iy
gregori	a
gregoria	n
grem	l
greml	i
gremli	n
gren	adiov
grena	d
grenad	aei
grenade	ds
grenadi	n
grenadin	eg
grenadine	s
grend	e
grende	l
greni	e
grenie	r
greno	b
grenob	l
grenobl	e
grenv	i
grenvi	l
grenvil	l
grenvill	e
grep	t
grept	i
grepti	m
greptim	e
greptime	d
greptimed	b
gres	h
gresh	a
gresha	m
gret	ac
gretc	h
gretch	e
gretche	n
grew	s
grews	o
grewso	m
grewsom	e
grewsome	rs
grewsomes	t
grey	bcehilnsw
greyb	e
greybe	a
greybea	r
greybear	d
greyc	i
greyci	n
greycin	g
greye	drs
greyer	s
greyes	t
greyh	o
greyho	u
greyhou	n
greyhoun	d
greyhound	s
greyi	ns
greyin	g
greyis	h
greyl	y
greyn	e
greyne	s
greynes	s
greyness	e
greynesse	s
greyw	a
greywa	c
greywac	k
greywack	e
grf	f
grg	q
gri	defglmnpstvz
grid	dils
gridd	l
griddl	ei
griddle	cds
griddlec	a
griddleca	k
griddlecak	e
griddli	n
griddlin	g
gridi	rs
gridir	o
gridiro	n
gridis	t
gridist	o
gridisto	r
gridl	o
gridlo	c
gridloc	k
gridlock	eis
gridlocke	d
gridlocki	n
gridlockin	g
grie	fv
grief	fls
grieff	u
grieffu	l
griefl	e
griefle	s
griefles	s
griefless	n
grieflessn	e
grieflessne	s
grieflessnes	s
grieflessness	e
grieflessnesse	s
griev	aeio
grieva	n
grievan	c
grievanc	e
grievance	s
grieve	drs
grieved	l
grievedl	y
griever	s
grieves	h
grievesh	i
grieveshi	p
grievi	n
grievin	g
grieving	l
grievingl	y
grievo	u
grievou	s
grievous	l
grievousl	y
grif	ft
griff	ei
griffi	nt
griffit	h
griffith	s
gril	l
grill	eis
grille	drs
griller	s
grilli	n
grillin	g
grim	aefilmny
grima	cl
grimac	ei
grimace	drs
grimacer	s
grimaci	en
grimacie	r
grimacin	g
grimacing	l
grimacingl	y
grimal	dk
grimald	i
grimalk	i
grimalki	n
grime	ds
grimf	u
grimfu	l
grimi	eln
grimie	rs
grimies	t
grimil	y
grimin	eg
grimine	s
grimines	s
griminess	e
griminesse	s
griml	y
grimm	e
grimme	rs
grimmes	t
grimn	e
grimne	s
grimnes	s
grimness	e
grimnesse	s
grin	dgns
grind	aeis
grinda	b
grindab	il
grindabi	l
grindabil	i
grindabili	t
grindabilit	iy
grindabiliti	e
grindabilitie	s
grindabl	e
grinde	dr
grinder	s
grindi	n
grindin	g
grinding	ls
grindingl	y
grinds	t
grindst	o
grindsto	n
grindston	e
grindstone	s
gring	o
grinn	ei
grinne	dr
grinner	s
grinni	n
grinnin	g
grinning	l
grinningl	y
grip	eilps
gripe	dfrs
gripef	u
gripefu	l
griper	s
gripes	a
gripesa	c
gripesac	k
gripi	n
gripin	g
griping	ln
gripingl	y
gripingn	e
gripingne	s
gripingnes	s
gripl	e
griple	s
griples	s
gripp	ei
grippe	dr
gripper	s
grippi	n
grippin	g
gripping	ln
grippingl	y
grippingn	e
grippingne	s
grippingnes	s
grippingness	e
grippingnesse	s
gris	kltw
grisk	i
griski	n
grisl	iy
grisli	en
grislie	rs
grislies	t
grislin	e
grisline	s
grislines	s
grisliness	e
grislinesse	s
grist	lm
gristl	ey
gristle	s
gristm	i
gristmi	l
gristmil	l
grisw	o
griswo	l
griswol	d
grit	lst
gritl	e
gritle	s
gritles	s
gritt	eiy
gritte	d
gritti	n
grittin	eg
grittine	s
grittines	s
griz	z
grizz	l
grizzl	ey
grizzle	d
grj	q
grm	ns
grmn	a
grmna	s
grmnas	i
grmnasi	u
grmnasiu	m
grn	ft
gro	abcfgikmopstuvwy
groa	nt
groan	efis
groane	dr
groaner	s
groanf	u
groanfu	l
groani	n
groanin	g
groaning	l
groaningl	y
groc	e
groce	r
grocer	disy
grocerd	o
grocerdo	m
groceri	en
grocerie	s
grocerin	g
grof	v
grog	grs
grogg	eiy
grogge	r
grogger	y
groggi	efln
groggie	rs
groggies	t
groggif	i
groggifi	e
groggifie	d
groggil	y
groggin	e
groggine	s
groggines	s
grogginess	e
grogginesse	s
grogr	a
grogra	m
grogs	h
grogsh	o
grogsho	p
groi	n
groin	eis
groine	d
groini	n
groinin	g
grom	m
gromm	e
gromme	t
groo	mtv
groom	eilsy
groome	dr
groomi	ns
groomin	g
groomis	h
groomish	l
groomishl	y
grooml	e
groomle	s
groomles	s
grooms	hm
groomsh	i
groomshi	p
groomsm	a
groomsma	n
groov	eiy
groove	dlrs
groovel	e
groovele	s
grooveles	s
groover	s
groovi	eln
groovie	rs
groovies	t
groovil	y
groovin	e
groovine	s
groovines	s
grop	ei
grope	drs
groper	s
gropi	n
gropin	g
groping	ls
gropingl	y
gros	bgsvz
grosb	e
grosbe	a
grosbea	k
grosg	r
grosgr	a
grosgra	i
grosgrai	n
gross	eilmny
grosse	dnrst
grosser	s
grosses	t
grossi	n
grossin	g
grossl	y
grossm	a
grossma	n
grossn	e
grossne	s
grossnes	s
grossness	e
grossnesse	s
grosv	e
grosve	n
grosven	o
grosveno	r
grot	eot
grote	s
grotes	q
grotesq	u
grotesqu	e
grotesque	lnrs
grotesquel	y
grotesquen	e
grotesquene	s
grotesquenes	s
grotesqueness	e
grotesquenesse	s
grotesquer	i
grotesqueri	e
grotesques	t
groto	n
grott	ioy
grotti	en
grottie	rs
grotties	t
grottin	e
grottine	s
grottines	s
grotto	s
grou	cnpst
grouc	h
grouch	iy
grouchi	l
grouchil	y
groun	d
ground	abehilnsw
grounda	bg
groundab	l
groundabl	ey
groundag	e
groundb	r
groundbr	e
groundbre	a
groundbrea	k
groundbreak	e
groundbreake	r
grounde	dr
grounded	n
groundedn	e
groundedne	s
groundednes	s
groundedness	e
groundednesse	s
grounder	s
groundh	o
groundho	g
groundhog	s
groundi	n
groundin	g
grounding	s
groundl	e
groundle	s
groundles	s
groundless	ln
groundlessl	y
groundlessn	e
groundlessne	s
groundlessnes	s
groundlessness	e
groundlessnesse	s
groundn	u
groundnu	t
groundnut	s
grounds	eh
groundse	l
groundsh	e
groundshe	e
groundshee	t
groundsheet	s
groundw	ao
groundwa	rt
groundwar	d
groundward	s
groundwat	e
groundwate	r
groundwo	r
groundwor	k
groundwork	s
group	aeilmsw
groupa	bg
groupab	l
groupabl	e
groupag	e
groupe	dr
groupi	en
groupin	g
grouping	s
groupl	e
grouple	t
groupm	e
groupme	n
groupmen	t
groupw	i
groupwi	s
groupwis	e
grous	ei
grouse	dlrsy
grousel	ei
grousele	s
grouseles	s
grouseli	k
grouselik	e
grouser	s
grousi	n
grousin	g
grov	e
grove	dlrst
grovel	eils
grovele	drs
groveler	s
groveles	s
groveli	n
grovelin	g
grovell	ei
grovelle	dr
groveller	s
grovelli	n
grovellin	g
grover	s
grow	aeilnst
growa	b
growab	l
growabl	e
growe	r
grower	s
growi	n
growin	g
growing	l
growingl	y
growl	eis
growle	d
growli	n
growlin	g
growling	l
growlingl	y
grown	nu
grownn	e
grownne	s
grownnes	s
grownu	p
grownup	s
growt	h
growth	es
growthe	rs
growthes	t
groy	n
groyn	ei
groyne	s
groyni	n
groynin	g
grp	cf
grpf	v
grr	jqv
grs	rs
grt	nr
gru	bdefmnsy
grub	bhs
grubb	eiy
grubbe	dr
grubber	s
grubbi	eln
grubbie	rs
grubbies	t
grubbil	y
grubbin	eg
grubbine	s
grubbines	s
grubbiness	e
grubbinesse	s
grubh	o
grubho	o
grubhoo	d
grud	g
grudg	ei
grudge	dflmrs
grudgef	u
grudgefu	l
grudgel	e
grudgele	s
grudgeles	s
grudgem	e
grudgeme	n
grudgemen	t
grudger	s
grudgi	n
grudgin	g
grudging	lns
grudgingl	y
grudgingn	e
grudgingne	s
grudgingnes	s
grue	ls
gruel	il
grueli	n
gruelin	g
gruell	i
gruelli	n
gruellin	g
grues	o
grueso	m
gruesom	e
gruesome	lnrs
gruesomel	y
gruesomen	e
gruesomene	s
gruesomenes	s
gruesomeness	e
gruesomenesse	s
gruesomes	t
gruf	f
gruff	eilnsy
gruffe	drs
gruffes	t
gruffi	ns
gruffin	g
gruffis	h
gruffl	y
gruffn	e
gruffne	s
gruffnes	s
gruffness	e
gruffnesse	s
grum	bmop
grumb	l
grumbl	eiy
grumble	drs
grumbler	s
grumbles	o
grumbleso	m
grumblesom	e
grumbli	en
grumblie	rs
grumblies	t
grumblin	g
grumbling	l
grumblingl	y
grumm	a
grumma	n
grumo	u
grumou	s
grump	iy
grumpi	eln
grumpie	rs
grumpies	t
grumpil	y
grumpin	e
grumpine	s
grumpines	s
grumpiness	e
grumpinesse	s
grun	dt
grund	y
grundy	i
grundyi	s
grundyis	m
grunt	eis
grunte	dr
grunter	s
grunti	n
gruntin	g
grunting	l
gruntingl	y
grus	k
grusk	y
gruy	e
gruye	r
gruyer	e
grv	u
grw	h
grx	o
gry	bs
grys	b
grysb	o
grysbo	k
gs	abdefghiklmnpqrstuvwy
gsa	dx
gsb	d
gsd	go
gsdo	v
gse	bdr
gsf	g
gsh	u
gsi	q
gsk	w
gsl	or
gsm	bd
gsn	cdfnorv
gsp	bnv
gsq	jq
gss	v
gst	v
gsu	i
gsui	t
gsuit	e
gsw	o
gsy	a
gt	aeimnopv
gta	rv
gtm	bp
gtmb	v
gtn	drv
gto	hv
gu	abcdefghijlmnopqrstuvwxyz
gua	cdemnrtvwy
guac	h
guach	a
guacha	r
guachar	o
guad	aerv
guada	l
guadal	u
guadalu	p
guadalup	e
guade	l
guadel	o
guadelo	u
guadelou	p
guadeloup	e
guan	aio
guana	c
guanac	o
guani	n
guanin	e
guano	eis
guanoe	d
guanoi	n
guanoin	g
guar	ad
guara	n
guaran	it
guarant	eoy
guarante	e
guarantee	dirs
guaranteei	n
guaranteein	g
guaranteer	s
guaranto	r
guard	aehilrs
guarda	bg
guardab	l
guardabl	e
guardag	e
guarde	dr
guarded	ln
guardedl	y
guardedn	e
guardedne	s
guardednes	s
guardedness	e
guardednesse	s
guarder	s
guardh	o
guardho	u
guardhou	s
guardhous	e
guardi	an
guardia	n
guardian	els
guardiane	s
guardianes	s
guardianl	e
guardianle	s
guardianles	s
guardians	h
guardiansh	i
guardianshi	p
guardianship	s
guardin	g
guarding	l
guardingl	y
guardl	ei
guardle	s
guardles	s
guardli	k
guardlik	e
guardr	o
guardro	o
guardroo	m
guards	m
guardsm	a
guardsma	n
guat	e
guate	m
guatem	a
guatema	l
guatemal	a
guatemala	n
guav	a
guava	s
gub	ev
gube	r
guber	n
gubern	a
guberna	t
gubernat	o
gubernato	r
gubernator	i
gubernatori	a
gubernatoria	l
guc	ck
gucc	i
gud	g
gudg	e
gudge	o
gudgeo	n
gue	lnrs
guel	p
guelp	h
guen	t
guent	h
guenth	e
guenthe	r
guer	dinr
guerd	o
guerdo	n
gueri	l
gueril	l
guerill	a
guerilla	s
guern	s
guerns	e
guernse	y
guerr	i
guerri	l
guerril	l
guerrill	a
guerrilla	is
guerrillai	s
guerrillais	m
guerrillaism	s
gues	st
guess	eitw
guesse	drs
guesser	s
guessi	n
guessin	g
guesst	i
guessti	m
guesstim	a
guesstima	t
guesstimat	e
guessw	o
guesswo	r
guesswor	k
guesswork	s
guest	beils
guestb	o
guestbo	o
guestboo	k
gueste	d
guesti	n
guestin	g
guestl	e
guestle	s
guestles	s
guf	f
guff	a
guffa	w
gug	g
gugg	e
gugge	n
guggen	h
guggenh	e
guggenhe	i
guggenhei	m
guh	lv
guhl	e
guhle	m
guhlem	a
guhlema	n
gui	adlnpstv
guia	n
guian	a
guid	aeio
guida	bn
guidab	l
guidabl	e
guidan	c
guidanc	e
guidance	s
guide	bdlprs
guideb	o
guidebo	o
guideboo	k
guidebook	s
guidel	ei
guidele	s
guideles	s
guideli	n
guidelin	e
guideline	s
guidep	o
guidepo	s
guidepos	t
guider	s
guidi	n
guidin	g
guiding	l
guidingl	y
guido	n
guil	defilt
guild	ers
guilde	r
guilder	s
guildr	y
guilds	hm
guildsh	i
guildshi	p
guildship	s
guildsm	a
guildsma	n
guile	dfls
guilef	u
guilefu	l
guilel	e
guilele	s
guileles	s
guilf	o
guilfo	r
guilfor	d
guili	n
guilin	g
guill	o
guillo	t
guillot	i
guilloti	n
guillotin	ei
guillotine	ds
guillotini	n
guillotinin	g
guilt	eilsy
guilte	d
guilti	eln
guiltie	rs
guilties	t
guiltil	y
guiltin	eg
guiltine	s
guiltines	s
guiltiness	e
guiltinesse	s
guiltl	e
guiltle	s
guiltles	s
guiltless	l
guiltlessl	y
guin	en
guine	av
guinev	e
guineve	r
guinever	e
guinn	e
guinne	s
guinnes	s
guip	u
guipu	r
guipur	e
guis	ei
guise	ds
guisi	n
guisin	g
guit	a
guita	r
guitar	ils
guitari	s
guitaris	t
guitarist	s
guitarl	i
guitarli	k
guitarlik	e
guj	a
guja	r
gujar	a
gujara	t
gujarat	i
gul	ceflopy
gulc	h
gulch	e
gulche	s
gule	s
gulf	eilsw
gulfe	d
gulfi	en
gulfie	rs
gulfies	t
gulfin	g
gulfl	i
gulfli	k
gulflik	e
gulfw	e
gulfwe	e
gulfwee	d
gull	aeisy
gulla	h
gulle	drty
guller	y
gullet	eis
gullete	d
gulleti	n
gulletin	g
gulley	s
gulli	ben
gullib	il
gullibi	l
gullibil	i
gullibili	t
gullibilit	iy
gullibiliti	e
gullibilitie	s
gullibl	ey
gullie	ds
gullin	g
gully	i
gullyi	n
gullyin	g
gulp	eisy
gulpe	dr
gulper	s
gulpi	en
gulpie	rs
gulpies	t
gulpin	g
gulping	l
gulpingl	y
gum	bdflmpsw
gumb	ao
gumba	l
gumbal	l
gumball	s
gumbo	i
gumboi	l
gumd	r
gumdr	o
gumdro	p
guml	ei
gumle	s
gumles	s
gumli	k
gumlik	e
gumm	eiy
gumme	r
gummer	s
gummi	n
gummin	g
gump	t
gumpt	i
gumpti	o
gumptio	nu
gumptiou	s
gums	h
gumsh	o
gumsho	e
gumw	ao
gumwa	t
gumwat	e
gumwate	r
gumwo	o
gumwoo	d
gun	bcdflmnprst
gunb	o
gunbo	a
gunboa	t
gunboat	s
gunc	o
gunco	t
guncot	t
guncott	o
guncotto	n
gund	aeo
gunda	m
gunde	r
gunder	s
gunders	o
gunderso	n
gundo	g
gunf	i
gunfi	gr
gunfig	h
gunfigh	t
gunfir	e
gunfire	s
gunl	eo
gunle	s
gunles	s
gunlo	c
gunloc	k
gunm	ae
gunma	n
gunman	s
gunmans	h
gunmansh	i
gunmanshi	p
gunmanship	s
gunme	nt
gunmet	a
gunmeta	l
gunn	aeiy
gunna	r
gunne	dr
gunner	sy
gunni	n
gunnin	g
gunp	lo
gunpl	a
gunpla	y
gunpo	iw
gunpoi	n
gunpoin	t
gunpoint	s
gunpow	d
gunpowd	e
gunpowde	r
gunpowder	esy
gunpowdere	d
gunr	u
gunru	n
gunrun	n
gunrunn	ei
gunrunne	r
gunrunni	n
gunrunnin	g
guns	hmt
gunsh	io
gunshi	p
gunsho	t
gunshot	s
gunsm	i
gunsmi	t
gunsmit	h
gunst	o
gunsto	c
gunstoc	k
gunt	h
gunth	e
gunthe	r
gup	pt
gupp	y
gupt	a
gur	gku
gurg	l
gurgl	eiy
gurgle	drs
gurgli	n
gurglin	g
gurgling	l
gurglingl	y
gurk	h
gurkh	a
guru	s
gurus	h
gurush	i
gurushi	p
guruship	s
gus	ht
gush	ei
gushe	drs
gushi	n
gushin	g
gushing	l
gushingl	y
gust	aeilosy
gusta	bftv
gustab	l
gustabl	e
gustable	s
gustaf	s
gustafs	o
gustafso	n
gustat	io
gustati	o
gustatio	n
gustato	r
gustator	y
gustav	eu
gustavu	s
guste	d
gusti	eln
gustie	rs
gusties	t
gustil	y
gustin	eg
gustine	s
gustines	s
gustiness	e
gustinesse	s
gustl	e
gustle	s
gustles	s
gusto	e
gustoe	s
gut	efhlmrst
gute	n
guten	b
gutenb	e
gutenbe	r
gutenber	g
gutf	u
gutfu	l
guth	r
guthr	i
guthri	e
gutl	ei
gutle	s
gutles	s
gutli	kn
gutlik	e
gutlin	g
guts	y
gutt	aeiluy
gutta	t
guttat	e
gutte	r
gutter	els
guttere	d
gutterl	i
gutterli	kn
gutterlik	e
gutterlin	g
gutti	n
guttin	g
guttl	e
guttu	r
guttur	a
guttura	l
guttural	i
gutturali	z
gutturaliz	e
guu	uv
guv	d
guw	u
gux	rsv
guy	aeis
guya	n
guyan	a
guye	dr
guyer	s
guyi	n
guyin	g
guz	z
guzz	l
guzzl	ei
guzzle	drs
guzzler	s
guzzli	n
guzzlin	g
gv	aefiosvx
gvf	fv
gvi	m
gvo	m
gvs	bipv
gvv	u
gw	aefjknovxy
gwa	v
gwe	n
gwk	t
gwn	rsv
gwo	osv
gwoo	v
gwy	n
gx	adeikou
gxi	u
gy	abdefghjlmnoprsvwxyz
gya	v
gyb	egp
gyd	o
gye	rv
gyf	b
gyl	k
gym	kns
gymk	h
gymkh	a
gymkha	n
gymkhan	a
gymn	ao
gymna	s
gymnas	it
gymnasi	u
gymnasiu	m
gymnasium	s
gymnast	is
gymnasti	c
gymnastic	s
gymnastics	e
gymnasticse	s
gymno	s
gymnos	p
gymnosp	e
gymnospe	r
gymnosper	m
gyn	ade
gyna	e
gynae	c
gynaec	o
gynaeco	l
gynaecol	o
gynaecolo	g
gynaecolog	iy
gynaecologi	cs
gynaecologic	a
gynaecologica	l
gynaecological	l
gynaecologicall	y
gynaecologis	t
gyne	c
gynec	o
gyneco	l
gynecol	o
gynecolo	g
gynecolog	iy
gynecologi	s
gynecologis	t
gyo	kop
gyp	dfs
gyps	eiuy
gypse	i
gypsei	a
gypseia	n
gypsi	e
gypsie	ds
gypsu	m
gypsum	s
gypsy	dehil
gypsyd	o
gypsydo	m
gypsydom	s
gypsye	s
gypsyes	q
gypsyesq	u
gypsyesqu	e
gypsyh	o
gypsyho	o
gypsyhoo	d
gypsyhood	s
gypsyi	ns
gypsyin	g
gypsyis	m
gypsyism	s
gypsyl	i
gypsyli	k
gypsylik	e
gyr	aeopu
gyra	lt
gyrat	eio
gyrati	o
gyratio	n
gyrato	r
gyre	n
gyren	e
gyro	cims
gyroc	o
gyroco	m
gyrocom	p
gyrocomp	a
gyrocompa	s
gyrocompas	s
gyroi	d
gyroid	a
gyroida	l
gyrom	ag
gyroma	g
gyromag	n
gyromagn	e
gyromagne	t
gyromagnet	i
gyromagneti	c
gyromg	n
gyromgn	e
gyromgne	t
gyromgnet	i
gyromgneti	c
gyros	c
gyrosc	o
gyrosco	p
gyroscop	ei
gyroscope	s
gyroscopi	c
gyroscopic	a
gyroscopica	l
gyroscopical	l
gyroscopicall	y
gyru	sv
gys	v
gyv	e
gyw	f
gyy	ars
gyyr	v
gyz	u
gz	adehijmru
gza	f
gzd	fj
gze	z
gzez	v
gzh	v
gzi	p
gzm	b
