h	abcdefghijklmnopqrstuvwxyz
ha	abcdefghijklmnopqrstuvwxyz
haa	gs
hab	aei
haba	n
haban	en
habane	r
habaner	a
habe	ar
habea	s
haber	dm
haberd	a
haberda	s
haberdas	h
haberdash	e
haberdashe	r
haberdasher	y
haberm	a
haberma	n
habi	blt
habil	i
habili	mt
habilim	e
habilime	n
habilimen	t
habilit	a
habilita	t
habilitat	e
habit	aisu
habita	bnt
habitab	il
habitabi	l
habitabil	i
habitabili	t
habitabilit	iy
habitabiliti	e
habitabilitie	s
habitabl	ey
habitable	n
habitablen	e
habitablene	s
habitablenes	s
habitableness	e
habitablenesse	s
habitan	t
habitat	is
habitati	ov
habitatio	n
habitation	as
habitationa	l
habitativ	e
habiti	n
habitin	g
habitu	ads
habitua	lt
habitual	iln
habituali	tz
habitualit	y
habitualiz	e
habituall	y
habitualn	e
habitualne	s
habitualnes	s
habitualness	e
habitualnesse	s
habituat	ei
habituati	o
habituatio	n
habitud	e
hac	ik
haci	e
hacie	n
hacien	d
haciend	a
hack	abeilmns
hacka	bm
hackab	l
hackabl	e
hackam	o
hackamo	r
hackamor	e
hackb	e
hackbe	r
hackber	r
hackberr	y
hacke	drst
hacker	ds
hackerd	o
hackerdo	m
hackes	t
hacket	t
hacki	n
hackin	gt
hackint	o
hackinto	s
hackintos	h
hackl	e
hackm	a
hackma	n
hackn	e
hackne	y
hackney	e
hackneye	d
hacks	at
hacksa	w
hacksaw	eis
hacksawe	d
hacksawi	n
hacksawin	g
hackst	e
hackste	r
had	adeijklor
hada	m
hadam	a
hadama	r
hadamar	d
hadd	aeo
hadda	d
hadde	s
haddes	t
haddo	c
haddoc	k
haddock	s
hade	s
hadi	n
hadin	g
hadj	es
hadje	s
hadk	v
hadl	e
hadle	y
hado	or
hadoo	p
hador	w
hadorw	o
hadorwo	u
hadorwou	l
hadorwoul	d
hadr	io
hadri	a
hadria	n
hadro	n
hae	mrv
haem	ao
haema	nt
haeman	g
haemang	i
haemangi	o
haemangio	b
haemangiob	l
haemangiobl	a
haemangiobla	s
haemangioblas	t
haemangioblast	o
haemangioblasto	m
haemangioblastom	a
haemat	io
haemati	cnt
haematit	ei
haematiti	c
haemato	l
haematol	o
haematolo	g
haematolog	y
haemo	cdglprs
haemoc	o
haemoco	n
haemocon	c
haemoconc	e
haemoconce	n
haemoconcen	t
haemoconcent	r
haemoconcentr	a
haemoconcentra	t
haemoconcentrat	i
haemoconcentrati	o
haemoconcentratio	n
haemod	i
haemodi	a
haemodia	l
haemodial	y
haemodialy	s
haemodialys	e
haemodialyse	r
haemog	lr
haemogl	o
haemoglo	b
haemoglob	i
haemoglobi	n
haemoglobin	aos
haemoglobina	e
haemoglobinae	m
haemoglobinaem	i
haemoglobinaemi	a
haemoglobino	m
haemoglobinom	e
haemoglobinome	t
haemoglobinomet	e
haemoglobinomete	r
haemogr	a
haemogra	m
haemol	y
haemoly	s
haemolys	i
haemolysi	s
haemop	h
haemoph	i
haemophi	l
haemophil	i
haemophili	a
haemophilia	c
haemophiliac	s
haemor	r
haemorr	h
haemorrh	ao
haemorrha	g
haemorrhag	ei
haemorrhage	ds
haemorrhagi	n
haemorrhagin	g
haemorrho	i
haemorrhoi	d
haemorrhoid	s
haemos	it
haemosi	d
haemosid	e
haemoside	r
haemosider	io
haemosideri	n
haemosidero	s
haemosideros	i
haemosiderosi	s
haemost	a
haemosta	st
haemostas	i
haemostasi	s
haer	e
haere	m
haerem	a
haerema	i
haf	eint
hafi	z
hafn	i
hafni	u
hafniu	m
hag	efgirsu
hage	nr
hagf	i
hagfi	s
hagfis	h
hagg	ail
hagga	ir
haggar	d
haggard	lns
haggardl	y
haggardn	e
haggardne	s
haggardnes	s
haggardness	e
haggardnesse	s
haggi	s
haggis	h
haggl	ei
haggle	drs
haggler	s
haggli	n
hagglin	g
hagi	o
hagio	gl
hagiog	r
hagiogr	a
hagiogra	p
hagiograp	h
hagiograph	ey
hagiographe	r
hagiol	o
hagiolo	g
hagiolog	y
hagr	i
hagri	d
hagrid	d
hagridd	e
hagridde	n
hags	t
hagst	r
hagstr	o
hagstro	m
hagu	e
hah	an
hai	efklnrt
haie	r
haif	a
haik	u
hail	eis
haile	dr
hailer	s
haili	n
hailin	g
hails	t
hailst	o
hailsto	nr
hailston	e
hailstor	m
hain	e
haine	s
hair	bcdegilnpsty
hairb	r
hairbr	eu
hairbre	a
hairbrea	d
hairbread	t
hairbreadt	h
hairbru	s
hairbrus	h
hairbrush	e
hairbrushe	s
hairc	u
haircu	t
haircut	st
haircutt	ei
haircutte	r
haircutter	s
haircutti	n
haircuttin	g
haircutting	s
haird	or
hairdo	s
hairdr	eiy
hairdre	s
hairdres	s
hairdress	ei
hairdresse	r
hairdresser	s
hairdressi	n
hairdressin	g
hairdri	e
hairdrie	r
hairdry	e
hairdrye	r
hairdryer	s
haire	d
hairg	r
hairgr	i
hairgri	p
hairi	eln
hairie	rs
hairies	t
hairil	y
hairin	e
hairine	s
hairines	s
hairiness	e
hairinesse	s
hairl	ei
hairle	s
hairles	s
hairless	n
hairlessn	e
hairlessne	s
hairlessnes	s
hairlessness	e
hairlessnesse	s
hairli	kn
hairlik	e
hairlin	e
hairline	s
hairn	e
hairne	t
hairp	i
hairpi	en
hairpie	c
hairpiec	e
hairpin	s
hairs	pt
hairsp	lr
hairspl	i
hairspli	t
hairsplit	t
hairsplitt	ei
hairsplitte	r
hairsplitti	n
hairsplittin	g
hairspr	ai
hairspra	y
hairspray	s
hairspri	n
hairsprin	g
hairst	ry
hairstr	e
hairstre	a
hairstrea	k
hairsty	l
hairstyl	ei
hairstyle	s
hairstyli	s
hairstylis	t
hairstylist	s
hairt	a
hairta	i
hairtai	l
hait	i
haiti	a
haitia	n
haj	ajq
hajj	es
hajje	s
hajq	v
hak	adeiv
hake	v
hal	abcefilmopstvy
hala	clt
halac	h
halach	i
halachi	c
halal	ls
halall	ei
halalle	d
halalli	n
halallin	g
halat	i
halati	o
halatio	n
halb	e
halbe	r
halber	d
halc	y
halcy	o
halcyo	n
hale	nry
halen	e
halene	s
halenes	s
half	abcdfhlmnopstw
halfa	ns
halfan	n
halfann	o
halfanno	y
halfannoy	i
halfannoyi	n
halfannoyin	g
halfannoying	l
halfannoyingl	y
halfas	l
halfasl	e
halfasle	e
halfaslee	p
halfb	a
halfba	c
halfbac	k
halfc	lou
halfcl	e
halfcle	a
halfclea	r
halfclear	l
halfclearl	y
halfco	a
halfcoa	x
halfcoax	i
halfcoaxi	n
halfcoaxin	g
halfcoaxing	l
halfcoaxingl	y
halfcu	t
halfd	e
halfde	c
halfdec	a
halfdeca	d
halfdecad	e
halff	l
halffl	a
halffla	t
halfflat	t
halfflatt	e
halfflatte	r
halfflatter	i
halfflatteri	n
halfflatterin	g
halfflattering	l
halfflatteringl	y
halfh	eo
halfhe	a
halfhea	r
halfhear	t
halfheart	e
halfhearte	d
halfho	u
halfhou	r
halfl	i
halfli	b
halflib	e
halflibe	r
halfliber	a
halflibera	l
halfliberal	l
halfliberall	y
halfm	e
halfme	a
halfmea	n
halfmean	t
halfn	e
halfne	s
halfnes	s
halfness	e
halfnesse	s
halfo	v
halfov	a
halfova	l
halfp	e
halfpe	n
halfpen	n
halfpenn	y
halfpenny	w
halfpennyw	o
halfpennywo	r
halfpennywor	t
halfpennywort	h
halfs	emt
halfse	cr
halfsec	t
halfsect	i
halfsecti	o
halfsectio	n
halfser	i
halfseri	o
halfserio	u
halfseriou	s
halfsm	i
halfsmi	l
halfsmil	i
halfsmili	n
halfsmilin	g
halfst	o
halfsto	c
halfstoc	k
halfstock	i
halfstocki	n
halfstockin	g
halft	ou
halfto	n
halfton	e
halftu	r
halftur	n
halfturn	e
halfturne	d
halfw	a
halfwa	y
hali	bdft
halib	u
halibu	t
halid	e
halif	a
halifa	x
halit	eo
halito	s
halitos	i
halitosi	s
hall	eimosuw
halle	ly
hallel	u
hallelu	j
halleluj	a
halleluja	h
hallelujah	i
hallelujahi	m
halli	n
hallin	a
hallina	n
hallm	a
hallma	r
hallmar	k
hallmark	eis
hallmarke	dr
hallmarker	s
hallmarki	n
hallmarkin	g
hallo	eiosw
halloe	d
halloi	n
halloin	g
halloo	eis
hallooe	d
hallooi	n
hallooin	g
hallow	e
hallowe	de
hallowee	n
hallu	c
halluc	i
halluci	n
hallucin	ao
hallucina	t
hallucinat	ei
hallucinati	ov
hallucinatio	n
hallucination	as
hallucinationa	l
hallucinativ	e
hallucino	g
hallucinog	e
hallucinoge	n
hallucinogen	is
hallucinogeni	c
hallucinogenic	s
hallw	a
hallwa	y
hallway	s
halm	a
halo	egilps
haloe	ds
haloes	q
haloesq	u
haloesqu	e
halog	e
haloge	n
halogen	ios
halogeni	c
halogeno	u
halogenou	s
haloi	dn
haloin	g
halol	i
haloli	k
halolik	e
halop	h
haloph	iy
halophi	l
halophil	e
halophy	t
halophyt	i
halophyti	s
halophytis	m
halp	e
halpe	r
halper	n
hals	et
halse	y
halst	e
halste	a
halstea	d
halt	eils
halte	drs
halter	eils
haltere	ds
halteri	n
halterin	g
halterl	i
halterli	k
halterlik	e
haltes	t
halti	n
haltin	g
halting	ls
haltingl	y
haltl	e
haltle	s
haltles	s
halv	ei
halve	drs
halver	s
halvers	o
halverso	n
halvi	n
halvin	g
haly	a
halya	r
halyar	d
ham	abeilmpsv
hama	dls
hamad	r
hamadr	y
hamadry	a
hamadrya	d
hamadryad	e
hamb	u
hambu	r
hambur	g
hamburg	es
hamburge	r
hamburger	s
hame	y
hami	lt
hamil	t
hamilt	o
hamilto	n
hamilton	i
hamiltoni	a
hamiltonia	n
hamiltonian	s
hamit	e
haml	ei
hamle	t
hamlet	ils
hamleti	sz
hamletis	hm
hamletiz	e
hamletl	i
hamletli	k
hamletlik	e
hamli	n
hamm	eio
hamme	drt
hammer	abehilst
hammera	b
hammerab	l
hammerabl	e
hammerb	l
hammerbl	o
hammerblo	w
hammere	dr
hammerer	s
hammerh	e
hammerhe	a
hammerhea	d
hammeri	n
hammerin	g
hammering	ls
hammeringl	y
hammerl	i
hammerli	k
hammerlik	e
hammers	p
hammersp	o
hammerspo	o
hammerspoo	n
hammert	o
hammerto	e
hammet	t
hammi	n
hammin	g
hammo	cn
hammoc	k
hammock	ls
hammockl	i
hammockli	k
hammocklik	e
hammon	d
hamp	est
hampe	r
hamper	eis
hampere	dr
hampered	ln
hamperedl	y
hamperedn	e
hamperedne	s
hamperednes	s
hamperedness	e
hamperednesse	s
hamperer	s
hamperi	n
hamperin	g
hamps	h
hampsh	i
hampshi	r
hampshir	e
hampt	o
hampto	n
hams	ht
hamsh	a
hamsha	c
hamshac	k
hamshack	l
hamshackl	e
hamst	er
hamste	r
hamster	s
hamstr	iu
hamstri	n
hamstrin	g
hamstring	eis
hamstringe	d
hamstringi	n
hamstringin	g
hamstru	n
hamstrun	g
han	cdefgklnosuv
hanc	o
hanco	c
hancoc	k
hand	bcefghijklmoprstwy
handb	aeior
handba	gl
handbag	s
handbal	l
handbe	l
handbel	l
handbi	l
handbil	l
handbo	o
handboo	k
handbook	s
handbr	ae
handbra	k
handbrak	e
handbrake	s
handbre	a
handbrea	d
handbread	t
handbreadt	h
handc	alru
handca	r
handcar	t
handcl	a
handcla	s
handclas	p
handcr	a
handcra	f
handcraf	t
handcraft	e
handcrafte	d
handcu	f
handcuf	f
handcuff	eis
handcuffe	d
handcuffi	n
handcuffin	g
hande	dlrs
handed	n
handedn	e
handedne	s
handednes	s
handes	t
handf	ru
handfr	e
handfre	e
handfu	l
handful	s
handg	ru
handgr	i
handgri	p
handgu	n
handgun	ns
handgunn	ei
handgunne	r
handgunni	n
handgunnin	g
handh	eo
handhe	l
handhel	d
handheld	s
handho	l
handhol	d
handi	celnw
handic	ar
handica	p
handicap	ps
handicapp	ei
handicappe	dr
handicapped	s
handicappi	n
handicappin	g
handicr	a
handicra	f
handicraf	t
handicraft	es
handicrafte	r
handicrafter	s
handicrafts	hm
handicraftsh	i
handicraftshi	p
handicraftship	s
handicraftsm	a
handicraftsma	n
handie	rs
handies	t
handil	y
handin	eg
handine	s
handines	s
handiness	e
handinesse	s
handiw	o
handiwo	r
handiwor	k
handiwork	s
handj	o
handjo	b
handjob	s
handk	e
handke	r
handker	c
handkerc	h
handkerch	i
handkerchi	e
handkerchie	fv
handkerchief	s
handkerchiev	e
handkerchieve	s
handl	eio
handle	abdlrs
handlea	b
handleab	il
handleabi	l
handleabil	i
handleabili	t
handleabilit	i
handleabiliti	e
handleabilitie	s
handleabl	e
handleb	a
handleba	r
handlebar	s
handlel	e
handlele	s
handleles	s
handler	s
handli	kn
handlik	e
handlin	g
handlo	o
handloo	m
handm	a
handma	di
handmad	e
handmai	d
hando	fuv
handof	f
handou	t
handout	s
handov	e
handove	r
handp	i
handpi	c
handpic	k
handpick	e
handpicke	d
handr	a
handra	i
handrai	l
handrail	s
hands	aefhopt
handsa	w
handse	lt
handset	st
handsett	i
handsetti	n
handsettin	g
handsf	ru
handsfr	e
handsfre	e
handsfu	l
handsh	a
handsha	k
handshak	ei
handshake	rs
handshaki	n
handshakin	g
handshaking	s
handso	m
handsom	e
handsome	ilnrs
handsomei	s
handsomeis	h
handsomel	y
handsomen	e
handsomene	s
handsomenes	s
handsomeness	e
handsomenesse	s
handsomes	t
handsp	r
handspr	i
handspri	n
handsprin	g
handst	ao
handsta	n
handstan	d
handstand	is
handstandi	n
handstandin	g
handsto	o
handstoo	d
handt	r
handtr	u
handtru	c
handtruc	k
handw	or
handwo	r
handwor	k
handwr	i
handwri	t
handwrit	it
handwriti	n
handwritin	g
handwriting	s
handwritt	e
handwritte	n
handy	m
handym	ae
handyma	n
handyme	n
hane	y
hanf	o
hanfo	r
hanfor	d
hang	adeimnostw
hanga	br
hangab	il
hangabi	l
hangabil	i
hangabili	t
hangabilit	iy
hangabiliti	e
hangabilitie	s
hangabl	e
hangar	eis
hangare	d
hangari	n
hangarin	g
hangd	o
hangdo	g
hange	dr
hanger	s
hangi	n
hangin	g
hanging	ls
hangingl	y
hangm	ae
hangma	n
hangman	ls
hangmanl	i
hangmanli	k
hangmanlik	e
hangmans	h
hangmansh	i
hangmanshi	p
hangme	n
hangn	a
hangna	i
hangnai	l
hango	uv
hangou	t
hangov	e
hangove	r
hangover	s
hangt	ae
hangta	g
hangte	n
hangw	o
hangwo	r
hangwor	t
hangwort	h
hangworth	y
hank	eiy
hanke	lr
hanker	eis
hankere	dr
hankerer	s
hankeri	n
hankerin	g
hanki	e
hankie	s
hanl	eop
hanle	y
hanlo	n
hann	aio
hanna	h
hanni	b
hannib	a
hanniba	l
hanno	v
hannov	e
hannove	r
hano	iv
hanov	e
hanove	r
hanover	i
hanoveri	az
hanoveria	n
hanoverian	i
hanoveriani	z
hanoverianiz	e
hanoverianize	s
hanoveriz	e
hanoverize	s
hans	aeo
hansa	r
hansar	d
hanse	aln
hansea	t
hanseat	i
hanseati	c
hanso	n
hanu	k
hanuk	k
hanukk	a
hanukka	h
hao	bhv
hap	ghlprstv
hapg	o
hapgo	o
hapgoo	d
haph	a
hapha	z
haphaz	a
haphaza	r
haphazar	d
haphazard	lnrs
haphazardl	y
haphazardn	e
haphazardne	s
haphazardnes	s
haphazardness	e
haphazardnesse	s
haphazardr	i
haphazardri	e
haphazardrie	s
hapl	eoy
haple	s
haples	s
hapless	ln
haplessl	y
haplessn	e
haplessne	s
haplessnes	s
haplo	il
haploi	d
haploid	is
haploidi	e
haploidie	s
haplol	o
haplolo	g
haplolog	y
happ	eiy
happe	n
happen	eis
happene	d
happeni	n
happenin	g
happening	s
happi	eln
happie	rs
happies	t
happil	y
happin	e
happine	s
happines	s
haps	b
hapsb	u
hapsbu	r
hapsbur	g
hapt	i
hapti	c
haptic	a
haptica	l
haq	defhimrs
haqe	rsv
har	abcdehiklmnoprstuv
hara	kns
harak	a
haran	g
harang	u
harangu	e
haras	s
harass	aeim
harassa	b
harassab	l
harassabl	e
harasse	drs
harasser	s
harassi	n
harassin	g
harassing	l
harassingl	y
harassm	e
harassme	n
harassmen	t
harassment	s
harb	io
harbi	n
harbin	g
harbing	e
harbinge	r
harbo	ru
harbor	eis
harbore	d
harbori	n
harborin	g
harbou	r
harbour	eils
harboure	dr
harbouri	n
harbourin	g
harbourl	e
harbourle	s
harbourles	s
harc	o
harco	u
harcou	r
harcour	t
hard	bcehilnpstwy
hardb	ao
hardba	cl
hardbac	k
hardbal	l
hardbo	aiu
hardboa	r
hardboar	d
hardboard	s
hardboi	l
hardboil	e
hardboile	d
hardbou	n
hardboun	d
hardc	o
hardco	prv
hardcop	y
hardcor	e
hardcore	s
hardcov	e
hardcove	r
harde	nrs
harden	aeis
hardena	b
hardenab	il
hardenabi	l
hardenabil	i
hardenabili	t
hardenabilit	i
hardenabiliti	e
hardenabilitie	s
hardenabl	e
hardene	d
hardeni	n
hardenin	g
hardes	t
hardh	ae
hardha	cnt
hardhac	k
hardhan	d
hardhand	e
hardhande	d
hardhe	a
hardhea	dr
hardhead	e
hardheade	d
hardhear	t
hardheart	e
hardhearte	d
hardi	ehlns
hardie	rs
hardies	t
hardih	o
hardiho	o
hardihoo	d
hardil	y
hardin	eg
hardine	s
hardines	s
hardiness	e
hardinesse	s
harding	s
hardis	h
hardl	y
hardn	e
hardne	s
hardnes	s
hardp	a
hardpa	n
hards	cht
hardsc	r
hardscr	a
hardscra	b
hardscrab	b
hardscrabb	l
hardscrabbl	e
hardsh	i
hardshi	p
hardship	s
hardst	a
hardsta	n
hardstan	d
hardt	a
hardta	c
hardtac	k
hardw	aio
hardwa	r
hardwar	e
hardware	s
hardwi	r
hardwir	e
hardwire	d
hardwo	or
hardwoo	d
hardwood	s
hardwor	k
hardwork	i
hardworki	n
hardworkin	g
hardy	e
hardye	s
hardyes	q
hardyesq	u
hardyesqu	e
hare	bdlms
hareb	er
harebe	l
harebel	l
harebr	a
harebra	i
harebrai	n
harebrain	e
harebraine	d
harel	i
hareli	kp
harelik	e
harelip	p
harelipp	e
harelippe	d
harem	s
harh	o
harho	u
harhou	r
harhour	l
harhourl	e
harhourle	s
harhourles	s
hari	cn
haric	o
harico	t
harin	g
haring	t
haringt	o
haringto	n
hark	e
harke	n
harl	aeo
harla	n
harle	mqy
harleq	u
harlequ	i
harlequi	n
harlo	t
harlot	s
harm	aefilos
harma	nt
harmat	t
harmatt	a
harmatta	n
harme	dr
harmer	s
harmf	u
harmfu	l
harmful	ln
harmfull	y
harmfuln	e
harmfulne	s
harmfulnes	s
harmfulness	e
harmfulnesse	s
harmi	n
harmin	g
harml	e
harmle	s
harmles	s
harmless	ln
harmlessl	y
harmlessn	e
harmlessne	s
harmlessnes	s
harmlessness	e
harmlessnesse	s
harmo	n
harmon	iy
harmoni	ceosuz
harmonic	ais
harmonica	ls
harmonical	ln
harmonicall	y
harmonicaln	e
harmonicalne	s
harmonicalnes	s
harmonicalness	e
harmonicalnesse	s
harmonici	s
harmonicis	t
harmonicist	s
harmonie	s
harmonio	u
harmoniou	s
harmonious	ln
harmoniousl	y
harmoniousn	e
harmoniousne	s
harmoniousnes	s
harmoniousness	e
harmoniousnesse	s
harmonis	aeit
harmonisa	b
harmonisab	l
harmonisabl	e
harmonise	ds
harmonisi	n
harmonisin	g
harmonist	i
harmonisti	c
harmonistic	a
harmonistica	l
harmonistical	l
harmonisticall	y
harmoniu	m
harmoniz	aei
harmoniza	bt
harmonizab	l
harmonizabl	e
harmonizat	i
harmonizati	o
harmonizatio	n
harmonization	s
harmonize	drs
harmonizer	s
harmonizi	n
harmonizin	g
harmony	o
harmonyo	ns
harmonyon	e
harn	e
harne	s
harnes	s
harness	eil
harnesse	drs
harnesser	s
harnessi	n
harnessin	g
harnessl	ei
harnessle	s
harnessles	s
harnessli	k
harnesslik	e
haro	l
harol	d
harp	eilosy
harpe	dr
harper	s
harpi	ns
harpin	g
harpis	t
harpist	s
harpl	i
harpli	k
harplik	e
harpo	o
harpoo	n
harpoon	eils
harpoone	der
harpoonee	r
harpooner	s
harpooni	n
harpoonin	g
harpoonl	i
harpoonli	k
harpoonlik	e
harps	i
harpsi	c
harpsic	h
harpsich	o
harpsicho	r
harpsichor	d
harr	ioy
harri	emns
harrie	drt
harrim	a
harrima	n
harrin	g
harring	t
harringt	o
harringto	n
harris	bo
harrisb	u
harrisbu	r
harrisbur	g
harriso	n
harrison	b
harrisonb	u
harrisonbu	r
harrisonbur	g
harro	vw
harrov	i
harrovi	a
harrovia	n
harrow	eims
harrowe	dr
harrower	s
harrowi	n
harrowin	g
harrowing	ln
harrowingl	y
harrowingn	e
harrowingne	s
harrowingnes	s
harrowm	e
harrowme	n
harrowmen	t
harrowment	s
harrows	c
harrowsc	h
harrowsch	o
harrowscho	o
harrowschoo	l
hars	h
harsh	eln
harshe	rs
harshes	t
harshl	y
harshn	e
harshne	s
harshnes	s
harshness	e
harshnesse	s
hart	flms
hartf	o
hartfo	r
hartfor	d
hartl	e
hartle	y
hartm	a
hartma	n
harts	h
hartsh	o
hartsho	r
hartshor	n
haru	s
harus	p
harusp	e
haruspe	x
harv	ae
harva	r
harvar	d
harvard	i
harvardi	z
harvardiz	e
harvardize	s
harve	sy
harves	t
harvest	aeils
harvesta	b
harvestab	il
harvestabi	l
harvestabil	i
harvestabili	t
harvestabilit	iy
harvestabiliti	e
harvestabilitie	s
harvestabl	e
harveste	dr
harvester	s
harvesti	n
harvestin	g
harvesting	s
harvestl	e
harvestle	s
harvestles	s
harvey	is
harveyi	z
harveyiz	e
harveyize	s
has	behklpst
hasb	r
hasbr	o
hase	n
hasen	p
hasenp	f
hasenpf	e
hasenpfe	f
hasenpfef	f
hasenpfeff	e
hasenpfeffe	r
hash	eity
hashe	ders
hashee	s
hashees	h
hasheesh	e
hasheeshe	s
hashi	ns
hashin	g
hashis	h
hashish	e
hashishe	s
hasht	a
hashta	g
hask	ei
haske	l
haskel	l
haski	n
haskin	s
hasl	e
hasle	t
hass	lo
hassl	ei
hassle	drs
hassli	n
hasslin	g
hasso	c
hassoc	k
hast	aeiy
hasta	t
hastat	e
haste	dflns
hastef	u
hastefu	l
hasteful	l
hastefull	y
hastel	e
hastele	s
hasteles	s
hasteless	n
hastelessn	e
hastelessne	s
hastelessnes	s
hastelessness	e
hastelessnesse	s
hasten	eis
hastene	dr
hastener	s
hasteni	n
hastenin	g
hasti	eln
hastie	rs
hasties	t
hastil	y
hastin	eg
hastine	s
hastines	s
hastiness	e
hastinesse	s
hasting	s
hat	bcefhilprstv
hatb	a
hatba	n
hatban	d
hatc	h
hatch	abeilmuw
hatcha	b
hatchab	il
hatchabi	l
hatchabil	i
hatchabili	t
hatchabilit	iy
hatchabiliti	e
hatchabilitie	s
hatchabl	e
hatchb	a
hatchba	c
hatchbac	k
hatchback	s
hatche	dlrst
hatcher	sy
hatchet	eils
hatchete	d
hatcheti	n
hatchetin	g
hatchetl	i
hatchetli	k
hatchetlik	e
hatchi	n
hatchin	g
hatchl	i
hatchli	n
hatchlin	g
hatchm	e
hatchme	n
hatchmen	t
hatchu	r
hatchur	e
hatchw	a
hatchwa	y
hate	dfrs
hatef	u
hatefu	l
hateful	ln
hatefull	y
hatefuln	e
hatefulne	s
hatefulnes	s
hatefulness	e
hatefulnesse	s
hater	s
hatf	i
hatfi	e
hatfie	l
hatfiel	d
hath	a
hatha	w
hathaw	a
hathawa	y
hati	n
hatin	g
hatl	ei
hatle	s
hatles	s
hatless	n
hatlessn	e
hatlessne	s
hatlessnes	s
hatlessness	e
hatlessnesse	s
hatli	k
hatlik	e
hatp	i
hatpi	n
hatr	e
hatre	d
hatred	s
hatt	ei
hatte	r
hatter	a
hattera	s
hatti	enz
hattie	s
hatties	b
hattiesb	u
hattiesbu	r
hattiesbur	g
hattin	g
hattiz	e
hattize	s
hau	bglnrst
haub	e
haube	r
hauber	k
haug	eh
hauge	n
haugh	t
haught	iy
haughti	eln
haughtie	rs
haughties	t
haughtil	y
haughtin	e
haughtine	s
haughtines	s
haughtiness	e
haughtinesse	s
haul	aeims
haula	g
haulag	e
haulage	s
haule	dr
hauli	n
haulin	g
haun	ct
haunc	h
haunch	e
haunche	s
haunt	eis
haunte	dr
haunted	n
hauntedn	e
hauntedne	s
hauntednes	s
haunter	s
haunti	n
hauntin	g
haunting	ls
hauntingl	y
haus	ade
hausd	o
hausdo	r
hausdor	f
hausdorf	f
hause	r
haut	b
hautb	o
hautbo	y
hav	aeio
hava	n
havan	a
have	nrs
haven	aeilsw
havena	g
havenag	e
havene	dr
haveni	n
havenin	g
havenl	e
havenle	s
havenles	s
havenw	a
havenwa	r
havenwar	d
haver	s
havers	a
haversa	c
haversac	k
havi	ln
havil	l
havill	a
havilla	n
havillan	d
havin	g
having	s
havo	c
havoc	ks
havock	ei
havocke	dr
havocker	s
havocki	n
havockin	g
haw	aklst
hawa	i
hawai	i
hawaii	a
hawaiia	n
hawk	eilmsw
hawke	dr
hawker	s
hawki	ns
hawkin	gs
hawkis	h
hawkish	ln
hawkishl	y
hawkishn	e
hawkishne	s
hawkishnes	s
hawkishness	e
hawkishnesse	s
hawkl	i
hawkli	k
hawklik	e
hawkm	o
hawkmo	t
hawkmot	h
hawkw	e
hawkwe	e
hawkwee	d
hawl	e
hawle	y
haws	e
hawse	r
hawt	h
hawth	o
hawtho	r
hawthor	n
hawthorn	e
hax	eiux
hay	cdefhilmnsw
hayc	o
hayco	c
haycoc	k
hayd	en
hayde	n
haye	dsy
hayf	io
hayfi	e
hayfie	l
hayfiel	d
hayfo	r
hayfor	k
hayh	v
hayi	n
hayin	g
hayl	o
haylo	f
haylof	t
haym	ao
hayma	k
haymak	e
haymake	r
haymo	w
hayn	e
hayne	s
hays	ht
haysh	a
haysha	k
hayshak	e
hayshake	r
hayst	a
haysta	c
haystac	k
hayw	aio
haywa	r
haywar	d
haywi	r
haywir	e
haywire	s
haywo	o
haywoo	d
haz	aeiy
haza	r
hazar	d
hazard	aeilos
hazarda	b
hazardab	l
hazardabl	e
hazarde	dr
hazarder	s
hazardi	n
hazardin	g
hazardl	e
hazardle	s
hazardles	s
hazardo	u
hazardou	s
hazardous	ln
hazardousl	y
hazardousn	e
hazardousne	s
hazardousnes	s
hazardousness	e
hazardousnesse	s
haze	dlrs
hazel	elns
hazele	s
hazeles	s
hazell	y
hazeln	u
hazelnu	t
hazelnut	s
hazer	s
hazi	eln
hazie	rs
hazies	t
hazil	y
hazin	eg
hazine	s
hazines	s
haziness	e
hazinesse	s
hb	abdehijklnopqruvwxy
hba	sv
hbas	e
hbb	e
hbd	h
hbe	fvw
hbef	v
hbew	v
hbh	akv
hbi	v
hbj	v
hbk	vx
hbn	lmp
hbo	mr
hbom	b
hbor	rsv
hbp	d
hbq	djp
hbqj	v
hbqp	v
hbu	er
hbw	lou
hbx	u
hc	cdefhijklmnoqrtuvw
hcc	v
hcd	j
hce	b
hcf	v
hch	rv
hci	rv
hcj	rv
hcn	mrv
hcq	n
hcr	s
hct	ho
hcu	ah
hcuh	v
hcw	s
hd	abcdefghijklmnopqrstuvwxyz
hda	eoquvx
hdae	v
hdb	dsw
hdbw	v
hdc	fr
hdd	dflruv
hddl	v
hde	mz
hdez	v
hdf	uv
hdg	rv
hdh	dpv
hdj	bkvz
hdk	v
hdl	crsv
hdm	i
hdn	bflmv
hdo	fv
hdq	f
hdr	ksuw
hds	rsv
hdt	rv
hdu	fk
hduk	v
hdv	mp
hdx	rvx
hdy	v
hdz	u
he	abcdefghiklmnoprstuvwxyz
hea	dlprtv
head	abcdeghilmnpqrstwy
heada	c
headac	h
headach	eiy
headache	s
headachi	e
headachie	rs
headachies	t
headb	ao
headba	n
headban	d
headband	s
headbo	a
headboa	r
headboar	d
headc	o
headco	u
headcou	n
headcoun	t
headd	r
headdr	e
headdre	s
headdres	s
heade	drs
header	s
heades	t
headg	e
headge	a
headgea	r
headh	u
headhu	n
headhun	t
headhunt	e
headhunte	r
headhunter	s
headi	eln
headie	rs
headies	t
headil	y
headin	eg
headine	s
headines	s
headiness	e
headinesse	s
heading	s
headl	aeio
headla	n
headlan	d
headland	s
headle	st
headles	s
headless	n
headlessn	e
headlessne	s
headlessnes	s
headli	gkn
headlig	h
headligh	t
headlight	s
headlik	e
headlin	ei
headline	ds
headlines	e
headlini	n
headlinin	g
headlo	cn
headloc	k
headlon	g
headlong	ns
headlongn	e
headlongne	s
headlongnes	s
headlongness	e
headlongnesse	s
headm	aio
headma	ns
headmas	t
headmast	e
headmaste	r
headmaster	ls
headmasterl	y
headmasters	h
headmastersh	i
headmastershi	p
headmastership	s
headmi	s
headmis	t
headmist	r
headmistr	e
headmistre	s
headmistres	s
headmistress	esy
headmistresse	s
headmistresss	h
headmistresssh	i
headmistressshi	p
headmo	s
headmos	t
headn	o
headno	t
headnot	e
headp	h
headph	o
headpho	n
headphon	e
headphone	s
headq	u
headqu	a
headqua	r
headquar	t
headquart	e
headquarte	r
headquarter	es
headquartere	d
headr	eo
headre	s
headres	t
headrest	s
headro	o
headroo	m
headroom	s
heads	ehmpt
headse	t
headset	s
headsh	ir
headshi	p
headshr	i
headshri	n
headshrin	k
headshrink	e
headshrinke	r
headsm	a
headsma	n
headsp	r
headspr	i
headspri	n
headsprin	g
headst	aor
headsta	lnr
headstal	l
headstan	d
headstar	t
headstart	s
headsto	cn
headstoc	k
headston	e
headstone	s
headstr	o
headstro	n
headstron	g
headstrong	ln
headstrongl	y
headstrongn	e
headstrongne	s
headstrongnes	s
headstrongness	e
headstrongnesse	s
headt	e
headte	a
headtea	c
headteac	h
headteach	e
headteache	r
headw	aio
headwa	iy
headwai	t
headwait	e
headwaite	r
headway	s
headwi	n
headwin	d
headwind	s
headwo	r
headwor	dk
headword	s
heal	aeisty
heala	b
healab	l
healabl	e
heale	dry
healer	s
heali	n
healin	g
healt	h
health	cfilswy
healthc	a
healthca	r
healthcar	e
healthf	u
healthfu	l
healthful	ln
healthfull	y
healthfuln	e
healthfulne	s
healthfulnes	s
healthi	eln
healthie	rs
healthies	t
healthil	y
healthin	e
healthine	s
healthines	s
healthiness	e
healthinesse	s
healthl	e
healthle	s
healthles	s
healthw	a
healthwa	r
healthwar	d
heap	eisy
heape	dr
heaper	s
heapi	en
heapie	rs
heapies	t
heapin	g
hear	adeikst
heara	b
hearab	l
hearabl	e
heare	rs
hearer	s
heares	t
heari	n
hearin	g
hearing	ls
hearingl	e
hearingle	s
hearingles	s
heark	e
hearke	n
hears	aeity
hearsa	y
hearsay	s
hearse	dls
hearsel	i
hearseli	k
hearselik	e
hearsi	n
hearsin	g
heart	abefhilrswy
hearta	c
heartac	h
heartach	ei
heartache	s
heartachi	n
heartachin	g
heartb	eru
heartbe	a
heartbea	t
heartbeat	s
heartbr	eo
heartbre	a
heartbrea	k
heartbreak	is
heartbreaki	n
heartbreakin	g
heartbro	k
heartbrok	e
heartbroke	n
heartbroken	ln
heartbrokenl	y
heartbrokenn	e
heartbrokenne	s
heartbrokennes	s
heartbrokenness	e
heartbrokennesse	s
heartbu	r
heartbur	n
heartburn	is
heartburni	n
heartburnin	g
hearte	dn
hearten	eis
heartene	dr
heartener	s
hearteni	n
heartenin	g
heartening	l
hearteningl	y
heartf	eu
heartfe	l
heartfel	t
heartfu	l
heartful	ln
heartfull	y
heartfuln	e
heartfulne	s
heartfulnes	s
hearth	lrs
hearthl	e
hearthle	s
hearthles	s
hearthr	u
hearthru	g
hearths	it
hearthsi	d
hearthsid	e
hearthst	o
hearthsto	n
hearthston	e
hearti	eln
heartie	rs
hearties	t
heartil	y
heartin	eg
heartine	s
heartines	s
heartiness	e
heartinesse	s
heartl	aei
heartla	n
heartlan	d
heartland	s
heartle	s
heartles	s
heartless	ln
heartlessl	y
heartlessn	e
heartlessne	s
heartlessnes	s
heartlessness	e
heartlessnesse	s
heartli	kn
heartlik	e
heartlin	g
heartr	e
heartre	n
heartren	d
heartrend	i
heartrendi	n
heartrendin	g
hearts	iot
heartsi	c
heartsic	k
heartso	r
heartsor	e
heartst	r
heartstr	i
heartstri	n
heartstrin	g
heartstring	s
heartw	io
heartwi	s
heartwis	e
heartwo	o
heartwoo	d
heat	aefhilsw
heata	b
heatab	l
heatabl	e
heate	dr
heated	ln
heatedl	y
heatedn	e
heatedne	s
heatednes	s
heatedness	e
heatednesse	s
heater	s
heatf	u
heatfu	l
heath	eiklmrsy
heathe	nr
heathen	dhilns
heathend	o
heathendo	m
heathendom	s
heathenh	o
heathenho	o
heathenhoo	d
heathenhood	s
heatheni	sz
heathenis	ehm
heathenism	s
heatheniz	ei
heathenize	ds
heathenizi	n
heathenizin	g
heathenl	y
heathenn	e
heathenne	s
heathennes	s
heathenness	e
heathennesse	s
heathens	h
heathensh	i
heathenshi	p
heathenship	s
heather	es
heathere	d
heathi	e
heathie	rs
heathies	t
heathk	i
heathki	t
heathl	ei
heathle	s
heathles	s
heathli	k
heathlik	e
heathm	a
heathma	n
heathr	o
heathro	w
heati	n
heatin	g
heating	s
heatl	ei
heatle	s
heatles	s
heatli	k
heatlik	e
heats	t
heatst	r
heatstr	o
heatstro	k
heatstrok	e
heatstroke	s
heatw	a
heatwa	v
heatwav	e
heatwave	s
heav	eiy
heave	dlnrs
heavel	e
heavele	s
heaveles	s
heaven	lsw
heavenl	eiy
heavenle	s
heavenles	s
heavenli	ekn
heavenlie	rs
heavenlies	t
heavenlik	e
heavenlin	e
heavenline	s
heavenlines	s
heavenliness	e
heavenlinesse	s
heavens	e
heavense	s
heavenw	a
heavenwa	r
heavenwar	d
heaver	s
heavi	elno
heavie	drs
heavies	t
heavil	y
heavin	eg
heavine	s
heavines	s
heaviness	e
heavinesse	s
heavio	s
heavios	i
heaviosi	t
heaviosit	y
heavy	isw
heavyi	ns
heavyin	g
heavyis	h
heavys	e
heavyse	t
heavyw	e
heavywe	i
heavywei	g
heavyweig	h
heavyweigh	t
heavyweight	s
heb	der
hebd	o
hebdo	m
hebdom	a
hebdoma	d
hebr	aei
hebra	i
hebrai	csz
hebraic	i
hebraici	z
hebraiciz	e
hebraicize	s
hebrais	et
hebraiz	e
hebre	w
hebrew	s
hebri	d
hebrid	e
hebride	s
hec	aktu
heca	t
hecat	e
heck	lm
heckl	ei
heckle	drs
heckler	s
heckli	n
hecklin	g
heckm	a
heckma	n
hect	aio
hecta	r
hectar	ae
hectara	g
hectarag	e
hectare	s
hecti	c
hectic	aln
hectica	l
hectical	l
hecticall	y
hecticl	y
hecticn	e
hecticne	s
hecticnes	s
hecticness	e
hecticnesse	s
hecto	gr
hectog	r
hectogr	a
hectogra	mp
hectograp	h
hecu	b
hecub	a
hed	dego
hedd	a
hede	v
hedg	ei
hedge	dhlrs
hedgeh	o
hedgeho	gp
hedgehog	gs
hedgehogg	y
hedgel	e
hedgele	s
hedgeles	s
hedger	os
hedgero	w
hedgerow	s
hedgi	n
hedgin	g
hedging	l
hedgingl	y
hedo	n
hedon	i
hedoni	cs
hedonis	mt
hedonist	i
hedonisti	c
hee	dhlmv
heed	efilsy
heede	dr
heeder	s
heedf	u
heedfu	l
heedi	ln
heedil	y
heedin	eg
heedine	s
heedines	s
heedl	e
heedle	s
heedles	s
heedless	ln
heedlessl	y
heedlessn	e
heedlessne	s
heedlessnes	s
heeh	av
heeha	w
heel	beilps
heelb	a
heelba	l
heelbal	l
heele	dr
heeler	s
heeli	n
heelin	g
heell	e
heelle	s
heelles	s
heelp	i
heelpi	e
heelpie	c
heelpiec	e
heem	v
hef	alt
heft	iy
hefti	eln
heftie	rs
hefties	t
heftil	y
heftin	e
heftine	s
heftines	s
heftiness	e
heftinesse	s
heg	eiuv
hege	lm
hegel	i
hegeli	a
hegelia	n
hegelian	i
hegeliani	z
hegelianiz	e
hegelianize	s
hegem	o
hegemo	n
hegemon	iy
hegemoni	ce
hegemonie	s
hegi	r
hegir	a
heh	e
hei	adfghlnrs
heid	eiv
heide	gl
heideg	g
heidegg	e
heidegge	r
heidel	b
heidelb	e
heidelbe	r
heidelber	g
heif	e
heife	r
heifer	s
heig	h
heigh	t
height	es
heighte	n
heighten	eis
heightene	dr
heightener	s
heighteni	n
heightenin	g
heih	v
hein	elorz
heinl	e
heinle	i
heinlei	n
heino	u
heinou	s
heinous	l
heinousl	y
heinr	i
heinri	c
heinric	h
heinz	e
heir	eils
heire	ds
heires	s
heiress	e
heiresse	s
heiri	n
heirin	g
heirl	o
heirlo	o
heirloo	m
heirloom	s
heirs	h
heirsh	i
heirshi	p
heirship	s
heis	et
heise	nr
heisen	b
heisenb	e
heisenbe	r
heisenber	g
heist	e
heiste	r
hek	v
hel	adegilmopsv
hele	n
helen	ae
helg	a
heli	cmoptux
helic	ao
helica	l
helico	inp
helicoi	d
helicop	t
helicopt	e
helicopte	r
helicopter	eis
helicoptere	d
helicopteri	n
helicopterin	g
helim	a
helima	g
helimag	n
helimagn	e
helimagne	t
helimagnet	i
helimagneti	s
helimagnetis	m
helio	cgpst
helioc	eh
helioce	n
heliocen	t
heliocent	r
heliocentr	i
heliocentri	c
helioch	r
heliochr	o
heliochro	m
heliochrom	e
heliog	r
heliogr	a
heliogra	p
heliograp	h
heliop	o
heliopo	l
heliopol	i
heliopoli	s
heliot	hry
helioth	e
heliothe	r
heliother	a
heliothera	p
heliotherap	y
heliotr	o
heliotro	p
heliotrop	ei
heliotropi	cs
heliotropis	m
helioty	p
heliotyp	e
helip	o
helipo	r
helipor	t
helit	r
helitr	o
helitro	n
heliu	m
helium	s
helix	e
helixe	s
hell	bcefhimosw
hellb	e
hellbe	n
hellben	d
hellbend	e
hellbende	r
hellc	a
hellca	t
helle	ns
hellen	ei
helleni	csz
hellenis	emt
hellenist	i
hellenisti	c
helleniz	aei
helleniza	t
hellenizat	i
hellenizati	o
hellenizatio	n
hellenization	s
hellenize	ds
hellenizi	n
hellenizin	g
helles	p
hellesp	o
hellespo	n
hellespon	t
hellf	iu
hellfi	r
hellfir	e
hellfu	l
hellh	o
hellho	l
hellhol	e
helli	os
hellio	n
hellis	h
hellish	ln
hellishl	y
hellishn	e
hellishne	s
hellishnes	s
hellishness	e
hellishnesse	s
hellm	a
hellma	n
hello	eis
helloe	ds
helloi	n
helloin	g
hellw	a
hellwa	r
hellwar	d
helm	ehilsu
helme	drt
helmet	ils
helmeti	n
helmetin	g
helmetl	ei
helmetle	s
helmetles	s
helmetli	k
helmetlik	e
helmh	o
helmho	l
helmhol	t
helmholt	z
helmi	n
helmin	gt
helmint	h
helminth	i
helminthi	c
helml	e
helmle	s
helmles	s
helms	mw
helmsm	a
helmsma	n
helmsw	o
helmswo	m
helmswom	a
helmswoma	n
helmu	t
helo	t
helot	r
helotr	y
help	adefilms
helpa	b
helpab	l
helpabl	e
helpd	e
helpde	s
helpdes	k
helpe	dr
helper	s
helpf	u
helpfu	l
helpful	ln
helpfull	y
helpfuln	e
helpfulne	s
helpfulnes	s
helpfulness	e
helpfulnesse	s
helpi	n
helpin	g
helping	ls
helpingl	y
helpl	eiy
helple	s
helples	s
helpless	ln
helplessl	y
helplessn	e
helplessne	s
helplessnes	s
helplessness	e
helplessnesse	s
helpli	n
helplin	e
helpline	s
helpm	a
helpma	t
helpmat	e
hels	i
helsi	n
helsin	k
helsink	i
helv	e
helve	t
helvet	i
helveti	c
helvetic	a
hem	ailmopsv
hema	lt
hemat	io
hemati	cnt
hematit	ei
hematite	s
hematiti	c
hemato	l
hematol	o
hematolo	g
hematolog	y
hemi	cmnps
hemic	y
hemicy	c
hemicyc	l
hemicycl	e
hemim	o
hemimo	r
hemimor	p
hemimorp	h
hemimorph	i
hemimorphi	c
hemin	g
heming	w
hemingw	a
hemingwa	y
hemip	lt
hemipl	e
hemiple	g
hemipleg	i
hemiplegi	a
hemipt	e
hemipte	r
hemipter	o
hemiptero	u
hemipterou	s
hemis	pt
hemisp	h
hemisph	e
hemisphe	r
hemispher	ae
hemisphera	l
hemisphere	ds
hemist	i
hemisti	c
hemistic	h
heml	io
hemli	n
hemlin	e
hemlo	c
hemloc	k
hemlock	s
hemm	ei
hemme	dr
hemmer	s
hemmi	n
hemmin	g
hemo	glprs
hemog	l
hemogl	o
hemoglo	b
hemoglob	i
hemoglobi	n
hemol	y
hemoly	s
hemolys	i
hemolysi	s
hemop	h
hemoph	i
hemophi	l
hemophil	i
hemophili	a
hemophilia	c
hemor	r
hemorr	h
hemorrh	ao
hemorrha	g
hemorrhag	e
hemorrho	i
hemorrhoi	d
hemorrhoid	s
hemos	t
hemost	a
hemosta	t
hemostat	s
hemp	els
hempe	n
hempl	i
hempli	k
hemplik	e
hemps	t
hempst	e
hempste	a
hempstea	d
hems	t
hemst	i
hemsti	t
hemstit	c
hemstitc	h
hen	bcdhlnprstvy
henb	a
henba	n
henban	e
henc	eho
hence	f
hencef	o
hencefo	r
hencefor	tw
hencefort	h
henceforw	a
henceforwa	r
henceforwar	d
hench	mw
henchm	ae
henchma	n
henchman	s
henchmans	h
henchmansh	i
henchmanshi	p
henchmanship	s
henchme	n
henchw	o
henchwo	m
henchwom	a
henchwoma	n
henco	o
hencoo	p
hend	er
hende	cr
hendec	a
hendeca	s
hendecas	y
hendecasy	l
hendecasyl	l
hendecasyll	a
hendecasylla	b
hendecasyllab	l
hendecasyllabl	e
hender	s
henders	o
henderso	n
hendr	i
hendri	cx
hendric	k
hendrick	s
hendricks	o
hendrickso	n
henh	o
henho	u
henhou	s
henhous	e
henl	ei
henle	y
henli	k
henlik	e
henn	aei
henna	eis
hennae	d
hennai	n
hennain	g
henne	rs
henner	y
hennes	s
henness	ey
hennesse	y
henni	ns
hennin	g
hennis	h
henp	e
henpe	c
henpec	k
henpeck	ei
henpecke	d
henpecki	n
henpeckin	g
henpecking	s
henr	ioy
henri	e
henrie	t
henriet	t
henriett	a
henro	o
henroo	s
henroos	t
hent	a
henta	i
heo	q
heoq	v
hep	abcpstv
hepa	rt
hepar	i
hepari	n
hepat	io
hepati	ct
hepatic	as
hepatica	l
hepatit	i
hepatiti	ds
hepatitid	e
hepatitide	s
hepatitis	e
hepatitise	s
hepato	m
hepatom	e
hepatome	g
hepatomeg	a
hepatomega	l
hepatomegal	y
hepb	u
hepbu	r
hepbur	n
hepc	a
hepca	t
hepp	i
heppi	n
heppin	g
hept	ao
hepta	bdgmr
heptab	a
heptaba	s
heptabas	e
heptag	o
heptago	n
heptagon	as
heptagona	l
heptam	e
heptame	t
heptamet	e
heptamete	r
heptar	c
heptarc	h
heptarch	y
hepto	d
heptod	e
her	abcdeikmnoprstz
hera	cln
herac	l
heracl	i
heracli	t
heraclit	u
heraclitu	s
heral	d
herald	eirs
heralde	d
heraldi	cns
heraldin	g
heraldis	t
heraldist	s
heraldr	iy
heraldri	e
heraldrie	s
herb	aeilsy
herba	cgl
herbac	e
herbace	o
herbaceo	u
herbaceou	s
herbaceous	l
herbaceousl	y
herbag	e
herbal	ils
herbali	s
herbalis	t
herball	y
herbe	r
herber	t
herbi	cev
herbic	i
herbici	d
herbicid	ae
herbicida	l
herbicidal	l
herbicidall	y
herbicide	s
herbie	rs
herbies	t
herbiv	o
herbivo	r
herbivor	eo
herbivore	s
herbivoro	u
herbivorou	s
herbl	i
herbli	k
herblik	e
herc	u
hercu	l
hercul	e
hercule	as
herculea	n
herd	beils
herdb	o
herdbo	o
herdboo	k
herde	dr
herdi	n
herdin	g
herdl	i
herdli	k
herdlik	e
herds	m
herdsm	ae
herdsma	n
herdsman	s
herdsmans	h
herdsmansh	i
herdsmanshi	p
herdsme	n
here	abdfinorstuw
herea	bft
hereab	o
hereabo	u
hereabou	t
hereabout	s
hereaf	t
hereaft	e
hereafte	r
hereafter	s
hereb	y
hered	i
heredi	t
heredit	aiy
heredita	r
hereditar	iy
hereditari	ln
hereditaril	y
hereditarin	e
hereditarine	s
hereditarines	s
hereditariness	e
hereditarinesse	s
herediti	e
hereditie	s
heref	o
herefo	r
herefor	d
herei	n
herein	at
hereina	f
hereinaf	t
hereinaft	e
hereinafte	r
hereint	o
heren	e
herene	s
herenes	s
hereo	fn
heres	ity
heresi	e
heresie	s
heret	io
hereti	c
heretic	as
heretica	l
hereto	f
heretof	o
heretofo	r
heretofor	e
hereu	n
hereun	dt
hereund	e
hereunde	r
hereunt	o
herew	i
herewi	t
herewit	h
heri	ot
herio	n
herit	a
herita	g
heritag	e
heritage	s
herk	i
herki	m
herkim	e
herkime	r
herm	aeio
herma	np
herman	n
hermap	h
hermaph	r
hermaphr	o
hermaphro	d
hermaphrod	i
hermaphrodi	t
hermaphrodit	ei
hermaphrodite	s
hermaphroditi	cs
hermaphroditic	a
hermaphroditica	l
hermaphroditical	l
hermaphroditicall	y
hermaphroditis	hm
hermaphroditism	s
herme	nst
hermen	e
hermene	u
hermeneu	t
hermeneut	i
hermeneuti	c
hermet	i
hermeti	c
hermetic	a
hermetica	l
hermetical	l
hermeticall	y
hermi	t
hermit	ehilrs
hermite	s
hermites	s
hermith	o
hermitho	o
hermithoo	d
hermiti	acs
hermitia	n
hermitic	a
hermitica	l
hermitical	l
hermiticall	y
hermitis	hm
hermitism	s
hermitl	i
hermitli	k
hermitlik	e
hermitr	ei
hermitre	s
hermitres	s
hermitri	e
hermitrie	s
hermits	h
hermitsh	i
hermitshi	p
hermitship	s
hermo	s
hermos	a
hern	ai
herna	n
hernan	d
hernand	e
hernande	z
herni	a
hernia	elst
herniat	ei
herniati	o
herniatio	n
hero	deilnos
herod	o
herodo	t
herodot	u
herodotu	s
heroe	s
heroes	s
heroi	cfnsz
heroic	ains
heroica	l
heroical	ln
heroicall	y
heroicaln	e
heroicalne	s
heroicalnes	s
heroicalness	e
heroicalnesse	s
heroici	t
heroicit	i
heroiciti	e
heroicitie	s
heroicn	e
heroicne	s
heroicnes	s
heroicness	e
heroicnesse	s
heroif	y
heroin	eis
heroine	s
heroines	h
heroinesh	i
heroineshi	p
heroini	s
heroinis	m
heroinism	s
herois	m
heroism	s
heroiz	e
herol	i
heroli	k
herolik	e
heron	s
heroo	l
herool	o
heroolo	g
heroolog	y
heros	h
herosh	i
heroshi	p
herp	e
herpe	st
herpes	e
herpese	s
herpet	o
herpeto	l
herpetol	o
herpetolo	g
herpetolog	y
herr	i
herri	n
herrin	g
herring	blst
herringb	o
herringbo	n
herringbon	ei
herringbone	ds
herringboni	n
herringbonin	g
herringl	i
herringli	k
herringlik	e
herringt	o
herringto	n
hers	ceh
hersc	h
hersch	e
hersche	l
herse	ly
hersel	f
hersh	e
hershe	ly
hert	fz
hertf	o
hertfo	r
hertfor	d
hertford	s
hertfords	h
hertfordsh	i
hertfordshi	r
hertfordshir	e
hertz	eo
hertze	s
hertzo	g
herz	e
herze	g
herzeg	o
herzego	v
herzegov	i
herzegovi	n
herzegovin	a
hes	ipst
hesi	t
hesit	a
hesita	nt
hesitan	ct
hesitanc	e
hesitant	l
hesitantl	y
hesitat	eio
hesitate	drs
hesitater	s
hesitati	nov
hesitatin	g
hesitating	l
hesitatingl	y
hesitatio	n
hesitation	s
hesitativ	e
hesitative	l
hesitativel	y
hesitato	r
hesitator	sy
hesp	e
hespe	r
hesper	iu
hesperi	a
hesperia	n
hesperu	s
hess	ei
hessi	a
hessia	n
hessian	s
hest	e
heste	r
het	emrt
hete	r
heter	ao
hetera	cu
heterac	a
heteraca	n
heteracan	t
heteracant	h
heterau	x
heteraux	e
heterauxe	s
heterauxes	i
heterauxesi	s
hetero	bcdglmnpstz
heterob	l
heterobl	a
heterobla	s
heteroblas	t
heteroblast	i
heteroblasti	c
heteroc	aho
heteroca	r
heterocar	p
heterocarp	o
heterocarpo	u
heterocarpou	s
heteroch	lr
heterochl	a
heterochla	m
heterochlam	y
heterochlamy	d
heterochlamyd	e
heterochlamyde	o
heterochlamydeo	u
heterochlamydeou	s
heterochr	o
heterochro	mn
heterochrom	io
heterochromi	ac
heterochromo	s
heterochromos	o
heterochromoso	m
heterochromosom	e
heterochron	i
heterochroni	c
heteroco	s
heterocos	m
heterod	io
heterodi	m
heterodim	e
heterodime	r
heterodo	x
heterodox	y
heterog	el
heteroge	n
heterogen	eo
heterogene	ios
heterogenei	t
heterogeneit	y
heterogeneo	u
heterogeneou	s
heterogeneous	ln
heterogeneousl	y
heterogeneousn	e
heterogeneousne	s
heterogeneousnes	s
heterogeneousness	e
heterogeneousnesse	s
heterogenes	i
heterogenesi	s
heterogeno	u
heterogenou	s
heterogl	o
heteroglo	s
heteroglos	s
heterogloss	i
heteroglossi	c
heterol	o
heterolo	g
heterolog	y
heterom	o
heteromo	r
heteromor	p
heteromorp	h
heteromorph	i
heteromorphi	c
heteron	ouy
heterono	m
heteronom	y
heteronu	c
heteronuc	l
heteronucl	e
heteronucle	a
heteronuclea	r
heterony	m
heterop	h
heteroph	ao
heteropha	s
heterophas	i
heterophasi	a
heteropho	r
heterophor	i
heterophori	c
heteros	cepuy
heterosc	e
heterosce	d
heterosced	a
heterosceda	s
heteroscedas	t
heteroscedast	i
heteroscedasti	c
heterose	x
heterosex	u
heterosexu	a
heterosexua	l
heterosexual	ils
heterosexuali	t
heterosexualit	iy
heterosexualiti	e
heterosexualitie	s
heterosexuall	y
heterosp	eo
heterospe	c
heterospec	i
heterospeci	f
heterospecif	i
heterospecifi	c
heterospo	lr
heterospol	a
heterospola	r
heterospor	i
heterospori	c
heterosu	g
heterosug	g
heterosugg	e
heterosugge	s
heterosugges	t
heterosuggest	i
heterosuggesti	o
heterosuggestio	n
heterosy	l
heterosyl	l
heterosyll	a
heterosylla	b
heterosyllab	i
heterosyllabi	c
heterot	h
heteroth	e
heterothe	r
heterother	m
heterotherm	iy
heterothermi	c
heteroz	y
heterozy	g
heterozyg	o
heterozygo	tu
heterozygot	ei
heterozygote	ds
heterozygoti	c
heterozygou	s
hetm	a
hetma	n
hett	iy
hetti	e
heu	brs
heub	l
heubl	e
heuble	i
heublei	n
heur	i
heuri	s
heuris	t
heurist	i
heuristi	c
heuristic	as
heuristica	l
heuristical	l
heuristicall	y
heus	e
heuse	nr
hev	cv
hew	deilsu
hewe	drt
hewet	t
hewi	t
hewit	t
hewl	e
hewle	t
hewlet	t
hex	ao
hexa	cdeghmnprst
hexac	ah
hexaca	n
hexacan	t
hexacant	h
hexach	l
hexachl	o
hexachlo	r
hexachlor	a
hexachlora	p
hexachlorap	h
hexachloraph	a
hexachlorapha	n
hexachloraphan	e
hexad	aei
hexada	c
hexadac	t
hexadact	y
hexadacty	l
hexadactyl	i
hexadactyli	s
hexadactylis	m
hexade	c
hexadec	ai
hexadeca	p
hexadecap	o
hexadecapo	l
hexadecapol	e
hexadeci	m
hexadecim	a
hexadecima	l
hexadi	c
hexae	m
hexaem	e
hexaeme	r
hexaemer	i
hexaemeri	c
hexag	o
hexago	n
hexagon	aos
hexagona	l
hexagonal	l
hexagonall	y
hexagono	u
hexagonou	s
hexah	e
hexahe	d
hexahed	r
hexahedr	ao
hexahedra	l
hexahedro	n
hexam	e
hexame	rt
hexamer	i
hexameri	cs
hexameris	m
hexamet	aeh
hexameta	p
hexametap	h
hexametaph	o
hexametapho	s
hexametaphos	p
hexametaphosp	h
hexametaphosph	a
hexametaphospha	t
hexametaphosphat	e
hexamete	r
hexameth	y
hexamethy	l
hexamethyl	e
hexamethyle	n
hexamethylen	e
hexamethylene	d
hexamethylened	i
hexamethylenedi	a
hexamethylenedia	m
hexamethylenediam	i
hexamethylenediami	n
hexamethylenediamin	e
hexan	d
hexand	r
hexandr	o
hexandro	u
hexandrou	s
hexap	eho
hexape	pt
hexapep	t
hexapept	i
hexapepti	d
hexapeptid	e
hexapet	a
hexapeta	l
hexapetal	o
hexapetalo	u
hexapetalou	s
hexaph	a
hexapha	s
hexaphas	e
hexapo	d
hexar	c
hexarc	h
hexas	et
hexase	p
hexasep	a
hexasepa	l
hexasepal	o
hexasepalo	u
hexasepalou	s
hexast	i
hexasti	c
hexastic	h
hexastich	i
hexastichi	c
hexat	eo
hexate	u
hexateu	c
hexateuc	h
hexato	mn
hexatom	i
hexatomi	c
hexaton	i
hexatoni	c
hexo	d
hexod	e
hey	dw
heyd	ae
heyda	y
heyday	s
heyde	y
heydey	s
heyw	o
heywo	o
heywoo	d
hez	v
hf	abcdefghjklmnosvwy
hfa	dv
hfb	u
hfd	dgv
hfe	dkv
hff	bdhkrsv
hffk	v
hfg	v
hfh	v
hfl	v
hfm	bv
hfn	fv
hfo	o
hfv	z
hfw	v
hfy	g
hg	ijlmnopquvwx
hgi	v
hgj	frsv
hgl	rv
hgm	r
hgn	fhov
hgno	v
hgo	rsv
hgp	su
hgq	d
hgv	s
hgw	v
hh	acdefhkmnprsuvxz
hhc	l
hhcl	u
hhclu	b
hhd	d
hhe	frv
hhh	hstv
hhk	b
hhm	b
hhn	p
hhp	v
hhx	rv
hi	abcdegjklmnpqrstvy
hia	tw
hiat	tu
hiatu	s
hiaw	a
hiawa	t
hiawat	h
hiawath	a
hib	bei
hibb	a
hibba	r
hibbar	d
hibe	r
hiber	n
hibern	ai
hiberna	lnt
hibernan	t
hibernat	eio
hibernate	ds
hibernati	no
hibernatin	g
hibernatio	n
hibernation	s
hibernato	r
hibernator	s
hiberni	a
hibi	s
hibis	c
hibisc	u
hibiscu	s
hic	ack
hica	r
hicc	ou
hicco	u
hiccou	g
hiccoug	h
hiccough	eis
hiccoughe	d
hiccoughi	n
hiccoughin	g
hiccu	p
hiccup	eips
hiccupe	d
hiccupi	n
hiccupin	g
hiccupp	ei
hiccuppe	d
hiccuppi	n
hiccuppin	g
hick	emos
hicke	y
hickey	s
hickm	a
hickma	n
hicko	kr
hickor	y
hid	adei
hida	bl
hidab	il
hidabi	l
hidabil	i
hidabili	t
hidabilit	iy
hidabiliti	e
hidabilitie	s
hidabl	e
hidal	g
hidalg	o
hidd	e
hidde	n
hide	abdlors
hidea	w
hideaw	a
hideawa	y
hideaway	s
hideb	o
hidebo	u
hidebou	n
hideboun	d
hidel	e
hidele	s
hideles	s
hideo	su
hideos	i
hideosi	t
hideosit	i
hideositi	e
hideositie	s
hideou	st
hideous	ln
hideousl	y
hideousn	e
hideousne	s
hideousnes	s
hideousness	e
hideousnesse	s
hideout	s
hider	s
hidi	n
hidin	g
hiding	s
hie	rs
hier	ao
hiera	rt
hierar	c
hierarc	h
hierarch	aiy
hierarcha	l
hierarchi	cesz
hierarchic	a
hierarchica	l
hierarchical	l
hierarchicall	y
hierarchie	s
hierarchis	t
hierarchiz	a
hierarchiza	t
hierarchizat	i
hierarchizati	o
hierarchizatio	n
hierat	i
hierati	c
hiero	gnp
hierog	l
hierogl	y
hierogly	p
hieroglyp	h
hieroglyph	i
hieroglyphi	c
hieroglyphic	s
hieron	y
hierony	m
hieronym	u
hieronymu	s
hierop	h
hieroph	a
hieropha	n
hierophan	t
hies	t
hig	gh
higg	i
higgi	n
higgin	s
high	bcefjlnstw
highb	or
highbo	ry
highbor	n
highbr	eo
highbre	d
highbro	w
highbrow	eis
highbrowe	d
highbrowi	s
highbrowis	hm
highbrowism	s
highc	o
highco	mu
highcom	m
highcomm	i
highcommi	s
highcommis	s
highcommiss	i
highcommissi	o
highcommissio	n
highcommission	e
highcommissione	r
highcou	r
highcour	t
highcourt	o
highcourto	f
highcourtof	j
highcourtofj	u
highcourtofju	s
highcourtofjus	t
highcourtofjust	i
highcourtofjusti	c
highcourtofjustic	e
highe	rs
highes	t
highf	i
highfi	e
highfie	l
highfiel	d
highj	a
highja	c
highjac	k
highjack	eis
highjacke	d
highjacki	n
highjackin	g
highl	aiy
highla	n
highlan	d
highland	eis
highlande	r
highlandi	s
highlandis	h
highli	g
highlig	h
highligh	t
highlight	eis
highlighte	dr
highlighter	s
highlighti	n
highlightin	g
highn	e
highne	s
highnes	s
highness	e
highnesse	s
highs	i
highsi	e
highsie	r
highsier	r
highsierr	a
hight	e
highte	e
hightee	n
highw	a
highwa	y
highway	ms
highwaym	ae
highwayma	n
highwayme	n
hij	av
hija	c
hijac	k
hijack	eis
hijacke	dr
hijacker	s
hijacki	n
hijackin	g
hik	ei
hike	drs
hiker	s
hiki	n
hikin	g
hil	abdflt
hila	r
hilar	iy
hilari	ot
hilario	u
hilariou	s
hilarious	ln
hilariousl	y
hilariousn	e
hilariousne	s
hilariousnes	s
hilariousness	e
hilariousnesse	s
hilarit	iy
hilariti	e
hilaritie	s
hilb	e
hilbe	r
hilber	t
hild	e
hilde	b
hildeb	r
hildebr	a
hildebra	n
hildebran	d
hilf	i
hilfi	g
hilfig	e
hilfige	r
hill	abceiosty
hilla	r
hillar	y
hillb	i
hillbi	l
hillbil	l
hillbill	y
hillc	r
hillcr	e
hillcre	s
hillcres	t
hille	dlr
hiller	s
hilli	en
hillie	rs
hillies	t
hillin	eg
hilline	s
hillines	s
hilliness	e
hillinesse	s
hillo	c
hilloc	k
hillock	esy
hillocke	d
hills	bdi
hillsb	o
hillsbo	r
hillsbor	o
hillsd	a
hillsda	l
hillsdal	e
hillsi	d
hillsid	e
hillside	s
hillt	o
hillto	p
hilltop	ps
hilltopp	ei
hilltoppe	dr
hilltopper	s
hilltoppi	n
hilltoppin	g
hilt	eilos
hilte	d
hilti	n
hiltin	g
hiltl	e
hiltle	s
hiltles	s
hilto	n
him	abmsy
hima	l
himal	a
himala	y
himalay	a
himalaya	ns
himm	l
himml	e
himmle	r
hims	e
himse	l
himsel	f
himy	a
himya	r
himyar	i
himyari	c
hin	degkmost
hind	beimoqrsu
hindb	r
hindbr	a
hindbra	i
hindbrai	n
hinde	r
hinder	eils
hindere	dr
hinderer	s
hinderi	n
hinderin	g
hindering	l
hinderingl	y
hinderl	i
hinderli	n
hinderlin	g
hinders	o
hinderso	m
hindersom	e
hindi	s
hindm	o
hindmo	s
hindmos	t
hindo	o
hindoo	s
hindq	u
hindqu	a
hindqua	r
hindquar	t
hindquart	e
hindquarte	r
hindquarter	s
hindr	a
hindra	n
hindran	c
hindranc	e
hindrance	s
hinds	i
hindsi	g
hindsig	h
hindsigh	t
hindsight	es
hindsighte	d
hindu	is
hindui	s
hinduis	m
hinduism	s
hindus	t
hindust	a
hindusta	n
hindustan	i
hine	st
hing	ei
hinge	dils
hingei	n
hingein	g
hingel	i
hingeli	k
hingelik	e
hingi	n
hingin	g
hink	l
hinkl	e
hinm	a
hinma	n
hins	d
hinsd	a
hinsda	l
hinsdal	e
hint	eis
hinte	dr
hinter	ls
hinterl	a
hinterla	n
hinterlan	d
hinterland	s
hinti	n
hintin	g
hip	belnps
hipb	o
hipbo	n
hipbon	e
hipl	eiy
hiple	s
hiples	s
hipli	k
hiplik	e
hipn	e
hipne	s
hipnes	s
hipp	eioy
hippe	s
hippes	t
hippi	en
hippie	dhins
hippied	o
hippiedo	m
hippiedom	s
hippieh	o
hippieho	o
hippiehoo	d
hippiei	s
hippieis	h
hippien	e
hippiene	s
hippienes	s
hippieness	e
hippienesse	s
hippin	eg
hippine	s
hippines	s
hippiness	e
hippinesse	s
hippo	cp
hippoc	r
hippocr	ae
hippocra	t
hippocrat	ei
hippocrate	s
hippocrati	c
hippocre	n
hippocren	e
hippop	o
hippopo	t
hippopot	a
hippopota	m
hippopotam	iu
hippopotami	dn
hippopotamin	e
hippopotamu	s
hippopotamus	e
hippopotamuse	s
hips	t
hipst	e
hipste	r
hiq	v
hir	aeios
hira	bm
hirab	l
hirabl	e
hire	adelrsy
hirea	b
hireab	l
hireabl	e
hiree	s
hirel	e
hirele	s
hireles	s
hirer	s
hiri	n
hirin	g
hiring	s
hiro	s
hiros	h
hirosh	i
hiroshi	m
hiroshim	a
hirs	cu
hirsc	h
hirsu	t
hirsut	e
his	epst
hise	n
hisen	s
hisens	e
hisp	ai
hispa	n
hispan	i
hispani	c
hispanic	is
hispanici	z
hispaniciz	e
hispanicize	s
hispi	d
hiss	ei
hisse	drs
hisser	s
hissi	n
hissin	g
hissing	l
hissingl	y
hist	aor
hista	m
histam	i
histami	n
histamin	eis
histamine	s
histamini	c
histo	glr
histog	r
histogr	a
histogra	m
histogram	s
histol	o
histolo	g
histolog	y
histor	iy
histori	aceo
historia	n
historian	s
historic	ai
historica	l
historical	ln
historicall	y
historicaln	e
historicalne	s
historicalnes	s
historicalness	e
historicalnesse	s
historici	t
historicit	y
historie	s
historio	g
historiog	r
historiogr	a
historiogra	p
historiograp	h
historiograph	ey
historiographe	r
histr	i
histri	o
histrio	n
histrion	i
histrioni	c
hit	achlst
hita	c
hitac	h
hitach	i
hitc	h
hitch	cehi
hitchc	o
hitchco	c
hitchcoc	k
hitche	drs
hitcher	s
hitchh	i
hitchhi	k
hitchhik	ei
hitchhike	drs
hitchhiker	s
hitchhiki	n
hitchhikin	g
hitchi	ln
hitchil	y
hitchin	eg
hitchine	s
hitchines	s
hith	e
hithe	r
hither	t
hithert	o
hitl	e
hitle	rs
hitler	i
hitleri	ast
hitleria	n
hitleris	m
hitlerit	e
hitlerite	s
hitles	s
hitt	aei
hitta	b
hittab	l
hittabl	e
hitte	r
hitter	s
hitti	nt
hittin	g
hittit	e
hiv	eis
hive	dlrs
hivel	ei
hivele	s
hiveles	s
hiveli	k
hivelik	e
hiver	s
hivi	n
hivin	g
hiy	a
hj	abcdefgjlmnopqruvx
hja	erv
hjb	rv
hjc	bst
hje	g
hjf	k
hjfk	v
hjj	v
hjm	bel
hjmb	rv
hjn	vz
hjnz	v
hjo	ov
hjq	abh
hjqh	rv
hjr	bs
hjrs	v
hju	v
hjx	b
hk	abehijklmnrz
hka	v
hkb	l
hki	rv
hkk	bd
hkl	brsv
hkr	l
hkz	v
hl	abdefhjklnopqrstwxz
hla	dv
hlb	df
hld	dhj
hle	qw
hlew	v
hlf	k
hlfk	v
hlh	opwz
hlhz	v
hlj	k
hljk	v
hlk	v
hll	b
hln	ov
hlo	ehkmoprsvwz
hlok	rv
hlos	rv
hloz	v
hlq	v
hlr	bv
hlrb	v
hls	krv
hlt	suw
hlw	qvw
hlwq	v
hlx	u
hlxu	v
hlz	opv
hm	abceglmnoqruwx
hmb	drv
hmc	s
hmcs	v
hme	bv
hmm	muv
hmn	o
hmr	rv
hmx	v
hn	bcdefghklmnopqrstvwxy
hnb	fio
hnc	pr
hnd	lsz
hne	ehoq
hneo	v
hnf	v
hng	v
hnh	t
hnl	eimpv
hnm	h
hnn	d
hno	blrv
hnp	abcdefghiorvwx
hnpf	rsv
hnpo	v
hnq	hl
hnr	is
hns	brv
hnx	u
hny	o
hnyo	v
ho	abcdefghijklmnoprstuvwxy
hoa	egrvx
hoag	l
hoagl	a
hoagla	n
hoaglan	d
hoar	dfisy
hoard	eis
hoarde	dr
hoarder	s
hoardi	n
hoardin	g
hoarding	s
hoarf	r
hoarfr	o
hoarfro	s
hoarfros	t
hoari	n
hoarin	e
hoarine	s
hoarines	s
hoars	e
hoarse	lnrs
hoarsel	y
hoarsen	e
hoarsene	s
hoarsenes	s
hoarseness	e
hoarsenesse	s
hoarses	t
hoax	ei
hoaxe	drs
hoaxer	s
hoaxi	n
hoaxin	g
hob	abdfglnosv
hoba	r
hobar	t
hobb	eilsy
hobbe	drs
hobber	s
hobbi	en
hobbie	s
hobbin	g
hobbl	ei
hobble	drs
hobbler	s
hobbli	n
hobblin	g
hobbling	l
hobblingl	y
hobby	hil
hobbyh	o
hobbyho	r
hobbyhor	s
hobbyhors	e
hobbyi	s
hobbyis	mt
hobbyist	s
hobbyl	e
hobbyle	s
hobbyles	s
hobd	a
hobda	y
hobf	v
hobg	o
hobgo	b
hobgob	l
hobgobl	i
hobgobli	n
hobl	i
hobli	k
hoblik	e
hobn	ao
hobna	i
hobnai	l
hobno	b
hobo	k
hobok	e
hoboke	n
hoc	klu
hock	e
hocke	iy
hockei	e
hockeie	s
hockey	eis
hockeye	s
hockeyi	s
hockeyis	t
hocu	s
hod	dg
hodd	e
hodde	n
hodg	ek
hodge	ps
hodgep	o
hodgepo	d
hodgepod	g
hodgepodg	e
hodgk	i
hodgki	n
hoe	cdfilrs
hoec	a
hoeca	k
hoecak	e
hoed	o
hoedo	w
hoedow	n
hoef	u
hoefu	l
hoei	n
hoein	g
hoel	i
hoeli	k
hoelik	e
hoer	s
hof	f
hoff	m
hoffm	a
hoffma	n
hog	abfglmnpstw
hoga	n
hogb	a
hogba	c
hogbac	k
hogf	i
hogfi	s
hogfis	h
hogg	ei
hogge	dr
hogger	y
hoggi	ns
hoggin	g
hoggis	h
hogl	i
hogli	kn
hoglik	e
hoglin	e
hogline	s
hoglines	s
hogm	a
hogma	n
hogman	a
hogmana	y
hogmanay	s
hogp	e
hogpe	n
hogs	k
hogsk	i
hogski	n
hogt	i
hogti	e
hogtie	d
hogw	a
hogwa	s
hogwas	h
hoh	lorv
hohl	r
hohlr	a
hohlra	u
hohlrau	m
hoho	k
hohok	a
hohoka	m
hoi	s
hois	t
hoist	eis
hoiste	dr
hoister	s
hoisti	n
hoistin	g
hoj	ov
hok	adruv
hoka	n
hoku	m
hol	abcdeilmostyz
hola	n
holan	d
holb	r
holbr	o
holbro	o
holbroo	k
holc	o
holco	m
holcom	b
hold	abefiosu
holda	bl
holdab	l
holdabl	e
holdal	l
holdall	s
holdb	a
holdba	c
holdbac	k
holde	mnr
holder	s
holders	h
holdersh	i
holdershi	p
holdership	s
holdf	a
holdfa	s
holdfas	t
holdi	n
holdin	g
holding	s
holdo	uv
holdou	t
holdov	e
holdove	r
holdu	p
hole	dlsy
holel	e
holele	s
holeles	s
holey	e
holeye	rs
holeyes	t
holi	delns
holid	a
holida	y
holiday	eims
holidaye	dr
holidayer	s
holidayi	n
holidayin	g
holidaym	a
holidayma	k
holidaymak	e
holidaymake	r
holidaymaker	s
holie	rs
holies	t
holil	y
holin	eg
holine	s
holines	s
holis	t
holist	i
holisti	c
holl	aeioy
holla	n
hollan	d
holland	aes
hollanda	i
hollandai	s
hollandais	e
hollande	r
holle	r
holler	i
holleri	t
hollerit	h
holli	ens
hollie	s
hollin	g
holling	s
hollings	w
hollingsw	o
hollingswo	r
hollingswor	t
hollingswort	h
hollis	t
hollist	e
holliste	r
hollo	w
hollow	aeilnsw
hollowa	y
hollowe	drs
hollowes	t
hollowi	n
hollowin	g
hollowl	y
hollown	e
hollowne	s
hollownes	s
hollowness	e
hollownesse	s
holloww	a
hollowwa	r
hollowwar	e
holly	hsw
hollyh	o
hollyho	c
hollyhoc	k
hollyw	o
hollywo	o
hollywoo	d
hollywood	i
hollywoodi	z
hollywoodiz	e
hollywoodize	s
holm	adei
holma	n
holmd	e
holmde	l
holme	s
holmi	u
holmiu	m
holo	cgpt
holoc	ae
holoca	u
holocau	s
holocaus	t
holocaust	ais
holocausta	l
holocausti	c
holoce	n
holocen	e
holog	r
hologr	a
hologra	mp
hologram	s
holograp	h
holograph	y
holop	h
holoph	o
holopho	t
holophot	e
holot	h
holoth	u
holothu	r
holothur	i
holothuri	a
holothuria	n
hols	t
holst	e
holste	ir
holstei	n
holster	eis
holstere	d
holsteri	n
holsterin	g
holy	os
holyo	k
holyok	e
holys	t
holyst	o
holysto	n
holyston	e
holz	m
holzm	a
holzma	n
hom	abeiosu
homa	cg
homac	a
homaca	n
homacan	t
homacant	h
homag	ei
homage	ads
homagea	b
homageab	l
homageabl	e
homagi	n
homagin	g
homb	v
home	bcdfgklmoprstwy
homeb	or
homebo	dy
homebod	y
homeboy	s
homebr	e
homebre	dw
homec	o
homeco	m
homecom	ei
homecome	r
homecomer	s
homecomi	n
homecomin	g
homecoming	s
homef	e
homefe	l
homefel	t
homeg	r
homegr	o
homegro	w
homegrow	n
homek	i
homeki	t
homel	aeiy
homela	n
homelan	d
homeland	s
homele	s
homeles	s
homeless	eln
homelesse	s
homelessl	y
homelessn	e
homelessne	s
homelessnes	s
homelessness	e
homelessnesse	s
homeli	ekln
homelie	rs
homelies	t
homelik	e
homelil	y
homelin	e
homeline	s
homelines	s
homeliness	e
homelinesse	s
homem	a
homema	dk
homemad	e
homemak	ei
homemake	r
homemaker	s
homemaki	n
homemakin	g
homeo	mpstw
homeom	o
homeomo	r
homeomor	p
homeomorp	h
homeomorph	i
homeomorphi	cs
homeomorphis	m
homeomorphism	s
homeop	a
homeopa	t
homeopat	h
homeopath	isy
homeopathi	ce
homeopathic	a
homeopathica	l
homeopathical	l
homeopathicall	y
homeopathie	s
homeos	t
homeost	a
homeosta	st
homeostas	ei
homeostase	s
homeostasi	s
homeostat	i
homeostati	c
homeostatic	a
homeostatica	l
homeostatical	l
homeostaticall	y
homeot	h
homeoth	e
homeothe	r
homeother	m
homeow	n
homeown	e
homeowne	r
homeowner	s
homeowners	h
homeownersh	i
homeownershi	p
homep	a
homepa	g
homepag	e
homepage	s
homer	is
homeri	c
homes	ipt
homesi	c
homesic	k
homesick	n
homesickn	e
homesickne	s
homesicknes	s
homesickness	e
homesicknesse	s
homesp	u
homespu	n
homest	e
homeste	a
homestea	d
homestead	es
homesteade	r
homesteader	s
homet	o
hometo	w
hometow	n
homew	ao
homewa	r
homewar	d
homeward	s
homewo	r
homewor	k
homework	s
homey	ns
homeyn	e
homeyne	s
homeynes	s
homeyness	e
homeynesse	s
homi	celn
homic	i
homici	d
homicid	ae
homicida	l
homicidal	l
homicidall	y
homicide	s
homie	rs
homies	t
homil	ey
homile	t
homilet	i
homileti	c
homiletic	s
homin	egiy
homine	s
homines	s
hominess	e
hominesse	s
homini	d
homo	cdglmnpstz
homoc	ehl
homoce	n
homocen	t
homocent	r
homocentr	i
homocentri	c
homoch	lr
homochl	a
homochla	m
homochlam	y
homochlamy	d
homochlamyd	e
homochlamyde	o
homochlamydeo	u
homochlamydeou	s
homochr	o
homochro	m
homochrom	y
homocl	i
homocli	m
homoclim	e
homod	i
homodi	m
homodim	e
homodime	r
homog	aer
homoga	m
homogam	o
homogamo	u
homogamou	s
homoge	n
homogen	eiot
homogene	ios
homogenei	t
homogeneit	iy
homogeneiti	e
homogeneitie	s
homogeneo	u
homogeneou	s
homogeneous	ln
homogeneousl	y
homogeneousn	e
homogeneousne	s
homogeneousnes	s
homogeneousness	e
homogeneousnesse	s
homogenes	i
homogenesi	s
homogeni	sz
homogenis	e
homogeniz	e
homogeno	u
homogenou	s
homogent	i
homogenti	s
homogentis	i
homogentisi	c
homogr	a
homogra	p
homograp	h
homograph	s
homol	ao
homola	t
homolat	e
homolate	r
homolater	a
homolatera	l
homolo	g
homolog	oy
homologo	u
homologou	s
homom	o
homomo	r
homomor	p
homomorp	h
homomorph	i
homomorphi	cs
homomorphis	m
homomorphism	s
homon	y
homony	m
homonym	ios
homonymi	ct
homonymit	iy
homonymiti	e
homonymitie	s
homonymo	u
homonymou	s
homop	h
homoph	o
homopho	bn
homophob	ei
homophobi	ac
homophobia	s
homophon	ey
homophone	s
homos	ae
homosa	p
homosap	i
homosapi	e
homosapie	n
homosapien	s
homose	x
homosex	u
homosexu	a
homosexua	l
homosexual	ils
homosexuali	st
homosexualis	t
homosexualit	y
homosexuall	y
homot	h
homoth	ae
homotha	l
homothal	l
homothall	iy
homothalli	s
homothallis	m
homothe	r
homother	m
homotherm	i
homothermi	c
homoz	y
homozy	g
homozyg	o
homozygo	tu
homozygot	ei
homozygote	s
homozygoti	c
homozygou	s
homu	n
homun	c
homunc	u
homuncu	l
homuncul	u
homunculu	s
hon	cdegikos
honc	h
honch	o
hond	aou
hondu	r
hondur	a
hondura	s
hone	drsy
hones	t
honest	elny
honeste	rs
honestes	t
honestl	y
honestn	e
honestne	s
honestnes	s
honestness	e
honestnesse	s
honey	bcdefilmsw
honeyb	e
honeybe	e
honeyc	o
honeyco	m
honeycom	b
honeycomb	eis
honeycombe	d
honeycombi	n
honeycombin	g
honeyd	e
honeyde	w
honeye	rs
honeyes	t
honeyf	u
honeyfu	l
honeyi	ns
honeyin	g
honeyis	h
honeyl	ei
honeyle	s
honeyles	s
honeyli	kp
honeylik	e
honeylip	p
honeylipp	e
honeylippe	d
honeym	o
honeymo	o
honeymoo	n
honeymoon	eis
honeymoone	dr
honeymooner	s
honeymooni	n
honeymoonin	g
honeys	eu
honeyse	l
honeysel	e
honeysele	c
honeyselec	t
honeysu	c
honeysuc	k
honeysuck	l
honeysuckl	e
honeyw	e
honeywe	l
honeywel	l
hong	ik
hongk	o
hongko	n
hongkon	g
honi	n
honin	g
honk	eisy
honke	d
honki	n
honkin	g
hono	lru
honol	u
honolu	l
honolul	u
honor	aeis
honora	br
honorab	l
honorabl	ey
honorable	n
honorablen	e
honorablene	s
honorablenes	s
honorar	iy
honorari	elu
honorarie	s
honoraril	y
honorariu	m
honore	dr
honori	fn
honorif	i
honorifi	c
honorin	g
honou	r
honour	aeils
honoura	br
honourab	il
honourabi	l
honourabil	i
honourabili	t
honourabilit	y
honourabl	ey
honourable	n
honourablen	e
honourablene	s
honourablenes	s
honourar	i
honourari	u
honourariu	m
honoure	dr
honouri	n
honourin	g
honourl	e
honourle	s
honourles	s
hons	h
honsh	u
hoo	cdefjklprstv
hooc	h
hood	eilosw
hoode	d
hoodi	en
hoodin	g
hoodl	eiu
hoodle	s
hoodles	s
hoodli	k
hoodlik	e
hoodlu	m
hoodo	o
hoodw	i
hoodwi	n
hoodwin	k
hoodwink	eis
hoodwinke	d
hoodwinki	n
hoodwinkin	g
hooe	y
hoof	beils
hoofb	e
hoofbe	a
hoofbea	t
hoofe	d
hoofi	n
hoofin	eg
hoofine	s
hoofines	s
hoofiness	e
hoofinesse	s
hoofl	ei
hoofle	s
hoofles	s
hoofli	k
hooflik	e
hooj	v
hook	aeilnsuwy
hooka	b
hookab	l
hookabl	e
hooke	dry
hooked	n
hookedn	e
hookedne	s
hookednes	s
hookedness	e
hookednesse	s
hooker	s
hooki	n
hookin	g
hookl	ei
hookle	s
hookles	s
hookli	k
hooklik	e
hookn	o
hookno	s
hooknos	e
hooku	p
hookup	s
hookw	o
hookwo	r
hookwor	m
hool	i
hooli	g
hoolig	a
hooliga	n
hooligan	is
hooligani	s
hooliganis	m
hoop	eils
hoope	r
hooper	s
hoopi	n
hoopin	g
hoopl	aei
hoople	s
hooples	s
hoopli	k
hooplik	e
hoops	k
hoopsk	i
hoopski	r
hoopskir	t
hoor	a
hoora	hy
hooray	eis
hooraye	d
hoorayi	n
hoorayin	g
hoos	hi
hoosi	e
hoosie	r
hoosier	i
hoosieri	z
hoosieriz	e
hoosierize	s
hoot	eisy
hoote	dnr
hooten	a
hootena	n
hootenan	n
hootenann	y
hooti	n
hootin	g
hooting	l
hootingl	y
hoov	e
hoove	rs
hoover	eis
hoovere	d
hooveri	nz
hooverin	g
hooveriz	e
hooverize	s
hop	ehiklops
hope	dflnrsw
hopef	u
hopefu	l
hopeful	lns
hopefull	y
hopefuln	e
hopefulne	s
hopefulnes	s
hopefulness	e
hopefulnesse	s
hopel	ey
hopele	s
hopeles	s
hopeless	ln
hopelessl	y
hopelessn	e
hopelessne	s
hopelessnes	s
hopelessness	e
hopelessnesse	s
hopen	e
hopene	t
hoper	s
hopew	e
hopewe	l
hopewel	l
hoph	e
hophe	a
hophea	d
hopi	n
hopin	g
hoping	l
hopingl	y
hopk	i
hopki	n
hopkin	s
hopkins	i
hopkinsi	a
hopkinsia	n
hopl	i
hopli	t
hoplit	e
hopo	s
hopos	t
hopost	a
hoposta	t
hopostat	i
hopostati	c
hopostatic	a
hopostatica	l
hopostatical	l
hopostaticall	y
hopp	eil
hoppe	dr
hopper	s
hoppi	n
hoppin	g
hopping	l
hoppingl	y
hoppl	e
hops	c
hopsc	o
hopsco	t
hopscot	c
hopscotc	h
hor	adeimnorstu
hora	crt
horac	e
horar	y
horat	i
horati	o
hord	ei
horde	ds
hordi	n
hordin	g
hore	h
horeh	o
horeho	u
horehou	n
horehoun	d
hori	z
horiz	o
horizo	n
horizon	alst
horizona	l
horizonl	e
horizonle	s
horizonles	s
horizont	a
horizonta	l
horizontal	ilns
horizontali	stz
horizontalis	m
horizontalit	i
horizontaliti	e
horizontalitie	s
horizontaliz	ae
horizontaliza	t
horizontalizat	i
horizontalizati	o
horizontalizatio	n
horizontall	y
horizontaln	e
horizontalne	s
horizontalnes	s
horizontalness	e
horizontalnesse	s
horm	o
hormo	n
hormon	aeio
hormona	l
hormone	ls
hormonel	i
hormoneli	k
hormonelik	e
hormoni	cz
hormoniz	e
hormono	l
hormonol	o
hormonolo	g
hormonolog	y
horn	beilpsy
hornb	eilo
hornbe	a
hornbea	m
hornbi	l
hornbil	l
hornbl	o
hornblo	w
hornblow	e
hornblowe	r
hornbo	o
hornboo	k
horne	dnst
horned	n
hornedn	e
hornedne	s
hornednes	s
hornedness	e
hornednesse	s
hornes	t
hornet	s
horni	ns
hornin	eg
hornine	s
hornines	s
hornis	h
hornl	e
hornle	s
hornles	s
hornless	n
hornlessn	e
hornlessne	s
hornlessnes	s
hornlessness	e
hornlessnesse	s
hornp	o
hornpo	u
hornpou	t
horns	tw
hornst	o
hornsto	n
hornston	e
hornsw	o
hornswo	g
hornswog	g
hornswogg	l
hornswoggl	e
horo	lsw
horol	o
horolo	g
horolog	eiy
horologi	c
horologic	a
horologica	l
horos	c
horosc	o
horosco	p
horoscop	ei
horoscope	rs
horoscopi	c
horoscopic	a
horoscopica	l
horow	i
horowi	t
horowit	z
horr	eio
horre	n
horren	dt
horrend	o
horrendo	u
horrendou	s
horrendous	ln
horrendousl	y
horrendousn	e
horrendousne	s
horrendousnes	s
horri	bdf
horrib	l
horribl	ey
horrible	ns
horriblen	e
horriblene	s
horriblenes	s
horribleness	e
horriblenesse	s
horrid	eln
horride	rs
horrides	t
horridl	y
horridn	e
horridne	s
horridnes	s
horridness	e
horridnesse	s
horrif	iy
horrifi	ce
horrific	a
horrifica	lt
horrifical	l
horrificall	y
horrificat	i
horrificati	o
horrificatio	n
horrification	s
horrifie	ds
horrified	l
horrifiedl	y
horrify	i
horrifyi	n
horrifyin	g
horrifying	l
horrifyingl	y
horro	r
horror	s
hors	eity
horse	bcdfhlmprstw
horseb	ar
horseba	c
horsebac	k
horsebr	e
horsebre	a
horsebrea	k
horsebreak	e
horsebreake	r
horsec	l
horsecl	o
horseclo	t
horseclot	h
horsef	l
horsefl	ey
horsefle	s
horsefles	h
horseh	i
horsehi	d
horsehid	e
horsel	aei
horsela	u
horselau	g
horselaug	h
horsele	s
horseles	s
horseli	k
horselik	e
horsem	ae
horsema	n
horseman	s
horsemans	h
horsemansh	i
horsemanshi	p
horsemanship	s
horseme	an
horsemea	t
horsep	lo
horsepl	a
horsepla	y
horsepo	w
horsepow	e
horsepowe	r
horsepower	s
horser	a
horsera	cd
horserac	i
horseraci	n
horseracin	g
horserad	i
horseradi	s
horseradis	h
horses	h
horsesh	o
horsesho	dei
horseshoe	dirs
horseshoei	n
horseshoein	g
horseshoer	s
horseshoi	n
horseshoin	g
horset	a
horseta	i
horsetai	l
horsew	ho
horsewh	i
horsewhi	p
horsewo	m
horsewom	ae
horsewoma	n
horsewoman	s
horsewomans	h
horsewomansh	i
horsewomanshi	p
horsewomanship	s
horsewome	n
horsi	ln
horsil	y
horsin	g
hort	aio
horta	t
hortat	i
hortati	v
hortativ	e
horti	c
hortic	u
horticu	l
horticul	t
horticult	u
horticultu	r
horticultur	aei
horticultura	l
horticultural	il
horticulturali	s
horticulturalis	t
horticulturall	y
horticulture	s
horticulturi	s
horticulturis	t
horticulturist	s
horto	n
horu	s
hos	eipst
hose	adls
hosel	ei
hosele	s
hoseles	s
hoseli	k
hoselik	e
hosi	n
hosin	g
hosp	i
hospi	ct
hospic	e
hospice	s
hospit	a
hospita	bl
hospitab	l
hospitabl	ey
hospitable	n
hospitablen	e
hospitablene	s
hospitablenes	s
hospitableness	e
hospitablenesse	s
hospital	is
hospitali	stz
hospitalis	e
hospitalit	iy
hospitaliti	e
hospitalitie	s
hospitaliz	aei
hospitaliza	t
hospitalizat	i
hospitalizati	o
hospitalizatio	n
hospitalize	ds
hospitalizi	n
hospitalizin	g
hoss	t
hosst	e
hosste	s
hosstes	s
host	aeilns
hosta	g
hostag	ei
hostage	ds
hostages	h
hostagesh	i
hostageshi	p
hostageship	s
hostagi	n
hostagin	g
hoste	dls
hostel	els
hostele	d
hostell	e
hostelle	d
hostes	s
hostess	eiy
hostesse	ds
hostessi	n
hostessin	g
hosti	ln
hostil	ei
hostile	ls
hostilel	y
hostili	t
hostilit	iy
hostiliti	e
hostilitie	s
hostin	g
hostl	e
hostle	s
hostles	s
hostn	a
hostna	m
hostnam	e
hosts	h
hostsh	i
hostshi	p
hostship	s
hot	bcehklmnpstv
hotb	eo
hotbe	d
hotbo	x
hotc	h
hotch	akp
hotchk	i
hotchki	s
hotchkis	s
hotchp	o
hotchpo	t
hotchpot	c
hotchpotc	h
hote	l
hotel	deikls
hoteld	o
hoteldo	m
hoteldom	s
hotele	s
hoteli	e
hotelie	r
hotelier	s
hotelk	e
hotelke	e
hotelkee	p
hotelkeep	e
hotelkeepe	r
hotell	ei
hotelle	s
hotelles	s
hotelli	n
hotellin	g
hoth	eo
hothe	a
hothea	d
hothead	e
hotheade	d
hotho	u
hothou	s
hothous	ei
hothouse	ds
hothousi	n
hothousin	g
hotk	e
hotke	y
hotl	iy
hotli	n
hotlin	e
hotm	a
hotma	i
hotmai	l
hotn	e
hotne	s
hotnes	s
hotness	e
hotnesse	s
hotp	o
hotpo	t
hots	hp
hotsh	o
hotsho	t
hotsp	ou
hotspo	t
hotspot	s
hotspu	r
hott	ei
hotte	dnrs
hotten	t
hottent	o
hottento	t
hottes	t
hotti	en
hottin	g
hou	dgnrs
houd	ai
houda	i
houdai	l
houdail	l
houdaill	e
houdi	n
houdin	i
houg	h
hough	t
hought	o
houghto	n
houn	d
hound	eilsy
hounde	dr
hounder	s
houndi	ens
houndie	rs
houndies	t
houndin	g
houndis	h
houndl	i
houndli	k
houndlik	e
hour	egils
houre	drs
houres	t
hourg	l
hourgl	a
hourgla	s
hourglas	s
hourl	eiy
hourle	s
hourles	s
hourli	e
hourlie	rs
hourlies	t
hous	eit
house	bcdfhklmrstw
houseb	or
housebo	au
houseboa	t
houseboat	eis
houseboate	dr
houseboater	s
houseboati	n
houseboatin	g
housebou	n
houseboun	d
housebr	eo
housebre	a
housebrea	k
housebreak	ei
housebreake	r
housebreaki	n
housebreakin	g
housebro	k
housebrok	e
housebroke	n
housec	lo
housecl	e
housecle	a
houseclea	n
houseclean	i
housecleani	n
housecleanin	g
houseco	a
housecoa	t
housef	lu
housefl	iy
housefli	e
houseflie	s
housefu	l
houseful	s
househ	o
househo	l
househol	d
household	ers
householde	r
householder	s
householders	h
householdersh	i
householdershi	p
householdership	s
householdr	y
housek	e
houseke	e
housekee	p
housekeep	ei
housekeepe	r
housekeeper	ls
housekeeperl	i
housekeeperli	k
housekeeperlik	e
housekeepi	n
housekeepin	g
housekeeping	s
housel	e
housele	es
houselee	k
houseles	s
houseless	n
houselessn	e
houselessne	s
houselessnes	s
houselessness	e
houselessnesse	s
housem	aio
housema	is
housemai	d
housemas	t
housemast	e
housemaste	r
housemi	s
housemis	t
housemist	r
housemistr	e
housemistre	s
housemistres	s
housemo	t
housemot	h
housemoth	e
housemothe	r
houser	o
housero	o
houseroo	m
houset	o
houseto	p
housetop	s
housew	aio
housewa	r
housewar	em
houseware	s
housewarm	i
housewarmi	n
housewarmin	g
housewi	fv
housewif	ei
housewife	dlrsy
housewifel	iy
housewifeli	n
housewifelin	e
housewifeline	s
housewifelines	s
housewifeliness	e
housewifelinesse	s
housewifer	iy
housewiferi	e
housewiferie	s
housewifes	h
housewifesh	i
housewifeshi	p
housewifi	ns
housewifin	g
housewifis	h
housewiv	e
housewive	s
housewo	r
housewor	k
housework	es
houseworke	r
housi	n
housin	g
housing	s
houst	o
housto	n
hov	e
hove	lr
hovel	eils
hovele	d
hoveli	n
hovelin	g
hovell	ei
hovelle	d
hovelli	n
hovellin	g
hover	ceis
hoverc	r
hovercr	a
hovercra	f
hovercraf	t
hovercraft	s
hovere	dr
hoverer	s
hoveri	n
hoverin	g
hovering	l
hoveringl	y
how	abeils
howa	r
howar	d
howb	e
howbe	i
howbei	t
howe	lrv
howel	l
howev	e
howeve	r
howi	t
howit	z
howitz	e
howitze	r
howl	eis
howle	drt
howli	n
howlin	g
hox	bdsv
hoy	dlt
hoyd	e
hoyde	n
hoyden	i
hoydeni	s
hoydenis	h
hoyl	e
hp	abdefgjklmnopqtux
hpd	fhkmopv
hpdk	v
hpdo	v
hpe	v
hpj	v
hpm	r
hpn	dfmo
hpo	bh
hpq	gnu
hpt	ho
hpx	frsvw
hq	abehjklmnorstu
hqa	v
hqb	bpv
hql	w
hqm	m
hqn	v
hqr	bp
hqt	v
hqu	rv
hr	abcdefghilnopqrstuvwxz
hra	rv
hrb	b
hrc	bdrv
hrd	djrsv
hre	bf
hrf	abcdemsv
hrg	q
hrl	v
hrn	bdfhq
hro	dktv
hrok	v
hrot	h
hroth	g
hrothg	a
hrothga	r
hrr	rv
hrs	s
hrt	brsv
hrtb	rv
hru	uy
hrv	fu
hrw	w
hrz	v
hs	abeilnopqrstuwxz
hsb	c
hse	r
hsn	fovy
hso	rsvw
hsp	ox
hsq	j
hsr	b
hsu	v
hsw	u
hsx	ou
hsxu	v
hsz	j
ht	acdeijmnopqtx
hta	v
htd	pv
htm	lp
html	s
htn	dq
htnd	rv
hto	h
htp	v
htq	dx
htt	kpz
http	s
hu	abcdefghiklmnorstuwxyz
hua	clnw
hual	i
huali	e
hualie	n
huan	g
huaw	e
huawe	i
hub	bcelprs
hubb	aeiuy
hubba	r
hubbar	d
hubbe	dl
hubbel	l
hubbi	n
hubbin	g
hubbu	b
hubbub	os
hubbubo	o
hubc	a
hubca	p
hubcap	s
hube	r
huber	t
hubl	i
hubli	k
hublik	e
hubp	v
hubr	i
hubri	s
hubris	et
hubrise	s
hubrist	i
hubristi	c
hubristic	a
hubristica	l
hubristical	l
hubristicall	y
huc	k
huck	ls
huckl	e
huckle	b
huckleb	e
hucklebe	r
huckleber	r
huckleberr	y
hucks	t
huckst	e
huckste	r
hud	cdlms
hudd	l
huddl	ei
huddle	dmrs
huddlem	e
huddleme	n
huddlemen	t
huddler	s
huddli	n
huddlin	g
huddling	l
huddlingl	y
hudm	v
huds	o
hudso	n
hue	delrsvy
huel	e
huele	s
hueles	s
hueless	n
huelessn	e
huelessne	s
huelessnes	s
huf	df
hufd	v
huff	eimsy
huffe	dr
huffi	ns
huffin	g
huffing	l
huffingl	y
huffis	h
huffm	a
huffma	n
hug	eghiosu
huge	lnrs
hugel	y
hugen	e
hugene	s
hugenes	s
hugeness	e
hugenesse	s
huges	t
hugg	aei
hugga	b
huggab	l
huggabl	e
hugge	der
hugger	s
huggi	n
huggin	gs
hugging	fl
huggingf	a
huggingfa	c
huggingfac	e
huggingl	y
hugh	ei
hughe	s
hughi	e
hugi	g
hugig	a
hugu	e
hugue	n
huguen	o
hugueno	t
hui	v
huk	m
hul	akl
hulk	i
hulki	n
hulkin	g
hull	aeils
hulla	b
hullab	a
hullaba	l
hullabal	o
hullabalo	o
hullabaloo	s
hulle	dr
huller	s
hulli	n
hullin	g
hulll	e
hullle	s
hullles	s
hum	abdeimoprsuv
huma	n
human	ehiklnos
humane	lnrs
humanel	y
humanen	e
humanene	s
humanenes	s
humaneness	e
humanenesse	s
humanes	t
humanh	o
humanho	o
humanhoo	d
humani	stz
humanis	mt
humanist	i
humanisti	c
humanit	aiy
humanita	r
humanitar	i
humanitari	a
humanitaria	n
humanitarian	is
humanitariani	s
humanitarianis	m
humanitarianism	s
humaniti	e
humanitie	s
humaniz	ae
humaniza	t
humanizat	i
humanizati	o
humanizatio	n
humank	i
humanki	n
humankin	d
humankind	s
humanl	iy
humanli	k
humanlik	e
humann	e
humanne	s
humannes	s
humanness	e
humannesse	s
humano	i
humanoi	d
humb	lou
humbl	eiy
humble	dnrs
humblen	e
humblene	s
humblenes	s
humbleness	e
humblenesse	s
humbler	s
humbles	t
humbli	n
humblin	g
humbling	ls
humblingl	y
humbo	l
humbol	d
humbold	t
humbu	g
humbug	g
humbugg	e
humbugge	r
humbugger	y
humd	ir
humdi	n
humdin	g
humding	e
humdinge	r
humdr	u
humdru	m
humdrum	mns
humdrumm	e
humdrumme	r
humdrummer	y
humdrumn	e
humdrumne	s
humdrumnes	s
humdrumness	e
humdrumnesse	s
hume	r
humer	aiu
humera	l
humeru	s
humerus	e
humeruse	s
humi	dl
humid	ilno
humidi	flt
humidif	iy
humidifi	ce
humidific	a
humidifica	t
humidificat	i
humidificati	o
humidificatio	n
humidifie	drs
humidifier	s
humidify	i
humidifyi	n
humidifyin	g
humidil	y
humidit	y
humidl	y
humidn	e
humidne	s
humidnes	s
humidness	e
humidnesse	s
humido	r
humil	i
humili	at
humilia	t
humiliat	eio
humiliate	ds
humiliati	nov
humiliatin	g
humiliatio	n
humiliation	s
humiliativ	e
humiliato	r
humiliator	sy
humilit	iy
humiliti	e
humilitie	s
humm	aeio
humma	b
hummab	l
hummabl	e
humme	dlr
hummi	n
hummin	g
humming	b
hummingb	i
hummingbi	r
hummingbir	d
hummo	c
hummoc	k
hummock	y
humo	ru
humor	aeios
humora	l
humore	drs
humorer	s
humores	q
humoresq	u
humoresqu	e
humori	n
humorin	g
humoro	u
humorou	s
humorous	ln
humorousl	y
humorousn	e
humorousne	s
humorousnes	s
humorousness	e
humorousnesse	s
humou	r
humour	efils
humoure	d
humourf	u
humourfu	l
humouri	n
humourin	g
humourl	e
humourle	s
humourles	s
humourless	ln
humourlessl	y
humourlessn	e
humourlessne	s
humourlessnes	s
hump	behisty
humpb	a
humpba	c
humpbac	k
humpback	e
humpbacke	d
humpe	dr
humper	s
humph	r
humphr	e
humphre	y
humpi	n
humpin	g
humpt	y
humu	s
humus	el
humuse	s
humusl	i
humusli	k
humuslik	e
hun	cdefgklnstz
hunc	h
hunch	bei
hunchb	a
hunchba	c
hunchbac	k
hunchback	es
hunchbacke	d
hunche	ds
hunchi	n
hunchin	g
hund	r
hundr	e
hundre	d
hundred	efstw
hundrede	r
hundredf	o
hundredfo	l
hundredfol	d
hundredt	h
hundredth	s
hundredw	e
hundredwe	i
hundredwei	g
hundredweig	h
hundredweigh	t
hundredweight	s
hune	v
hung	aer
hunga	r
hungar	iy
hungari	a
hungaria	n
hunge	r
hunger	eils
hungere	dr
hungeri	n
hungerin	g
hungerl	e
hungerle	s
hungerles	s
hungr	iy
hungri	eln
hungrie	rs
hungries	t
hungril	y
hungrin	e
hungrine	s
hungrines	s
hungriness	e
hungrinesse	s
hunk	esy
hunke	r
hunker	is
hunkeri	n
hunkerin	g
hunn	i
hunni	s
hunnis	h
hunt	aeilrs
hunta	b
huntab	l
huntabl	e
hunte	dr
hunted	l
huntedl	y
hunter	ls
hunterl	i
hunterli	k
hunterlik	e
hunti	n
huntin	g
hunting	st
huntingt	o
huntingto	n
huntl	e
huntle	y
huntr	e
huntre	s
huntres	s
hunts	mv
huntsm	a
huntsma	n
huntsv	i
huntsvi	l
huntsvil	l
huntsvill	e
huo	bv
huob	i
hur	dloprstvw
hurd	l
hurdl	ei
hurdle	drs
hurdler	s
hurdli	n
hurdlin	g
hurdling	s
hurl	eisy
hurle	dry
hurler	s
hurli	n
hurlin	g
huro	n
huron	s
hurp	v
hurr	aiy
hurra	hy
hurray	s
hurri	ce
hurric	a
hurrica	n
hurrican	e
hurricane	s
hurrie	drs
hurried	ln
hurriedl	y
hurriedn	e
hurriedne	s
hurriednes	s
hurriedness	e
hurriednesse	s
hurrier	s
hurry	gi
hurryg	r
hurrygr	a
hurrygra	p
hurrygrap	h
hurryi	n
hurryin	g
hurrying	l
hurryingl	y
hurs	t
hurt	aefilsy
hurta	b
hurtab	l
hurtabl	e
hurte	r
hurter	s
hurtf	u
hurtfu	l
hurtful	ln
hurtfull	y
hurtfuln	e
hurtfulne	s
hurtfulnes	s
hurtfulness	e
hurtfulnesse	s
hurti	n
hurtin	g
hurtl	ei
hurtle	ds
hurtles	s
hurtli	n
hurtlin	g
hurtling	l
hurtlingl	y
hurw	i
hurwi	t
hurwit	z
hus	bhkrst
husb	a
husba	n
husban	d
husband	ehilmors
husbande	dr
husbander	s
husbandh	o
husbandho	o
husbandhoo	d
husbandi	n
husbandin	g
husbandl	e
husbandle	s
husbandles	s
husbandm	ae
husbandma	n
husbandme	n
husbando	m
husbandr	iy
husbandri	e
husbandrie	s
husbands	h
husbandsh	i
husbandshi	p
hush	aefi
husha	b
hushab	y
hushe	drs
hushes	t
hushf	u
hushfu	l
hushful	l
hushfull	y
hushi	n
hushin	g
husk	eilsy
huske	dr
husker	s
huski	eln
huskie	rs
huskies	t
huskil	y
huskin	eg
huskine	s
huskines	s
huskiness	e
huskinesse	s
huskl	i
huskli	k
husklik	e
huss	aey
hussa	r
husse	i
hussei	n
hust	ilo
husti	n
hustin	g
husting	s
hustl	ei
hustle	drs
hustler	s
hustli	n
hustlin	g
husto	n
hut	clmrst
hutc	h
hutch	ei
hutche	s
hutchi	ns
hutchin	s
hutchins	o
hutchinso	n
hutchis	o
hutchiso	n
hutl	i
hutli	k
hutlik	e
hutm	e
hutme	n
hutmen	t
hutr	v
hutt	i
hutti	n
huttin	g
huu	muv
huum	v
huw	u
hux	lt
huxl	e
huxle	y
huxt	a
huxta	b
huxtab	l
huxtabl	e
huz	z
huzz	a
hv	adefjmnostuvxz
hvd	mp
hvdp	v
hve	rv
hvf	frsv
hvo	jmx
hvs	brtv
hvu	v
hvx	v
hw	abdhjnouwx
hwh	v
hwj	rv
hwn	v
hwo	orsv
hwoo	rv
hwos	v
hwu	v
hww	b
hx	adefijklnuvx
hxa	v
hxe	v
hxi	uy
hxiy	v
hxu	p
hxup	v
hxx	nuv
hxxn	v
hy	abdefgjkmnoprstuxyz
hya	cdlntv
hyac	i
hyaci	n
hyacin	t
hyacint	h
hyacinth	i
hyacinthi	n
hyacinthin	e
hyad	e
hyade	s
hyal	i
hyali	n
hyalin	e
hyan	n
hyann	i
hyanni	s
hyat	t
hyb	gpry
hybr	i
hybri	d
hybrid	is
hybridi	stz
hybridis	em
hybridism	s
hybridit	i
hybriditi	e
hybriditie	s
hybridiz	ae
hybridiza	t
hybridizat	i
hybridizati	o
hybridizatio	n
hyd	emor
hyde	r
hyder	a
hydera	b
hyderab	a
hyderaba	d
hydr	aio
hydra	ntu
hydran	gt
hydrang	e
hydrange	a
hydrant	s
hydrat	eio
hydrate	ds
hydrati	no
hydratin	g
hydratio	n
hydration	s
hydrato	r
hydrator	s
hydrau	l
hydraul	i
hydrauli	c
hydraulic	ais
hydraulica	l
hydraulical	l
hydraulicall	y
hydraulici	t
hydraulicit	y
hydraulics	e
hydraulicse	s
hydri	c
hydro	cdeglmpqstuvxz
hydroc	ao
hydroca	r
hydrocar	b
hydrocarb	o
hydrocarbo	n
hydrocarbon	aios
hydrocarbona	c
hydrocarbonac	e
hydrocarbonace	o
hydrocarbonaceo	u
hydrocarbonaceou	s
hydrocarboni	c
hydrocarbono	u
hydrocarbonou	s
hydroco	d
hydrocod	o
hydrocodo	n
hydrocodon	e
hydrod	y
hydrody	n
hydrodyn	a
hydrodyna	m
hydrodynam	i
hydrodynami	c
hydrodynamic	s
hydroe	l
hydroel	e
hydroele	c
hydroelec	t
hydroelect	r
hydroelectr	i
hydroelectri	c
hydroelectric	ai
hydroelectrica	l
hydroelectrical	l
hydroelectricall	y
hydroelectrici	t
hydroelectricit	iy
hydroelectriciti	e
hydroelectricitie	s
hydrog	er
hydroge	n
hydrogen	os
hydrogeno	u
hydrogenou	s
hydrogr	a
hydrogra	p
hydrograp	h
hydrograph	eiy
hydrographe	r
hydrographi	c
hydrol	oy
hydrolo	g
hydrolog	iy
hydrologi	ces
hydrologic	a
hydrologica	l
hydrological	l
hydrologicall	y
hydrologie	s
hydrologis	t
hydrologist	s
hydroly	sz
hydrolys	ei
hydrolysi	s
hydrolyz	e
hydrom	ae
hydroma	g
hydromag	n
hydromagn	e
hydromagne	t
hydromagnet	i
hydromagneti	c
hydromagnetic	s
hydrome	t
hydromet	e
hydromete	r
hydrop	ahlo
hydropa	t
hydropat	h
hydropath	i
hydropathi	c
hydroph	o
hydropho	bn
hydrophob	i
hydrophobi	ac
hydrophon	e
hydropl	a
hydropla	n
hydroplan	e
hydroplane	drs
hydropo	nw
hydropon	i
hydroponi	c
hydroponic	a
hydroponica	l
hydroponical	l
hydroponicall	y
hydropow	e
hydropowe	r
hydroq	u
hydroqu	i
hydroqui	n
hydroquin	o
hydroquino	n
hydroquinon	e
hydros	pt
hydrosp	h
hydrosph	e
hydrosphe	r
hydrospher	e
hydrost	a
hydrosta	t
hydrostat	i
hydrostati	c
hydrostatic	s
hydrot	hr
hydroth	e
hydrothe	r
hydrother	am
hydrothera	p
hydrotherap	y
hydrotherm	a
hydrotherma	l
hydrotr	o
hydrotro	p
hydrotrop	i
hydrotropi	s
hydrotropis	m
hydrou	s
hydrov	a
hydrova	n
hydrovan	e
hydrox	iy
hydroxi	d
hydroxid	e
hydroxide	s
hydroxy	al
hydroxya	p
hydroxyap	a
hydroxyapa	t
hydroxyapat	i
hydroxyapati	t
hydroxyapatit	e
hydroz	o
hydrozo	a
hydrozoa	n
hye	n
hyen	aio
hyena	is
hyenai	s
hyenais	m
hyeni	cn
hyenin	e
hyeno	i
hyenoi	d
hyf	fp
hyg	eir
hyge	in
hygei	a
hygeia	n
hygen	i
hygeni	c
hygenic	s
hygi	e
hygie	n
hygien	ei
hygiene	s
hygieni	cs
hygienic	as
hygienica	l
hygienical	l
hygienicall	y
hygienis	t
hygienist	s
hygr	o
hygro	ms
hygrom	e
hygrome	t
hygromet	er
hygromete	r
hygrometr	y
hygros	c
hygrosc	o
hygrosco	p
hygroscop	ei
hygroscopi	c
hyk	s
hyks	o
hykso	s
hym	aen
hyma	n
hyme	n
hymen	eo
hymene	a
hymenea	l
hymeno	p
hymenop	t
hymenopt	e
hymenopte	r
hymenopter	o
hymenoptero	u
hymenopterou	s
hymn	abeilos
hymna	l
hymnb	o
hymnbo	o
hymnboo	k
hymne	dr
hymner	s
hymni	cns
hymnin	g
hymnis	t
hymnl	ei
hymnle	s
hymnles	s
hymnli	k
hymnlik	e
hymno	dl
hymnod	y
hymnol	o
hymnolo	g
hymnolog	y
hyo	mopv
hyp	adefhinos
hypa	l
hypal	l
hypall	a
hypalla	g
hypallag	e
hype	drs
hyper	abcdefghiklmnoprstuvw
hypera	bceglnrw
hyperab	s
hyperabs	o
hyperabso	r
hyperabsor	p
hyperabsorp	t
hyperabsorpt	i
hyperabsorpti	o
hyperabsorptio	n
hyperabsorption	s
hyperac	ciotu
hyperacc	u
hyperaccu	r
hyperaccur	a
hyperaccura	t
hyperaccurat	e
hyperaccurate	ln
hyperaccuratel	y
hyperaccuraten	e
hyperaccuratene	s
hyperaccuratenes	s
hyperaccurateness	e
hyperaccuratenesse	s
hyperaci	d
hyperacid	i
hyperacidi	t
hyperacidit	y
hyperaco	u
hyperacou	s
hyperacous	t
hyperacoust	i
hyperacousti	c
hyperacoustic	s
hyperacoustics	e
hyperacousticse	s
hyperact	i
hyperacti	ov
hyperactio	n
hyperaction	s
hyperactiv	ei
hyperactive	ls
hyperactivel	y
hyperactivi	t
hyperactivit	y
hyperacu	it
hyperacui	t
hyperacuit	iy
hyperacuiti	e
hyperacuitie	s
hyperacut	e
hyperacute	ln
hyperacutel	y
hyperacuten	e
hyperacutene	s
hyperacutenes	s
hyperacuteness	e
hyperacutenesse	s
hyperae	ms
hyperaem	i
hyperaemi	a
hyperaes	t
hyperaest	h
hyperaesth	e
hyperaesthe	t
hyperaesthet	e
hyperaesthete	s
hyperag	g
hyperagg	r
hyperaggr	e
hyperaggre	gs
hyperaggreg	a
hyperaggrega	t
hyperaggregat	ei
hyperaggregate	ds
hyperaggregati	n
hyperaggregatin	g
hyperaggres	s
hyperaggress	i
hyperaggressi	v
hyperaggressiv	e
hyperaggressive	ln
hyperaggressivel	y
hyperaggressiven	e
hyperaggressivene	s
hyperaggressivenes	s
hyperaggressiveness	e
hyperaggressivenesse	s
hyperal	egt
hyperale	r
hyperaler	t
hyperalg	i
hyperalgi	c
hyperalt	r
hyperaltr	u
hyperaltru	i
hyperaltrui	s
hyperaltruis	m
hyperaltruism	s
hyperan	ag
hyperana	r
hyperanar	c
hyperanarc	h
hyperanarch	iy
hyperanarchi	e
hyperanarchie	s
hyperang	e
hyperange	l
hyperangel	i
hyperangeli	c
hyperangelic	a
hyperangelica	l
hyperangelical	l
hyperangelicall	y
hyperar	io
hyperari	d
hyperaro	u
hyperarou	s
hyperarous	a
hyperarousa	l
hyperaw	a
hyperawa	r
hyperawar	e
hyperaware	n
hyperawaren	e
hyperawarene	s
hyperawarenes	s
hyperawareness	e
hyperawarenesse	s
hyperb	aor
hyperba	r
hyperbar	i
hyperbari	c
hyperbo	lr
hyperbol	aei
hyperbole	s
hyperboli	cs
hyperbolis	t
hyperbolist	s
hyperbor	e
hyperbore	a
hyperborea	n
hyperbr	u
hyperbru	t
hyperbrut	a
hyperbruta	l
hyperbrutal	l
hyperbrutall	y
hyperc	aehilor
hyperca	lptu
hypercal	c
hypercalc	a
hypercalca	e
hypercalcae	m
hypercalcaem	i
hypercalcaemi	c
hypercap	n
hypercapn	i
hypercapni	c
hypercat	ah
hypercata	b
hypercatab	o
hypercatabo	l
hypercatabol	i
hypercataboli	s
hypercatabolis	m
hypercatabolism	s
hypercath	a
hypercatha	r
hypercathar	s
hypercathars	ei
hypercatharse	s
hypercatharsi	s
hypercau	t
hypercaut	i
hypercauti	o
hypercautio	u
hypercautiou	s
hypercautious	ln
hypercautiousl	y
hypercautiousn	e
hypercautiousne	s
hypercautiousnes	s
hypercautiousness	e
hypercautiousnesse	s
hyperce	l
hypercel	l
hypercell	u
hypercellu	l
hypercellul	a
hypercellula	r
hypercellular	i
hypercellulari	t
hypercellularit	y
hyperch	al
hypercha	r
hyperchar	g
hypercharg	e
hypercharge	d
hyperchl	o
hyperchlo	r
hyperchlor	hi
hyperchlorh	y
hyperchlorhy	d
hyperchlorhyd	r
hyperchlorhydr	i
hyperchlorhydri	c
hyperchlori	n
hyperchlorin	a
hyperchlorina	t
hyperchlorinat	i
hyperchlorinati	o
hyperchlorinatio	n
hyperchlorination	s
hyperci	v
hyperciv	i
hypercivi	l
hypercivil	i
hypercivili	z
hyperciviliz	ae
hyperciviliza	t
hypercivilizat	i
hypercivilizati	o
hypercivilizatio	n
hypercivilization	s
hypercivilize	d
hypercl	ai
hypercla	s
hyperclas	s
hyperclass	i
hyperclassi	c
hyperclassic	a
hyperclassica	l
hyperclassical	i
hyperclassicali	t
hyperclassicalit	iy
hyperclassicaliti	e
hyperclassicalitie	s
hypercli	m
hyperclim	a
hyperclima	x
hyperclimax	e
hyperclimaxe	s
hyperco	almn
hypercoa	g
hypercoag	u
hypercoagu	l
hypercoagul	a
hypercoagula	b
hypercoagulab	il
hypercoagulabi	l
hypercoagulabil	i
hypercoagulabili	t
hypercoagulabilit	iy
hypercoagulabiliti	e
hypercoagulabilitie	s
hypercoagulabl	e
hypercol	ou
hypercolo	u
hypercolou	r
hypercolu	m
hypercolum	n
hypercom	p
hypercomp	eo
hypercompe	t
hypercompet	i
hypercompeti	t
hypercompetit	i
hypercompetiti	v
hypercompetitiv	e
hypercompo	s
hypercompos	i
hypercomposi	t
hypercomposit	e
hypercon	cfjs
hyperconc	e
hyperconce	n
hyperconcen	t
hyperconcent	r
hyperconcentr	a
hyperconcentra	t
hyperconcentrat	i
hyperconcentrati	o
hyperconcentratio	n
hyperconcentration	s
hyperconf	io
hyperconfi	d
hyperconfid	e
hyperconfide	n
hyperconfiden	ct
hyperconfidenc	e
hyperconfidence	s
hyperconfident	l
hyperconfidentl	y
hyperconfo	r
hyperconfor	m
hyperconform	i
hyperconformi	s
hyperconformis	t
hyperconformist	s
hyperconj	u
hyperconju	g
hyperconjug	a
hyperconjuga	t
hyperconjugat	ei
hyperconjugate	d
hyperconjugati	o
hyperconjugatio	n
hypercons	cet
hyperconsc	i
hyperconsci	eo
hyperconscie	n
hyperconscien	t
hyperconscient	i
hyperconscienti	o
hyperconscientio	u
hyperconscientiou	s
hyperconscientious	ln
hyperconscientiousl	y
hyperconscientiousn	e
hyperconscientiousne	s
hyperconscientiousnes	s
hyperconscientiousness	e
hyperconscientiousnesse	s
hyperconscio	u
hyperconsciou	s
hyperconscious	n
hyperconsciousn	e
hyperconsciousne	s
hyperconsciousnes	s
hyperconsciousness	e
hyperconsciousnesse	s
hyperconse	r
hyperconser	v
hyperconserv	a
hyperconserva	t
hyperconservat	i
hyperconservati	sv
hyperconservatis	m
hyperconservatism	s
hyperconservativ	e
hyperconservative	lns
hyperconservativel	y
hyperconservativen	e
hyperconservativene	s
hyperconservativenes	s
hyperconservativeness	e
hyperconservativenesse	s
hyperconst	i
hyperconsti	t
hyperconstit	u
hyperconstitu	t
hyperconstitut	i
hyperconstituti	o
hyperconstitutio	n
hyperconstitution	a
hyperconstitutiona	l
hyperconstitutional	l
hyperconstitutionall	y
hypercr	i
hypercri	t
hypercrit	i
hypercriti	c
hypercritic	ai
hypercritica	l
hypercritici	s
hypercriticis	m
hyperd	ei
hyperde	lmv
hyperdel	i
hyperdeli	c
hyperdelic	ai
hyperdelica	ct
hyperdelicac	iy
hyperdelicaci	e
hyperdelicacie	s
hyperdelicat	e
hyperdelicate	ln
hyperdelicatel	y
hyperdelicaten	e
hyperdelicatene	s
hyperdelicatenes	s
hyperdelicateness	e
hyperdelicatenesse	s
hyperdelici	o
hyperdelicio	u
hyperdeliciou	s
hyperdelicious	ln
hyperdeliciousl	y
hyperdeliciousn	e
hyperdeliciousne	s
hyperdeliciousnes	s
hyperdeliciousness	e
hyperdeliciousnesse	s
hyperdem	o
hyperdemo	c
hyperdemoc	r
hyperdemocr	a
hyperdemocra	t
hyperdemocrat	i
hyperdemocrati	c
hyperdev	e
hyperdeve	l
hyperdevel	o
hyperdevelo	p
hyperdevelop	em
hyperdevelope	d
hyperdevelopm	e
hyperdevelopme	n
hyperdevelopmen	t
hyperdevelopment	as
hyperdevelopmenta	l
hyperdi	pv
hyperdip	l
hyperdipl	o
hyperdiplo	i
hyperdiploi	d
hyperdiploid	y
hyperdiv	i
hyperdivi	s
hyperdivis	i
hyperdivisi	o
hyperdivisio	n
hyperdivision	s
hypere	flmnstx
hyperef	f
hypereff	i
hypereffi	c
hypereffic	i
hypereffici	e
hyperefficie	n
hyperefficien	t
hyperel	e
hyperele	g
hypereleg	a
hyperelega	n
hyperelegan	t
hyperelegant	l
hyperelegantl	y
hyperem	eop
hypereme	s
hyperemes	i
hyperemesi	s
hyperemo	t
hyperemot	i
hyperemoti	ov
hyperemotio	n
hyperemotion	a
hyperemotiona	l
hyperemotional	il
hyperemotionali	t
hyperemotionalit	iy
hyperemotionaliti	e
hyperemotionalitie	s
hyperemotionall	y
hyperemotiv	ei
hyperemotive	ln
hyperemotivel	y
hyperemotiven	e
hyperemotivene	s
hyperemotivenes	s
hyperemotiveness	e
hyperemotivenesse	s
hyperemotivi	t
hyperemotivit	iy
hyperemotiviti	e
hyperemotivitie	s
hyperemp	h
hyperemph	a
hyperempha	s
hyperemphas	i
hyperemphasi	z
hyperemphasiz	ei
hyperemphasize	ds
hyperemphasizi	n
hyperemphasizin	g
hyperen	det
hyperend	e
hyperende	m
hyperendem	i
hyperendemi	c
hyperene	r
hyperener	g
hyperenerg	eiy
hyperenerge	t
hyperenerget	i
hyperenergeti	c
hyperenergi	e
hyperenergie	s
hyperent	h
hyperenth	u
hyperenthu	s
hyperenthus	i
hyperenthusi	a
hyperenthusia	s
hyperenthusias	mt
hyperenthusiasm	s
hyperenthusiast	i
hyperenthusiasti	c
hyperenthusiastic	a
hyperenthusiastica	l
hyperenthusiastical	l
hyperenthusiasticall	y
hyperes	t
hyperest	h
hyperesth	e
hyperesthe	s
hyperesthes	i
hyperesthesi	a
hyperet	h
hypereth	i
hyperethi	c
hyperethic	a
hyperethica	l
hyperethical	l
hyperethicall	y
hyperex	ct
hyperexc	ir
hyperexci	t
hyperexcit	ae
hyperexcita	b
hyperexcitab	il
hyperexcitabi	l
hyperexcitabil	i
hyperexcitabili	t
hyperexcitabilit	i
hyperexcitabiliti	e
hyperexcitabilitie	s
hyperexcitabl	e
hyperexcite	dm
hyperexcitem	e
hyperexciteme	n
hyperexcitemen	t
hyperexcitement	s
hyperexcr	e
hyperexcre	t
hyperexcret	i
hyperexcreti	o
hyperexcretio	n
hyperexcretion	s
hyperext	e
hyperexte	n
hyperexten	s
hyperextens	i
hyperextensi	b
hyperextensib	il
hyperextensibi	l
hyperextensibil	i
hyperextensibili	t
hyperextensibilit	y
hyperextensibl	e
hyperf	aelou
hyperfa	s
hyperfas	t
hyperfast	i
hyperfasti	d
hyperfastid	i
hyperfastidi	o
hyperfastidio	u
hyperfastidiou	s
hyperfastidious	ln
hyperfastidiousl	y
hyperfastidiousn	e
hyperfastidiousne	s
hyperfastidiousnes	s
hyperfastidiousness	e
hyperfastidiousnesse	s
hyperfe	dm
hyperfed	e
hyperfede	r
hyperfeder	a
hyperfedera	l
hyperfederal	i
hyperfederali	s
hyperfederalis	t
hyperfederalist	s
hyperfem	i
hyperfemi	n
hyperfemin	i
hyperfemini	n
hyperfeminin	e
hyperfeminine	ln
hyperfemininel	y
hyperfemininen	e
hyperfemininene	s
hyperfemininenes	s
hyperfeminineness	e
hyperfemininenesse	s
hyperfl	e
hyperfle	x
hyperflex	i
hyperflexi	b
hyperflexib	il
hyperflexibi	l
hyperflexibil	i
hyperflexibili	t
hyperflexibilit	iy
hyperflexibiliti	e
hyperflexibilitie	s
hyperflexibl	ey
hyperflexible	n
hyperflexiblen	e
hyperflexiblene	s
hyperflexiblenes	s
hyperflexibleness	e
hyperflexiblenesse	s
hyperfo	r
hyperfor	m
hyperfu	n
hyperfun	c
hyperfunc	t
hyperfunct	i
hyperfuncti	o
hyperfunctio	n
hyperfunction	ais
hyperfunctiona	l
hyperfunctional	l
hyperfunctionall	y
hyperfunctioni	n
hyperfunctionin	g
hyperg	aelr
hyperga	m
hypergam	mo
hypergamm	a
hypergamma	g
hypergammag	l
hypergammagl	o
hypergammaglo	b
hypergammaglob	u
hypergammaglobu	l
hypergammaglobul	i
hypergammaglobuli	n
hypergammaglobulin	a
hypergammaglobulina	e
hypergammaglobulinae	m
hypergammaglobulinaem	i
hypergammaglobulinaemi	ac
hypergamo	u
hypergamou	s
hyperge	nou
hypergen	e
hypergene	st
hypergenes	ei
hypergenese	s
hypergenesi	s
hypergenet	i
hypergeneti	c
hypergenetic	a
hypergenetica	l
hypergenetical	ln
hypergeneticall	y
hypergeneticaln	e
hypergeneticalne	s
hypergeneticalnes	s
hypergeneticalness	e
hypergeneticalnesse	s
hypergeo	m
hypergeom	e
hypergeome	t
hypergeomet	r
hypergeometr	i
hypergeometri	c
hypergeometric	a
hypergeometrica	l
hypergeu	s
hypergeus	i
hypergeusi	a
hypergl	u
hyperglu	o
hypergluo	n
hypergr	a
hypergra	m
hypergram	m
hypergramm	a
hypergramma	t
hypergrammat	i
hypergrammati	c
hypergrammatic	a
hypergrammatica	l
hypergrammatical	ln
hypergrammaticall	y
hypergrammaticaln	e
hypergrammaticalne	s
hypergrammaticalnes	s
hypergrammaticalness	e
hypergrammaticalnesse	s
hyperh	iy
hyperhi	l
hyperhil	a
hyperhila	r
hyperhilar	i
hyperhilari	ot
hyperhilario	u
hyperhilariou	s
hyperhilarious	ln
hyperhilariousl	y
hyperhilariousn	e
hyperhilariousne	s
hyperhilariousnes	s
hyperhilariousness	e
hyperhilariousnesse	s
hyperhilarit	iy
hyperhilariti	e
hyperhilaritie	s
hyperhy	p
hyperhyp	o
hyperhypo	c
hyperhypoc	r
hyperhypocr	i
hyperhypocri	s
hyperhypocris	iy
hyperhypocrisi	e
hyperhypocrisie	s
hyperi	mnor
hyperim	m
hyperimm	u
hyperimmu	n
hyperimmun	i
hyperimmuni	tz
hyperimmunit	iy
hyperimmuniti	e
hyperimmunitie	s
hyperimmuniz	aei
hyperimmuniza	t
hyperimmunizat	i
hyperimmunizati	o
hyperimmunizatio	n
hyperimmunization	s
hyperimmunize	ds
hyperimmunizi	n
hyperimmunizin	g
hyperin	fnstv
hyperinf	l
hyperinfl	a
hyperinfla	t
hyperinflat	e
hyperinflate	d
hyperinn	e
hyperinne	r
hyperinner	v
hyperinnerv	a
hyperinnerva	t
hyperinnervat	i
hyperinnervati	o
hyperinnervatio	n
hyperinnervation	s
hyperins	u
hyperinsu	l
hyperinsul	i
hyperinsuli	n
hyperinsulin	a
hyperinsulina	e
hyperinsulinae	m
hyperinsulinaem	i
hyperinsulinaemi	ac
hyperint	e
hyperinte	ln
hyperintel	l
hyperintell	ei
hyperintelle	c
hyperintellec	t
hyperintellect	u
hyperintellectu	a
hyperintellectua	l
hyperintellectual	ln
hyperintellectuall	y
hyperintellectualn	e
hyperintellectualne	s
hyperintellectualnes	s
hyperintellectualness	e
hyperintellectualnesse	s
hyperintelli	g
hyperintellig	e
hyperintellige	n
hyperintelligen	ct
hyperintelligenc	e
hyperintelligence	s
hyperintelligent	l
hyperintelligentl	y
hyperinten	s
hyperintens	e
hyperintense	ln
hyperintensel	y
hyperintensen	e
hyperintensene	s
hyperintensenes	s
hyperintenseness	e
hyperintensenesse	s
hyperinv	o
hyperinvo	l
hyperinvol	u
hyperinvolu	t
hyperinvolut	i
hyperinvoluti	o
hyperinvolutio	n
hyperinvolution	s
hyperio	n
hyperir	r
hyperirr	i
hyperirri	t
hyperirrit	a
hyperirrita	b
hyperirritab	l
hyperirritabl	e
hyperk	aei
hyperka	l
hyperkal	a
hyperkala	e
hyperkalae	m
hyperkalaem	i
hyperkalaemi	c
hyperke	r
hyperker	a
hyperkera	t
hyperkerat	o
hyperkerato	t
hyperkeratot	i
hyperkeratoti	c
hyperki	n
hyperkin	e
hyperkine	s
hyperkines	i
hyperkinesi	s
hyperl	eio
hyperle	t
hyperlet	h
hyperleth	a
hyperletha	lr
hyperlethar	g
hyperletharg	iy
hyperlethargi	e
hyperlethargie	s
hyperli	np
hyperlin	k
hyperlink	eis
hyperlinke	d
hyperlinki	n
hyperlinkin	g
hyperlip	i
hyperlipi	d
hyperlipid	a
hyperlipida	e
hyperlipidae	m
hyperlipidaem	i
hyperlipidaemi	ac
hyperlo	g
hyperlog	i
hyperlogi	c
hyperlogic	a
hyperlogica	l
hyperlogical	iln
hyperlogicali	t
hyperlogicalit	iy
hyperlogicaliti	e
hyperlogicalitie	s
hyperlogicall	y
hyperlogicaln	e
hyperlogicalne	s
hyperlogicalnes	s
hyperlogicalness	e
hyperlogicalnesse	s
hyperm	aeinouy
hyperma	gnrs
hypermag	i
hypermagi	c
hypermagic	a
hypermagica	l
hypermagical	l
hypermagicall	y
hyperman	i
hypermani	ac
hypermania	s
hypermanic	s
hypermar	k
hypermark	e
hypermarke	t
hypermarket	s
hypermas	c
hypermasc	u
hypermascu	l
hypermascul	i
hypermasculi	n
hypermasculin	ei
hypermasculine	ln
hypermasculinel	y
hypermasculinen	e
hypermasculinene	s
hypermasculinenes	s
hypermasculineness	e
hypermasculinenesse	s
hypermasculini	t
hypermasculinit	iy
hypermasculiniti	e
hypermasculinitie	s
hyperme	dt
hypermed	i
hypermedi	c
hypermedic	a
hypermedica	t
hypermedicat	i
hypermedicati	o
hypermedicatio	n
hypermedication	s
hypermet	a
hypermeta	bmp
hypermetab	o
hypermetabo	l
hypermetabol	i
hypermetaboli	cs
hypermetabolis	m
hypermetabolism	s
hypermetam	o
hypermetamo	r
hypermetamor	p
hypermetamorp	h
hypermetamorph	i
hypermetamorphi	c
hypermetap	h
hypermetaph	o
hypermetapho	r
hypermetaphor	i
hypermetaphori	c
hypermetaphoric	a
hypermetaphorica	l
hypermi	lr
hypermil	i
hypermili	t
hypermilit	a
hypermilita	n
hypermilitan	t
hypermilitant	l
hypermilitantl	y
hypermir	a
hypermira	c
hypermirac	u
hypermiracu	l
hypermiracul	o
hypermiraculo	u
hypermiraculou	s
hypermiraculous	ln
hypermiraculousl	y
hypermiraculousn	e
hypermiraculousne	s
hypermiraculousnes	s
hypermiraculousness	e
hypermiraculousnesse	s
hypermn	e
hypermne	s
hypermnes	i
hypermnesi	c
hypermo	bdr
hypermob	i
hypermobi	l
hypermobil	ei
hypermobili	t
hypermobilit	iy
hypermobiliti	e
hypermobilitie	s
hypermod	e
hypermode	rs
hypermoder	n
hypermodern	is
hypermoderni	st
hypermodernis	t
hypermodernist	s
hypermodernit	iy
hypermoderniti	e
hypermodernitie	s
hypermodes	t
hypermodest	ln
hypermodestl	y
hypermodestn	e
hypermodestne	s
hypermodestnes	s
hypermodestness	e
hypermodestnesse	s
hypermor	ap
hypermora	l
hypermoral	il
hypermorali	t
hypermoralit	iy
hypermoraliti	e
hypermoralitie	s
hypermorall	y
hypermorp	h
hypermorph	i
hypermorphi	c
hypermu	t
hypermut	a
hypermuta	b
hypermutab	i
hypermutabi	l
hypermutabil	i
hypermutabili	t
hypermutabilit	iy
hypermutabiliti	e
hypermutabilitie	s
hypermy	s
hypermys	t
hypermyst	i
hypermysti	c
hypermystic	a
hypermystica	l
hypermystical	ln
hypermysticall	y
hypermysticaln	e
hypermysticalne	s
hypermysticalnes	s
hypermysticalness	e
hypermysticalnesse	s
hypern	aou
hyperna	t
hypernat	iru
hypernati	o
hypernatio	n
hypernation	a
hypernationa	l
hypernational	i
hypernationali	s
hypernationalis	t
hypernationalist	i
hypernationalisti	c
hypernatr	a
hypernatra	e
hypernatrae	m
hypernatraem	i
hypernatraemi	ac
hypernatu	r
hypernatur	a
hypernatura	l
hypernatural	ln
hypernaturall	y
hypernaturaln	e
hypernaturalne	s
hypernaturalnes	s
hypernaturalness	e
hypernaturalnesse	s
hyperno	r
hypernor	m
hypernorm	a
hypernorma	l
hypernormal	iln
hypernormali	t
hypernormalit	iy
hypernormaliti	e
hypernormalitie	s
hypernormall	y
hypernormaln	e
hypernormalne	s
hypernormalnes	s
hypernormalness	e
hypernormalnesse	s
hypernu	t
hypernut	r
hypernutr	i
hypernutri	t
hypernutrit	i
hypernutriti	o
hypernutritio	n
hypernutrition	s
hypero	enrsx
hyperoe	s
hyperoes	t
hyperoest	r
hyperoestr	o
hyperoestro	g
hyperoestrog	e
hyperoestroge	n
hyperoestrogen	i
hyperoestrogeni	s
hyperoestrogenis	m
hyperor	gt
hyperorg	a
hyperorga	n
hyperorgan	i
hyperorgani	c
hyperort	h
hyperorth	o
hyperortho	d
hyperorthod	o
hyperorthodo	x
hyperos	m
hyperosm	o
hyperosmo	l
hyperosmol	a
hyperosmola	r
hyperox	y
hyperoxy	g
hyperoxyg	e
hyperoxyge	n
hyperoxygen	a
hyperoxygena	t
hyperoxygenat	ei
hyperoxygenate	ds
hyperoxygenati	no
hyperoxygenatin	g
hyperoxygenatio	n
hyperoxygenation	s
hyperp	aehioru
hyperpa	rt
hyperpar	a
hyperpara	t
hyperparat	h
hyperparath	y
hyperparathy	r
hyperparathyr	o
hyperparathyro	i
hyperparathyroi	d
hyperpat	hr
hyperpath	e
hyperpathe	t
hyperpathet	i
hyperpatheti	c
hyperpathetic	a
hyperpathetica	l
hyperpathetical	l
hyperpatheticall	y
hyperpatr	i
hyperpatri	o
hyperpatrio	t
hyperpatriot	i
hyperpatrioti	c
hyperpatriotic	a
hyperpatriotica	l
hyperpatriotical	l
hyperpatrioticall	y
hyperpe	r
hyperper	fis
hyperperf	e
hyperperfe	c
hyperperfec	t
hyperperfect	i
hyperperfecti	o
hyperperfectio	n
hyperperfection	s
hyperperi	s
hyperperis	t
hyperperist	a
hyperperista	l
hyperperistal	s
hyperperistals	ei
hyperperistalse	s
hyperperistalsi	s
hyperpers	o
hyperperso	n
hyperperson	a
hyperpersona	l
hyperpersonal	l
hyperpersonall	y
hyperph	ao
hyperpha	l
hyperphal	a
hyperphala	n
hyperphalan	g
hyperphalang	iy
hyperphalangi	as
hyperphalangis	m
hyperpho	rs
hyperphor	i
hyperphori	ac
hyperphos	p
hyperphosp	h
hyperphosph	a
hyperphospha	t
hyperphosphat	a
hyperphosphata	e
hyperphosphatae	m
hyperphosphataem	i
hyperphosphataemi	ac
hyperpi	gt
hyperpig	m
hyperpigm	e
hyperpigme	n
hyperpigmen	t
hyperpigment	ae
hyperpigmenta	t
hyperpigmentat	i
hyperpigmentati	o
hyperpigmentatio	n
hyperpigmentation	s
hyperpigmente	d
hyperpit	u
hyperpitu	i
hyperpitui	t
hyperpituit	a
hyperpituita	r
hyperpituitar	y
hyperpo	l
hyperpol	a
hyperpola	r
hyperpolar	i
hyperpolari	z
hyperpolariz	a
hyperpolariza	t
hyperpolarizat	i
hyperpolarizati	o
hyperpolarizatio	n
hyperpr	o
hyperpro	dlm
hyperprod	u
hyperprodu	c
hyperproduc	et
hyperproduce	r
hyperproducer	s
hyperproduct	i
hyperproducti	o
hyperproductio	n
hyperproduction	s
hyperprol	a
hyperprola	c
hyperprolac	t
hyperprolact	i
hyperprolacti	n
hyperprolactin	a
hyperprolactina	e
hyperprolactinae	m
hyperprolactinaem	i
hyperprolactinaemi	ac
hyperprom	i
hyperpromi	s
hyperpromis	c
hyperpromisc	u
hyperpromiscu	o
hyperpromiscuo	u
hyperpromiscuou	s
hyperpromiscuous	ln
hyperpromiscuousl	y
hyperpromiscuousn	e
hyperpromiscuousne	s
hyperpromiscuousnes	s
hyperpromiscuousness	e
hyperpromiscuousnesse	s
hyperpu	r
hyperpur	ei
hyperpure	ln
hyperpurel	y
hyperpuren	e
hyperpurene	s
hyperpurenes	s
hyperpureness	e
hyperpurenesse	s
hyperpuri	t
hyperpurit	iy
hyperpuriti	e
hyperpuritie	s
hyperr	aehio
hyperra	t
hyperrat	i
hyperrati	o
hyperratio	n
hyperration	a
hyperrationa	l
hyperrational	il
hyperrationali	t
hyperrationalit	iy
hyperrationaliti	e
hyperrationalitie	s
hyperrationall	y
hyperre	as
hyperrea	cl
hyperreac	t
hyperreact	io
hyperreacti	v
hyperreactiv	ei
hyperreactivi	t
hyperreactivit	iy
hyperreactiviti	e
hyperreactivitie	s
hyperreacto	r
hyperreactor	s
hyperreal	i
hyperreali	sz
hyperrealis	t
hyperrealist	s
hyperrealiz	ei
hyperrealize	ds
hyperrealizi	n
hyperrealizin	g
hyperres	op
hyperreso	n
hyperreson	a
hyperresona	n
hyperresonan	ct
hyperresonanc	e
hyperresonance	s
hyperresonant	l
hyperresonantl	y
hyperresp	o
hyperrespo	n
hyperrespon	s
hyperrespons	i
hyperresponsi	v
hyperresponsiv	e
hyperresponsive	ln
hyperresponsivel	y
hyperresponsiven	e
hyperresponsivene	s
hyperresponsivenes	s
hyperresponsiveness	e
hyperresponsivenesse	s
hyperrh	y
hyperrhy	t
hyperrhyt	h
hyperrhyth	m
hyperrhythm	i
hyperrhythmi	c
hyperrhythmic	a
hyperrhythmica	l
hyperri	d
hyperrid	i
hyperridi	c
hyperridic	u
hyperridicu	l
hyperridicul	o
hyperridiculo	u
hyperridiculou	s
hyperridiculous	ln
hyperridiculousl	y
hyperridiculousn	e
hyperridiculousne	s
hyperridiculousnes	s
hyperridiculousness	e
hyperridiculousnesse	s
hyperro	m
hyperrom	a
hyperroma	n
hyperroman	t
hyperromant	i
hyperromanti	c
hyperromantic	as
hyperromantica	l
hyperromantical	l
hyperromanticall	y
hypers	aceoptu
hypersa	il
hypersai	n
hypersain	t
hypersaint	l
hypersaintl	y
hypersal	i
hypersali	nv
hypersalin	ei
hypersalini	t
hypersalinit	iy
hypersaliniti	e
hypersalinitie	s
hypersaliv	a
hypersaliva	t
hypersalivat	i
hypersalivati	o
hypersalivatio	n
hypersalivation	s
hypersc	hr
hypersch	o
hyperscho	l
hyperschol	a
hyperschola	s
hyperscholas	t
hyperscholast	i
hyperscholasti	c
hyperscholastic	a
hyperscholastica	l
hyperscholastical	l
hyperscholasticall	y
hyperscr	u
hyperscru	p
hyperscrup	u
hyperscrupu	l
hyperscrupul	o
hyperscrupulo	su
hyperscrupulos	i
hyperscrupulosi	t
hyperscrupulosit	iy
hyperscrupulositi	e
hyperscrupulositie	s
hyperscrupulou	s
hyperscrupulous	ln
hyperscrupulousl	y
hyperscrupulousn	e
hyperscrupulousne	s
hyperscrupulousnes	s
hyperscrupulousness	e
hyperscrupulousnesse	s
hyperse	cnx
hypersec	r
hypersecr	e
hypersecre	t
hypersecret	ei
hypersecreti	o
hypersecretio	n
hypersecretion	s
hypersen	st
hypersens	iu
hypersensi	bt
hypersensib	i
hypersensibi	l
hypersensibil	i
hypersensibili	t
hypersensibilit	iy
hypersensibiliti	e
hypersensibilitie	s
hypersensit	i
hypersensiti	svz
hypersensitis	a
hypersensitisa	t
hypersensitisat	i
hypersensitisati	o
hypersensitisatio	n
hypersensitiv	ei
hypersensitivi	t
hypersensitivit	y
hypersensitiz	aei
hypersensitiza	t
hypersensitizat	i
hypersensitizati	o
hypersensitizatio	n
hypersensitization	s
hypersensitize	ds
hypersensitizi	n
hypersensitizin	g
hypersensu	ao
hypersensua	l
hypersensual	ln
hypersensuall	y
hypersensualn	e
hypersensualne	s
hypersensualnes	s
hypersensualness	e
hypersensualnesse	s
hypersensuo	u
hypersensuou	s
hypersensuous	ln
hypersensuousl	y
hypersensuousn	e
hypersensuousne	s
hypersensuousnes	s
hypersensuousness	e
hypersensuousnesse	s
hypersent	i
hypersenti	m
hypersentim	e
hypersentime	n
hypersentimen	t
hypersentiment	a
hypersentimenta	l
hypersentimental	l
hypersentimentall	y
hypersex	eu
hypersexe	d
hypersexu	a
hypersexua	l
hypersexual	i
hypersexuali	t
hypersexualit	y
hyperso	cmnp
hypersoc	i
hypersoci	a
hypersocia	l
hypersocial	l
hypersociall	y
hypersom	n
hypersomn	io
hypersomni	c
hypersomno	l
hypersomnol	e
hypersomnole	n
hypersomnolen	ct
hypersomnolenc	e
hypersomnolence	s
hyperson	i
hypersoni	c
hypersop	h
hypersoph	i
hypersophi	s
hypersophis	t
hypersophist	i
hypersophisti	c
hypersophistic	a
hypersophistica	t
hypersophisticat	e
hypersophisticate	d
hypersophisticated	l
hypersophisticatedl	y
hypersp	ehl
hyperspe	c
hyperspec	u
hyperspecu	l
hyperspecul	a
hyperspecula	t
hyperspeculat	i
hyperspeculati	v
hyperspeculativ	e
hyperspeculative	ln
hyperspeculativel	y
hyperspeculativen	e
hyperspeculativene	s
hyperspeculativenes	s
hyperspeculativeness	e
hyperspeculativenesse	s
hypersph	e
hypersphe	r
hyperspher	i
hyperspheri	c
hyperspheric	a
hyperspherica	l
hyperspl	e
hypersple	n
hypersplen	i
hyperspleni	cs
hypersplenis	m
hyperst	ai
hypersta	t
hyperstat	i
hyperstati	c
hypersti	m
hyperstim	u
hyperstimu	l
hyperstimul	a
hyperstimula	t
hyperstimulat	ei
hyperstimulate	ds
hyperstimulati	no
hyperstimulatin	g
hyperstimulatio	n
hyperstimulation	s
hypersu	bs
hypersub	t
hypersubt	l
hypersubtl	e
hypersubtle	n
hypersubtlen	e
hypersubtlene	s
hypersubtlenes	s
hypersubtleness	e
hypersubtlenesse	s
hypersus	cp
hypersusc	e
hypersusce	p
hypersuscep	t
hypersuscept	i
hypersuscepti	b
hypersusceptib	i
hypersusceptibi	l
hypersusceptibil	i
hypersusceptibili	t
hypersusceptibilit	iy
hypersusceptibiliti	e
hypersusceptibilitie	s
hypersusp	i
hypersuspi	c
hypersuspic	i
hypersuspici	o
hypersuspicio	u
hypersuspiciou	s
hypersuspicious	ln
hypersuspiciousl	y
hypersuspiciousn	e
hypersuspiciousne	s
hypersuspiciousnes	s
hypersuspiciousness	e
hypersuspiciousnesse	s
hypert	ehory
hyperte	clnx
hypertec	h
hypertech	n
hypertechn	i
hypertechni	c
hypertechnic	a
hypertechnica	l
hypertechnical	iln
hypertechnicali	t
hypertechnicalit	iy
hypertechnicaliti	e
hypertechnicalitie	s
hypertechnicall	y
hypertechnicaln	e
hypertechnicalne	s
hypertechnicalnes	s
hypertechnicalness	e
hypertechnicalnesse	s
hypertel	o
hypertelo	r
hypertelor	i
hypertelori	s
hyperteloris	m
hyperten	s
hypertens	ei
hypertensi	ov
hypertensio	n
hypertensiv	e
hypertex	t
hyperth	ey
hyperthe	r
hyperther	m
hypertherm	a
hypertherma	l
hyperthermal	l
hyperthermall	y
hyperthy	r
hyperthyr	o
hyperthyro	i
hyperthyroi	d
hyperthyroid	i
hyperthyroidi	cs
hyperthyroidis	m
hyperto	x
hypertox	i
hypertoxi	c
hypertoxic	i
hypertoxici	t
hypertoxicit	iy
hypertoxiciti	e
hypertoxicitie	s
hypertr	aio
hypertra	g
hypertrag	i
hypertragi	c
hypertragic	a
hypertragica	l
hypertragical	l
hypertragicall	y
hypertri	cg
hypertric	h
hypertrich	o
hypertricho	s
hypertrichos	i
hypertrichosi	s
hypertrig	l
hypertrigl	y
hypertrigly	c
hypertriglyc	e
hypertriglyce	r
hypertriglycer	i
hypertriglyceri	d
hypertriglycerid	a
hypertriglycerida	e
hypertriglyceridae	m
hypertriglyceridaem	i
hypertriglyceridaemi	ac
hypertro	p
hypertrop	i
hypertropi	a
hyperty	p
hypertyp	i
hypertypi	c
hypertypic	a
hypertypica	l
hyperu	r
hyperur	b
hyperurb	a
hyperurba	n
hyperurban	i
hyperurbani	s
hyperurbanis	m
hyperv	aio
hyperva	rs
hypervar	i
hypervari	a
hypervaria	b
hypervariab	il
hypervariabi	l
hypervariabil	i
hypervariabili	t
hypervariabilit	iy
hypervariabiliti	e
hypervariabilitie	s
hypervariabl	ey
hypervas	c
hypervasc	u
hypervascu	l
hypervascul	a
hypervascula	r
hypervascular	i
hypervasculari	t
hypervascularit	iy
hypervasculariti	e
hypervascularitie	s
hypervi	grs
hypervig	i
hypervigi	l
hypervigil	a
hypervigila	n
hypervigilan	ct
hypervigilanc	e
hypervigilant	ln
hypervigilantl	y
hypervigilantn	e
hypervigilantne	s
hypervigilantnes	s
hypervigilantness	e
hypervigilantnesse	s
hypervir	u
hyperviru	l
hypervirul	e
hypervirule	n
hypervirulen	t
hypervirulent	l
hypervirulentl	y
hypervis	c
hypervisc	o
hypervisco	su
hyperviscos	i
hyperviscosi	t
hyperviscosit	iy
hyperviscositi	e
hyperviscositie	s
hyperviscou	s
hypervo	l
hypervol	u
hypervolu	m
hypervolum	i
hypervolumi	n
hypervolumin	o
hypervolumino	u
hypervoluminou	s
hypervoluminous	ln
hypervoluminousl	y
hypervoluminousn	e
hypervoluminousne	s
hypervoluminousnes	s
hypervoluminousness	e
hypervoluminousnesse	s
hyperw	e
hyperwe	a
hyperwea	k
hyph	ae
hyphe	n
hyphen	aeils
hyphena	t
hyphenat	ei
hyphenate	ds
hyphenati	no
hyphenatin	g
hyphenatio	n
hyphenation	s
hyphene	d
hypheni	cn
hyphenin	g
hyphenl	e
hyphenle	s
hyphenles	s
hypi	n
hypin	g
hypn	o
hypno	lst
hypnol	o
hypnolo	g
hypnolog	y
hypnos	ei
hypnose	s
hypnosi	s
hypnot	hi
hypnoth	e
hypnothe	r
hypnother	a
hypnothera	p
hypnotherap	y
hypnoti	csz
hypnotis	eimt
hypnotise	ds
hypnotisi	n
hypnotisin	g
hypnotiz	aei
hypnotiza	bt
hypnotizab	il
hypnotizabi	l
hypnotizabil	i
hypnotizabili	t
hypnotizabilit	iy
hypnotizabiliti	e
hypnotizabilitie	s
hypnotizabl	e
hypnotizat	i
hypnotizati	o
hypnotizatio	n
hypnotize	drs
hypnotizi	n
hypnotizin	g
hypo	abcdfgklmnpstv
hypoa	cel
hypoac	t
hypoact	i
hypoacti	v
hypoactiv	ei
hypoactivi	t
hypoactivit	y
hypoae	s
hypoaes	t
hypoaest	h
hypoaesth	e
hypoaesthe	s
hypoaesthes	i
hypoaesthesi	a
hypoal	g
hypoalg	e
hypoalge	s
hypoalges	i
hypoalgesi	a
hypob	lr
hypobl	a
hypobla	s
hypoblas	t
hypoblast	i
hypoblasti	c
hypobr	o
hypobro	m
hypobrom	io
hypobromi	t
hypobromit	e
hypobromo	u
hypobromou	s
hypoc	aehor
hypoca	pu
hypocap	n
hypocapn	i
hypocapni	ac
hypocau	s
hypocaus	t
hypoce	l
hypocel	l
hypocell	u
hypocellu	l
hypocellul	a
hypocellula	r
hypocellular	i
hypocellulari	t
hypocellularit	y
hypoch	lo
hypochl	o
hypochlo	r
hypochlor	h
hypochlorh	y
hypochlorhy	d
hypochlorhyd	r
hypochlorhydr	i
hypochlorhydri	c
hypocho	n
hypochon	d
hypochond	r
hypochondr	i
hypochondri	a
hypochondria	cs
hypochondriac	ais
hypochondriaca	l
hypochondriaci	s
hypochondriacis	m
hypoco	n
hypocon	ei
hypoconi	d
hypocr	ei
hypocre	t
hypocret	i
hypocreti	n
hypocri	st
hypocris	iy
hypocrisi	e
hypocrisie	s
hypocrit	ei
hypocrite	s
hypocriti	c
hypocritic	a
hypocritica	l
hypocritical	l
hypocriticall	y
hypod	ei
hypode	r
hypoder	m
hypoderm	i
hypodermi	c
hypodermic	as
hypodermica	l
hypodermical	l
hypodermicall	y
hypodi	g
hypodig	m
hypof	u
hypofu	n
hypofun	c
hypofunc	t
hypofunct	i
hypofuncti	o
hypofunctio	n
hypofunction	a
hypofunctiona	l
hypog	ao
hypoga	ms
hypogam	o
hypogamo	u
hypogamou	s
hypogas	t
hypogast	r
hypogastr	i
hypogastri	c
hypogo	n
hypogon	a
hypogona	d
hypogonad	o
hypogonado	t
hypogonadot	r
hypogonadotr	o
hypogonadotro	p
hypogonadotrop	h
hypogonadotroph	i
hypogonadotrophi	c
hypok	i
hypoki	n
hypokin	e
hypokine	t
hypokinet	i
hypokineti	c
hypol	e
hypole	m
hypolem	n
hypolemn	i
hypolemni	s
hypolemnis	c
hypolemnisc	u
hypolemniscu	s
hypom	aio
hypoma	gn
hypomag	n
hypomagn	e
hypomagne	s
hypomagnes	a
hypomagnesa	e
hypomagnesae	m
hypomagnesaem	i
hypomagnesaemi	ac
hypoman	i
hypomani	ac
hypomania	c
hypomi	x
hypomix	o
hypomixo	l
hypomixol	y
hypomixoly	d
hypomixolyd	i
hypomixolydi	a
hypomixolydia	n
hypomo	r
hypomor	p
hypomorp	h
hypomorph	i
hypomorphi	c
hypon	ao
hypona	st
hyponas	t
hyponast	i
hyponasti	c
hyponat	r
hyponatr	a
hyponatra	e
hyponatrae	m
hyponatraem	i
hyponatraemi	ac
hypono	m
hyponom	e
hypop	ahi
hypopa	r
hypopar	a
hypopara	t
hypoparat	h
hypoparath	y
hypoparathy	r
hypoparathyr	o
hypoparathyro	i
hypoparathyroi	d
hypoph	aory
hypopha	l
hypophal	a
hypophala	n
hypophalan	g
hypophalang	y
hypopho	s
hypophos	p
hypophosp	h
hypophosph	aio
hypophospha	t
hypophosphat	a
hypophosphata	e
hypophosphatae	m
hypophosphataem	i
hypophosphataemi	ac
hypophosphi	t
hypophosphit	e
hypophospho	r
hypophosphor	io
hypophosphori	c
hypophosphoro	u
hypophosphorou	s
hypophr	y
hypophry	g
hypophryg	i
hypophrygi	a
hypophrygia	n
hypophy	s
hypophys	i
hypophysi	s
hypopi	gt
hypopig	m
hypopigm	e
hypopigme	n
hypopigmen	t
hypopigment	a
hypopigmenta	t
hypopigmentat	i
hypopigmentati	o
hypopigmentatio	n
hypopit	u
hypopitu	i
hypopitui	t
hypopituit	a
hypopituita	r
hypopituitar	y
hypos	p
hyposp	l
hypospl	e
hyposple	n
hyposplen	i
hypospleni	cs
hyposplenis	m
hypot	ehr
hypote	n
hypoten	su
hypotens	i
hypotensi	o
hypotensio	n
hypotenu	s
hypotenus	e
hypotenuse	s
hypoth	aey
hypotha	l
hypothal	al
hypothala	m
hypothalam	u
hypothalamu	s
hypothall	u
hypothallu	s
hypothe	cnrst
hypothec	ai
hypotheca	t
hypothecat	e
hypotheci	u
hypotheciu	m
hypothen	u
hypothenu	s
hypothenus	e
hypothenuse	s
hypother	m
hypotherm	i
hypothermi	a
hypothermia	s
hypothes	ei
hypothese	s
hypothesi	sz
hypothesis	t
hypothesist	s
hypothesiz	ei
hypothesize	drs
hypothesizi	n
hypothesizin	g
hypothet	i
hypotheti	c
hypothetic	a
hypothetica	l
hypothetical	ls
hypotheticall	y
hypothy	r
hypothyr	o
hypothyro	i
hypothyroi	d
hypothyroid	i
hypothyroidi	cs
hypothyroidis	m
hypotr	io
hypotri	c
hypotric	h
hypotrich	o
hypotricho	su
hypotrichos	i
hypotrichosi	s
hypotrichou	s
hypotro	c
hypotroc	h
hypotroch	o
hypotrocho	i
hypotrochoi	d
hypov	i
hypovi	t
hypovit	a
hypovita	m
hypovitam	i
hypovitami	n
hypovitamin	o
hypovitamino	s
hypovitaminos	i
hypovitaminosi	s
hyps	o
hypso	m
hypsom	e
hypsome	t
hypsomet	r
hypsometr	y
hyr	apvy
hyra	x
hys	ostv
hyso	n
hyss	o
hysso	p
hyst	e
hyste	r
hyster	eio
hystere	cs
hysterec	t
hysterect	o
hysterecto	m
hysterectom	y
hysteres	i
hysteresi	s
hysteri	ac
hysteria	s
hysteric	as
hysterica	l
hysterical	l
hystericall	y
hystero	l
hysterol	o
hysterolo	g
hysterolog	y
hyt	e
hyte	r
hyter	a
hyu	n
hyun	d
hyund	a
hyunda	i
hyx	v
hyy	ar
hyyr	v
hyz	u
hz	adefjlnopxz
hza	s
hzd	j
hze	q
hzf	e
hzj	rsv
hzl	rv
hzo	pv
hzp	p
hzz	rv
