j	abcdefghijklmnopqrstuvwxyz
ja	abcdegijklmnopqrstuvwxyz
jab	bilos
jabb	ei
jabbe	dr
jabbi	n
jabbin	g
jabbing	l
jabbingl	y
jabi	r
jabir	u
jabl	o
jablo	n
jablon	s
jablons	k
jablonsk	y
jabo	t
jac	aikoqu
jaca	lr
jacar	a
jacara	n
jacaran	d
jacarand	a
jaci	n
jacin	t
jacint	h
jack	abdehiklmpsy
jacka	lnrs
jackal	s
jackan	a
jackana	p
jackanap	e
jackanape	s
jackar	o
jackaro	o
jackas	s
jackb	o
jackbo	o
jackboo	t
jackd	a
jackda	w
jacke	rst
jacker	s
jackes	t
jacket	els
jackete	d
jacketl	ei
jacketle	s
jacketles	s
jacketli	k
jacketlik	e
jackh	a
jackha	m
jackham	m
jackhamm	e
jackhamme	r
jackhammer	eis
jackhammere	d
jackhammeri	n
jackhammerin	g
jacki	en
jackin	g
jackk	n
jackkn	i
jackkni	fv
jackknif	ei
jackknife	ds
jackknifi	n
jackknifin	g
jackkniv	e
jackknive	s
jackl	ei
jackle	g
jackli	g
jacklig	h
jackligh	t
jackm	a
jackma	n
jackp	o
jackpo	t
jacks	cot
jacksc	r
jackscr	e
jackscre	w
jackso	n
jackson	isv
jacksoni	a
jacksonia	n
jacksonv	i
jacksonvi	l
jacksonvil	l
jacksonvill	e
jackst	r
jackstr	a
jackstra	w
jaco	bn
jacob	eisuy
jacobe	a
jacobea	n
jacobi	ant
jacobia	n
jacobin	i
jacobini	sz
jacobinis	m
jacobiniz	e
jacobit	e
jacobs	eo
jacobse	n
jacobso	n
jacobu	s
jacon	e
jacone	t
jacq	u
jacqu	e
jacque	ls
jacquel	i
jacqueli	n
jacquelin	e
jacu	lz
jacul	a
jacula	t
jaculat	e
jacuz	z
jacuzz	i
jad	eio
jade	dils
jaded	ln
jadedl	y
jadedn	e
jadedne	s
jadednes	s
jadedness	e
jadednesse	s
jadei	t
jadeit	e
jadel	i
jadeli	k
jadelik	e
jadi	ns
jadin	eg
jadine	s
jadines	s
jadis	h
jadish	ln
jadishl	y
jadishn	e
jadishne	s
jadishnes	s
jae	gv
jaeg	e
jaege	r
jag	gu
jagg	ei
jagge	dr
jagged	eln
jaggede	rs
jaggedes	t
jaggedl	y
jaggedn	e
jaggedne	s
jaggednes	s
jaggedness	e
jaggednesse	s
jagger	y
jaggi	e
jaggie	s
jagu	a
jagua	r
jaguar	s
jai	lmv
jail	abeilos
jaila	b
jailab	l
jailabl	e
jailb	i
jailbi	r
jailbir	d
jaile	dr
jailer	es
jailere	s
jaileres	s
jailers	h
jailersh	i
jailershi	p
jaili	n
jailin	g
jaill	ei
jaille	s
jailles	s
jailli	k
jaillik	e
jailo	r
jailor	s
jaim	e
jaj	aqw
jaja	v
jak	aepv
jaka	r
jakar	t
jakart	a
jake	s
jal	aov
jala	p
jalo	u
jalou	s
jalous	i
jalousi	e
jam	abeilms
jama	i
jamai	c
jamaic	a
jamaica	n
jamb	a
jamba	l
jambal	a
jambala	y
jambalay	a
jame	s
james	ot
jameso	n
jamest	o
jamesto	w
jamestow	n
jami	e
jaml	i
jamli	k
jamlik	e
jamm	aei
jamma	b
jammab	l
jammabl	e
jamme	dr
jammer	s
jammi	en
jammie	rs
jammies	t
jammin	eg
jammine	s
jammines	s
jan	egiosu
jane	dist
janed	o
janedo	e
janei	r
janeir	o
janes	v
janesv	i
janesvi	l
janesvil	l
janesvill	e
jang	l
jangl	eiy
jangle	drs
jangler	s
jangli	n
janglin	g
jani	cstz
janic	e
janit	or
janito	r
janitor	eis
janitore	d
janitori	an
janitoria	l
janitorin	g
janitors	h
janitorsh	i
janitorshi	p
janitr	ei
janitre	s
janitres	s
janitri	x
janiz	a
janiza	r
janizar	y
jano	s
jans	e
janse	n
jansen	i
janseni	s
jansenis	t
janu	as
janua	r
januar	iy
januari	e
januarie	s
january	s
jao	bpr
jap	aeo
japa	n
japan	eio
japane	s
japanes	e
japani	sz
japanis	e
japaniz	aei
japaniza	t
japanizat	i
japanizati	o
japanizatio	n
japanization	s
japanize	ds
japanizi	n
japanizin	g
japano	l
japanol	o
japanolo	g
japanolog	y
japo	n
japon	i
japoni	c
japonic	a
jaq	bcefghkopstv
jaqb	v
jaqc	v
jaqe	rv
jaqf	v
jar	efglorsv
jare	d
jarf	u
jarfu	l
jarful	s
jarg	o
jargo	no
jargon	eisy
jargone	delrs
jargonee	r
jargoneer	s
jargonel	l
jargonell	e
jargones	q
jargonesq	u
jargonesqu	e
jargoni	cns
jargonin	g
jargonis	ht
jargonist	is
jargonisti	c
jargoo	n
jargoon	s
jarl	e
jarle	s
jarles	s
jaro	v
jarov	i
jarovi	sz
jarovis	e
jaroviz	e
jarr	ei
jarre	d
jarri	n
jarrin	g
jarring	l
jarringl	y
jars	f
jarsf	u
jarsfu	l
jarv	i
jarvi	ns
jas	emopt
jasm	i
jasmi	n
jasmin	e
jaso	n
jasp	e
jaspe	r
jast	r
jastr	o
jastro	w
jat	o
jau	nr
jaun	dt
jaund	i
jaundi	c
jaundic	ei
jaundice	ds
jaundici	n
jaundicin	g
jaunt	isy
jaunti	ln
jauntil	y
jauntin	e
jauntine	s
jauntines	s
jav	aev
java	densv
javad	e
javade	v
javadev	e
javadeve	l
javadevel	o
javadevelo	p
javadevelop	m
javadevelopm	e
javadevelopme	n
javadevelopmen	t
javadevelopment	k
javadevelopmentk	i
javadevelopmentki	t
javae	e
javan	e
javane	s
javanes	e
javas	c
javasc	r
javascr	i
javascri	p
javascrip	t
javav	i
javavi	r
javavir	t
javavirt	u
javavirtu	a
javavirtua	l
javavirtual	m
javavirtualm	a
javavirtualma	c
javavirtualmac	h
javavirtualmach	i
javavirtualmachi	n
javavirtualmachin	e
jave	l
javel	i
javeli	n
javelin	eis
javeline	de
javelinee	r
javelini	n
javelinin	g
jaw	beilsy
jawb	or
jawbo	n
jawbon	ei
jawbone	drs
jawboni	n
jawbonin	g
jawbr	e
jawbre	a
jawbrea	k
jawbreak	e
jawbreake	r
jawe	dr
jawi	n
jawin	g
jawl	ei
jawle	s
jawles	s
jawli	k
jawlik	e
jax	iux
jaxu	v
jay	chksw
jayc	e
jayce	e
jaycee	s
jayw	a
jaywa	l
jaywal	k
jaywalk	e
jaywalke	r
jaz	z
jazz	eilmy
jazze	rs
jazzer	s
jazzes	t
jazzi	ln
jazzil	y
jazzin	g
jazzl	i
jazzli	k
jazzlik	e
jazzm	a
jazzma	n
jb	abcdeghijklmnopqrstuvwxyz
jba	frsv
jbb	bey
jbd	v
jbe	abefruv
jbee	v
jbef	v
jbg	bo
jbh	aikm
jbk	imrvx
jbl	duv
jbn	fhlpv
jbnf	v
jbo	hrsv
jboh	v
jbor	v
jbos	s
jbp	dv
jbq	jp
jbt	brv
jbtb	v
jbu	h
jbv	v
jbw	fu
jbx	u
jby	o
jc	bcdefgijklmnoprstuwxy
jcb	bk
jcd	j
jce	bceqruv
jci	e
jcj	o
jcjo	v
jck	v
jcl	v
jcn	ckrtv
jcnc	v
jcnt	v
jco	gl
jcr	ks
jcs	bdfhilprtvwz
jcsb	v
jcsd	v
jcsf	rv
jcsh	v
jcst	v
jcsw	rv
jct	v
jcu	a
jcw	s
jcy	o
jd	abcdefghijklmnoqrtuvwxy
jdb	cfrsv
jdc	r
jdd	du
jddd	v
jde	emrsuvz
jdf	uv
jdg	vz
jdi	l
jdj	bcdefglqrstuvwz
jdk	d
jdl	rsv
jdm	r
jdn	flm
jdo	rv
jdq	l
jdr	gksuv
jdt	o
jdu	fkp
jdv	dm
jdw	v
jdx	x
jdy	dv
je	abdefghijklmnopqrstuvwxz
jea	flnv
jeal	o
jealo	u
jealou	s
jealous	ilny
jealousi	e
jealousie	s
jealousl	y
jealousn	e
jealousne	s
jealousnes	s
jealousness	e
jealousnesse	s
jean	ns
jeann	ei
jeanni	e
jeb	rv
jed	biq
jedi	s
jedis	w
jedisw	a
jediswa	p
jee	dfmprsv
jeep	s
jeer	eis
jeere	dr
jeerer	s
jeeri	n
jeerin	g
jeering	ls
jeeringl	y
jeev	ev
jeeve	s
jef	df
jeff	er
jeffe	r
jeffer	s
jeffers	o
jefferso	n
jefferson	i
jeffersoni	a
jeffersonia	n
jeffersonian	s
jeffr	e
jeffre	y
jeg	bfruv
jeh	aou
jeha	d
jehad	s
jeho	v
jehov	a
jehova	h
jei	a
jej	u
jeju	n
jejun	eu
jejunu	m
jek	vy
jeky	l
jekyl	l
jel	lsv
jell	ioy
jelli	ef
jellie	drs
jellies	t
jellif	y
jelly	fgil
jellyf	i
jellyfi	ns
jellyfis	h
jellyfish	e
jellyfishe	s
jellyg	r
jellygr	a
jellygra	p
jellygrap	h
jellyi	n
jellyin	g
jellyl	i
jellyli	k
jellylik	e
jels	o
jelso	f
jelsof	t
jen	bknrsuv
jenb	v
jenk	i
jenki	n
jenkin	s
jenn	aeiy
jenne	t
jenni	efn
jennie	s
jennif	e
jennife	r
jennin	g
jenning	s
jens	e
jense	n
jeo	pqt
jeop	a
jeopa	r
jeopar	d
jeopard	iy
jeopardi	esz
jeopardie	s
jeopardis	ei
jeopardise	ds
jeopardisi	n
jeopardisin	g
jeopardiz	ei
jeopardize	ds
jeopardizi	n
jeopardizin	g
jep	v
jer	beikorsuv
jerb	o
jerbo	a
jere	ms
jerem	iy
jeremi	a
jeremia	dh
jeri	c
jeric	h
jerich	o
jerk	eiswy
jerke	drs
jerker	s
jerkes	t
jerki	n
jerkin	eg
jerkine	s
jerkines	s
jerking	ls
jerkingl	y
jerkw	a
jerkwa	t
jerkwat	e
jerkwate	r
jero	bm
jerob	o
jerobo	a
jeroboa	m
jerom	e
jerr	y
jers	e
jerse	y
jersey	aeis
jerseya	n
jerseyan	s
jerseye	d
jerseyi	t
jerseyit	e
jerseyite	s
jeru	s
jerus	a
jerusa	l
jerusal	e
jerusale	m
jes	istu
jess	eiy
jessi	ce
jessic	a
jest	eis
jeste	dr
jesti	n
jestin	g
jesu	is
jesui	t
jesuit	is
jesuiti	csz
jesuitic	a
jesuitica	l
jesuitis	m
jesuitiz	ei
jesuitize	ds
jesuitizi	n
jesuitizin	g
jesus	ce
jesusc	h
jesusch	r
jesuschr	i
jesuschri	s
jesuschris	t
jesuse	s
jet	blprst
jetb	r
jetbr	a
jetbra	i
jetbrai	n
jetbrain	s
jetbrains	m
jetbrainsm	o
jetbrainsmo	n
jetbrainsmon	o
jetl	ai
jetla	g
jetlag	s
jetli	kn
jetlik	e
jetlin	e
jetline	r
jetp	o
jetpo	r
jetpor	t
jets	ak
jetsa	m
jetsk	i
jett	eiy
jette	d
jetti	ens
jettie	drs
jetties	t
jettin	eg
jettine	s
jettines	s
jettiness	e
jettinesse	s
jetting	l
jettingl	y
jettis	o
jettiso	n
jetty	i
jettyi	n
jettyin	g
jeu	d
jev	mortu
jew	efisuvy
jewe	dlst
jewel	eilrsw
jewele	dr
jeweli	n
jewelin	g
jewell	ei
jewelle	dr
jeweller	sy
jewelli	kn
jewellik	e
jewellin	g
jewelr	iy
jewelri	e
jewelrie	s
jewelw	e
jewelwe	e
jewelwee	d
jewes	s
jewet	t
jewf	i
jewfi	s
jewfis	h
jewi	ns
jewin	g
jewis	hm
jewish	n
jewishn	e
jewishne	s
jewishnes	s
jewu	v
jez	v
jf	abcdefjklmnopsuvwxy
jfa	dv
jfb	ruv
jfd	dgv
jfe	deklt
jff	dkoruv
jfk	a
jfl	b
jfn	cdghnq
jfnn	v
jfo	o
jfp	rv
jfs	uv
jfu	afrvz
jfv	az
jfw	v
jfx	v
jfy	gu
jfyu	v
jg	begijlnoqruvxy
jgb	v
jge	a
jgg	irv
jgi	frsuv
jgj	rvy
jgl	rv
jgn	abfhoqrsv
jgnf	v
jgo	rv
jgq	iv
jgr	y
jgu	a
jgy	rv
jh	adefgjux
jha	rv
jhd	de
jhe	e
ji	abefghijlmnoqrtuvxz
jia	v
jib	bes
jibb	ei
jibbe	dr
jibber	s
jibbi	n
jibbin	g
jif	f
jiff	y
jig	gsu
jigg	eil
jigge	dr
jigger	e
jiggere	d
jiggi	n
jiggin	g
jiggl	ei
jiggle	drs
jiggler	s
jiggli	en
jigglie	rs
jigglies	t
jigglin	g
jigs	a
jigsa	w
jigsaw	eins
jigsawe	d
jigsawi	n
jigsawin	g
jigu	v
jih	a
jiha	d
jihad	s
jil	lt
jim	beims
jime	n
jimen	e
jimene	z
jimi	n
jimin	y
jimm	iy
jimmi	e
jims	o
jimso	n
jimson	w
jimsonw	e
jimsonwe	e
jimsonwee	d
jin	gjnrvx
jing	lo
jingl	eiy
jingle	drs
jingler	s
jingli	en
jinglie	rs
jinglies	t
jinglin	g
jingling	l
jinglingl	y
jingo	i
jingoi	s
jingois	m
jinj	a
jinn	y
jinr	i
jinri	k
jinrik	is
jinriki	s
jinrikis	h
jinrikish	a
jinriks	h
jinriksh	a
jinx	ei
jinxe	s
jinxi	n
jinxin	g
jiq	iux
jir	p
jit	nt
jitn	e
jitne	y
jitt	e
jitte	r
jitter	bisy
jitterb	u
jitterbu	g
jitteri	en
jitterie	rs
jitteries	t
jitterin	e
jitterine	s
jitterines	s
jitteriness	e
jitterinesse	s
jiv	e
jiz	z
jj	abcdefgjkmnqrtuvxz
jja	qv
jjb	bgtv
jjc	bikrs
jjd	gq
jje	dgz
jjg	n
jjj	rv
jjm	bt
jjmb	v
jjn	dfgrsvyz
jjq	absu
jjr	s
jjt	b
jjx	b
jk	abcdefghijklmnortvwxyz
jka	fprsv
jkb	kl
jkd	rv
jke	berv
jkf	v
jkh	v
jki	rv
jkk	d
jkl	bkorsv
jko	z
jkr	l
jkw	v
jkz	v
jl	abdefghjklnopqrstuvwxyz
jla	v
jlb	hijmo
jlbh	v
jld	dr
jle	bno
jlh	optz
jlj	k
jlk	rv
jll	bsv
jln	fnotw
jlno	v
jlo	ekmopstvw
jlp	arsuv
jlr	bf
jls	v
jlt	hs
jlu	alrv
jlw	jqsv
jlx	euv
jly	y
jlz	iopr
jm	abcegijklmnopqrtuxy
jma	d
jmb	g
jmc	s
jmcs	v
jme	befhtv
jmeb	rv
jmef	v
jmet	e
jmete	r
jmg	p
jmi	z
jmj	s
jml	bfhlt
jmlb	rsv
jmlf	v
jmlt	v
jmm	mru
jmn	v
jmo	f
jmp	o
jmr	v
jn	abcefghijklmnopqrstuvwxyz
jna	dv
jnb	cdefgiorstvwz
jnbc	v
jnbd	rv
jnbe	v
jnbf	v
jnbg	rv
jnbi	v
jnc	bprv
jncb	v
jne	eorsvz
jnee	v
jnf	bhlorv
jng	rv
jnh	hot
jni	rv
jnj	ksvz
jnk	b
jnl	i
jnm	b
jnn	d
jno	abel
jnp	bdo
jnq	hz
jnr	cdefgirstvz
jnrf	v
jnrg	v
jns	bhprsv
jnsb	rv
jnss	v
jnv	v
jnw	u
jny	bdrtvw
jnz	bdfhv
jo	abcdefghijklmnoprstuvwxyz
joa	enqrv
joan	n
joann	ae
joaq	u
joaqu	i
joaqui	n
job	bflrst
jobb	ei
jobbe	dr
jobber	y
jobbi	s
jobbis	h
jobf	v
jobl	e
joble	s
jobles	s
jobless	en
joblesse	s
joblessn	e
joblessne	s
joblessnes	s
joblessness	e
joblessnesse	s
jobr	e
jobre	l
jobs	t
jobst	e
jobste	r
jobt	i
jobti	t
jobtit	l
jobtitl	e
joc	aklou
joca	s
jocas	t
jocast	a
jock	eos
jocke	ty
jocket	t
jockett	e
jockey	eils
jockeye	d
jockeyi	ns
jockeyin	g
jockeyis	h
jockeyl	i
jockeyli	k
jockeylik	e
jockeys	h
jockeysh	i
jockeyshi	p
jockeyship	s
jocks	t
jockst	r
jockstr	a
jockstra	p
joco	s
jocos	ei
jocosi	t
jocosit	y
jocu	ln
jocul	a
jocula	r
jocun	d
jocund	i
jocundi	t
jocundit	y
jod	hry
jodh	p
jodhp	u
jodhpu	r
jodhpur	es
jodhpure	d
joe	lsy
joey	s
jof	k
jog	gs
jogg	eil
jogge	dr
jogger	s
joggi	n
joggin	g
joggl	e
joh	anv
joha	n
johan	ns
johann	ae
johanne	s
johannes	b
johannesb	u
johannesbu	r
johannesbur	g
johans	eo
johanse	n
johanso	n
john	dnsw
johnd	o
johndo	e
johndoe	s
johnn	iy
johnni	e
johns	eot
johnse	n
johnso	n
johnson	i
johnsoni	a
johnsonia	n
johnst	o
johnsto	nw
johnstow	n
johnw	i
johnwi	c
johnwic	k
joi	ns
join	adeist
joina	b
joinab	l
joinabl	e
joind	e
joinde	r
joine	dr
joiner	isy
joineri	e
joinerie	s
joini	n
joinin	g
joint	eilnsw
jointe	drs
jointed	ln
jointedl	y
jointedn	e
jointedne	s
jointednes	s
jointedness	e
jointednesse	s
jointes	t
jointi	n
jointin	g
jointl	ey
jointle	s
jointles	s
jointn	e
jointne	s
jointnes	s
jointw	o
jointwo	r
jointwor	m
jois	t
joist	eils
joiste	d
joisti	n
joistin	g
joistl	e
joistle	s
joistles	s
joj	o
jok	aei
joke	delrs
jokel	e
jokele	st
jokeles	s
joker	sy
jokes	o
jokeso	m
jokesom	e
joki	n
jokin	g
joking	l
jokingl	y
jol	bilt
joli	e
jolie	t
joll	aiy
jolli	eflt
jollie	drs
jollies	t
jollif	iy
jollifi	c
jollific	a
jollifica	t
jollificat	i
jollificati	o
jollificatio	n
jollil	y
jollit	y
jolly	i
jollyi	n
jollyin	g
jolt	eilsy
jolte	dr
jolter	hs
jolterh	e
jolterhe	a
jolterhea	d
jolterhead	e
jolterheade	d
jolti	en
joltie	rs
jolties	t
joltin	g
jolting	l
joltingl	y
joltl	e
joltle	s
joltles	s
jom	b
jomb	v
jon	aefoqrv
jona	hst
jonat	h
jonath	a
jonatha	n
jonathan	i
jonathani	z
jonathaniz	a
jonathaniza	t
jonathanizat	i
jonathanizati	o
jonathanizatio	n
jonathanization	s
jone	s
jones	e
jonese	s
jonq	u
jonqu	i
jonqui	l
joo	bjkmrstuv
joom	l
jooml	a
jop	lo
jopl	i
jopli	n
jor	adgjmqruv
jord	arsv
jorda	n
jordan	i
jordani	a
jordania	n
jorg	e
jorge	n
jorgen	s
jorgens	eo
jorgense	n
jorgenso	n
jorq	v
jorr	v
joru	m
jos	ehist
jose	fp
josep	h
joseph	isu
josephi	n
josephin	e
josephs	o
josephso	n
josephu	s
josh	u
joshu	a
josi	a
josia	h
joss	e
josse	r
jost	l
jostl	ei
jostle	dmrs
jostlem	e
jostleme	n
jostlemen	t
jostlement	s
jostler	s
jostli	n
jostlin	g
jot	st
jott	eiy
jotte	dr
jotti	n
jottin	g
jou	flnrsv
jouf	v
joul	e
joule	as
joulea	n
joun	c
jounc	e
jour	n
journ	ae
journa	l
journal	aeis
journala	r
journalar	y
journale	st
journales	e
journali	sz
journalis	ehmt
journalism	s
journalist	s
journaliz	ei
journalize	ds
journalizi	n
journalizin	g
journe	y
journey	eims
journeye	dr
journeyer	s
journeyi	n
journeyin	g
journeying	s
journeym	ae
journeyma	n
journeyme	n
jous	t
joust	eis
jouste	d
jousti	n
joustin	g
jov	aei
jova	n
jovan	o
jovano	v
jovanov	i
jovanovi	c
jovanovic	h
jovi	a
jovia	ln
jovial	ilnt
joviali	tz
jovialit	iy
jovialiti	e
jovialitie	s
jovializ	e
joviall	y
jovialn	e
jovialne	s
jovialnes	s
jovialness	e
jovialnesse	s
jovialt	y
jox	b
joy	abcefiloprs
joya	n
joyan	c
joyanc	e
joyb	o
joybo	y
joyc	e
joye	ds
joyf	u
joyfu	l
joyful	ln
joyfull	ey
joyfulle	rs
joyfulles	t
joyfuln	e
joyfulne	s
joyfulnes	s
joyfulness	e
joyfulnesse	s
joyi	n
joyin	g
joyl	e
joyle	s
joyles	s
joyless	ln
joylessl	y
joylessn	e
joylessne	s
joylessnes	s
joylessness	e
joylessnesse	s
joyo	u
joyou	s
joyous	ln
joyousl	y
joyousn	e
joyousne	s
joyousnes	s
joyp	a
joypa	d
joyr	i
joyri	d
joyrid	ei
joyride	r
joyridi	n
joyridin	g
joys	ot
joyso	m
joysom	e
joyst	i
joysti	c
joystic	k
joystick	s
jp	abdefgijklmnopqrsuvxyz
jpa	rsvz
jpb	dw
jpd	fhkoptv
jpe	g
jpf	vw
jpj	v
jpm	dr
jpn	d
jpo	behv
jpob	v
jpp	d
jpq	g
jpr	v
jpu	rv
jpx	v
jpz	w
jq	abdehijklmnopqrstux
jqa	bcrv
jqb	bfrv
jqe	r
jqh	rv
jql	v
jqm	m
jqn	bcnrv
jqo	cw
jqp	o
jqq	q
jqr	u
jqs	frv
jqsf	v
jqu	abcefhrvw
jque	r
jquer	y
jqx	v
jr	abcdefhijkmnopqrstuvxy
jra	o
jrb	btv
jrc	iv
jrd	bdlv
jre	brv
jrf	r
jrh	v
jri	v
jrj	qsv
jrk	v
jrm	beir
jrn	dpv
jro	bhkrv
jrp	g
jrr	jqrv
jrs	stv
jrt	rsv
jru	pruvy
jrv	ru
jrx	ov
jry	du
js	cdefgilmnopqrtuvw
jsd	cl
jse	rv
jsf	s
jsl	v
jsn	cdfhlpqrxy
jsnh	v
jsnr	v
jsny	v
jso	nrsv
jsp	v
jsq	t
jsr	b
jt	adeijmnopqruvx
jta	rv
jtd	bep
jtm	bp
jtmb	v
jtn	bq
jtnb	v
jtq	x
jtr	p
jtu	p
jtv	v
jtx	v
ju	abcdefghijklmnopqrstuvwxy
jua	cfnrsv
juan	i
juani	t
juanit	a
jub	acipv
juba	l
jubi	l
jubil	ae
jubila	nt
jubilan	ct
jubilanc	eiy
jubilanci	e
jubilancie	s
jubilant	l
jubilantl	y
jubilat	ei
jubilati	o
jubilatio	n
jubilation	s
jubile	es
jubilee	s
juc	hv
juch	a
jucha	t
juchat	s
jud	acdegimosy
juda	is
judai	cs
judaic	a
judais	mt
judaism	s
judaist	i
judaisti	c
judd	e
judde	r
judder	eis
juddere	d
judderi	n
judderin	g
jude	a
judea	n
judg	eim
judge	adlmrs
judgea	b
judgeab	l
judgeabl	e
judgel	ei
judgele	s
judgeles	s
judgeli	k
judgelik	e
judgem	e
judgeme	n
judgemen	t
judgement	des
judgementd	a
judgementda	y
judgemente	d
judger	s
judges	h
judgesh	i
judgeshi	p
judgeship	s
judgi	n
judgin	g
judgm	e
judgme	n
judgmen	t
judgment	ds
judgmentd	a
judgmentda	y
judi	ct
judic	ai
judica	t
judicat	ou
judicato	r
judicator	y
judicatu	r
judicatur	e
judici	ao
judicia	lr
judiciar	iy
judiciari	el
judiciarie	s
judiciaril	y
judicio	u
judiciou	s
judicious	ln
judiciousl	y
judiciousn	e
judiciousne	s
judiciousnes	s
judiciousness	e
judiciousnesse	s
judit	h
judm	v
judo	is
judoi	s
judois	t
judoist	s
juds	o
judso	n
jue	aev
juf	d
jug	fglosu
jugf	u
jugfu	l
jugg	eil
jugge	dr
jugger	n
juggern	a
juggerna	u
juggernau	t
juggi	n
juggin	gs
juggl	ei
juggle	dmrs
jugglem	e
juggleme	n
jugglemen	t
juggler	esy
jugglere	s
juggleres	s
juggli	n
jugglin	g
juggling	l
jugglingl	y
jugl	e
jugle	t
jugo	s
jugos	l
jugosl	a
jugosla	v
jugoslav	i
jugoslavi	a
jugu	l
jugul	a
jugula	rt
jugular	s
jugulat	e
jui	c
juic	eiy
juice	dlrs
juicel	e
juicele	s
juiceles	s
juici	eln
juicie	rs
juicies	t
juicil	y
juicin	eg
juicine	s
juicines	s
juiciness	e
juicinesse	s
juj	u
juju	b
jujub	e
juk	e
juke	bs
jukeb	o
jukebo	x
jukebox	e
jukeboxe	s
jul	eiy
jule	s
juli	aeou
julia	n
julie	st
juliu	s
july	s
jum	bepv
jumb	alo
jumba	l
jumbal	s
jumbl	eiy
jumble	dmrs
jumblem	e
jumbleme	n
jumblemen	t
jumblement	s
jumbler	s
jumbli	n
jumblin	g
jumbling	l
jumblingl	y
jume	r
jump	aeimsy
jumpa	b
jumpab	l
jumpabl	e
jumpe	drs
jumper	is
jumperi	s
jumperis	m
jumpes	t
jumpi	eln
jumpie	rs
jumpies	t
jumpil	y
jumpin	eg
jumpine	s
jumpines	s
jumpiness	e
jumpinesse	s
jumping	l
jumpingl	y
jumpm	a
jumpma	s
jumpmas	t
jumpmast	e
jumpmaste	r
jumps	u
jumpsu	i
jumpsui	t
jumpsuit	s
jun	cefgikot
junc	ot
junct	iou
juncti	o
junctio	n
junction	as
junctiona	l
juncto	r
junctu	r
junctur	e
juncture	s
june	as
junea	u
jung	fil
jungf	r
jungfr	a
jungfra	u
jungi	a
jungia	n
jungl	eiy
jungle	ls
junglel	i
jungleli	k
junglelik	e
jungli	s
junglis	t
juni	op
junio	r
junior	s
juniors	h
juniorsh	i
juniorshi	p
junip	e
junipe	r
junk	eimsy
junke	drst
junker	s
junkes	t
junket	e
junkete	e
junketee	r
junki	en
junkie	rs
junkies	t
junkin	g
junkm	a
junkma	n
junky	a
junkya	r
junkyar	d
juno	e
junoe	s
junoes	q
junoesq	u
junoesqu	e
junt	ao
junta	s
jup	iy
jupi	t
jupit	e
jupite	r
jupiter	s
jupy	t
jupyt	e
jupyte	r
juq	v
jur	aeikoprvy
jura	s
juras	s
jurass	i
jurassi	c
juri	des
jurid	i
juridi	c
juridic	a
juridica	l
jurie	drs
juries	t
juris	cdpt
jurisc	o
jurisco	n
juriscon	s
juriscons	u
jurisconsu	l
jurisconsul	t
jurisd	i
jurisdi	c
jurisdic	t
jurisdict	i
jurisdicti	ov
jurisdictio	n
jurisdiction	as
jurisdictiona	l
jurisdictional	l
jurisdictionall	y
jurisdictiv	e
jurisp	r
jurispr	u
jurispru	d
jurisprud	e
jurisprude	n
jurispruden	ct
jurisprudenc	e
jurisprudent	i
jurisprudenti	a
jurisprudentia	l
juro	r
juror	s
jury	ilm
juryi	n
juryin	g
juryl	e
juryle	s
juryles	s
jurym	a
juryma	n
jus	t
just	eilns
juste	drs
juster	s
justes	t
justi	cfn
justic	ei
justice	los
justicel	e
justicele	s
justiceles	s
justiceo	f
justiceof	t
justiceoft	h
justiceofth	e
justiceofthe	p
justiceofthep	e
justiceofthepe	a
justiceofthepea	c
justiceofthepeac	e
justici	a
justicia	b
justiciab	l
justiciabl	e
justif	iy
justifi	ace
justifia	b
justifiab	l
justifiabl	ey
justific	a
justifica	t
justificat	i
justificati	o
justificatio	n
justification	s
justifie	drs
justifier	s
justify	i
justifyi	n
justifyin	g
justifying	l
justifyingl	y
justin	egi
justini	a
justinia	n
justl	y
justn	e
justne	s
justnes	s
justness	e
justnesse	s
jut	beilrst
jute	ls
jutel	i
juteli	k
jutelik	e
juti	s
jutis	h
jutl	a
jutla	n
jutlan	d
jutt	ei
jutte	d
jutti	n
juttin	g
jutting	l
juttingl	y
juu	fhmrtuv
juum	v
juv	dev
juve	n
juven	eis
juvene	s
juvenes	c
juvenesc	e
juvenesce	n
juvenescen	ct
juvenescenc	e
juveni	l
juvenil	ei
juvenile	lns
juvenilel	y
juvenilen	e
juvenilene	s
juvenilenes	s
juvenili	t
juvenilit	y
juvens	c
juvensc	e
juvensce	n
juvenscen	c
juvenscenc	e
juw	u
juwu	v
jux	t
juxt	a
juxta	p
juxtap	o
juxtapo	s
juxtapos	ei
juxtapose	ds
juxtaposi	nt
juxtaposin	g
juxtaposit	i
juxtapositi	o
juxtapositio	n
jv	adefjlmnorsuvz
jvd	m
jve	v
jvf	fv
jvm	v
jvn	k
jvo	mv
jvr	v
jvs	bir
jvu	v
jvz	vw
jw	adefhjklnoprsuxy
jwj	v
jwk	s
jwl	s
jwn	rsv
jwo	s
jwos	v
jwp	t
jws	v
jwu	uv
jwx	v
jx	abdefgijklmnotuwx
jxa	u
jxi	z
jxj	v
jxt	u
jxx	bf
jy	abefnoprsuwxyz
jyb	dpw
jye	rv
jyn	d
jyo	bpt
jyp	dk
jyr	p
jys	v
jyu	f
jyw	f
jyx	v
jyy	aprv
jyz	u
jz	abcdefghijmnopqrstuvxy
jza	o
jzb	r
jzd	jprv
jze	qsz
jzf	v
jzh	rv
jzm	bfs
jzmb	v
jzn	fv
jzp	s
jzq	dfh
jzr	u
jzs	v
jzu	v
jzx	v
