k	abcdefghijklmnopqrstuvwxyz
ka	abdefghijklmnopqrstuvwxyz
kaa	bfrsv
kaab	a
kab	ouy
kabo	b
kabu	kl
kabuk	i
kaby	l
kabyl	e
kad	bdko
kadd	i
kaddi	s
kaddis	h
kae	v
kaf	k
kafk	a
kafka	e
kafkae	s
kafkaes	q
kafkaesq	u
kafkaesqu	e
kag	i
kah	n
kai	s
kais	e
kaise	r
kaj	apw
kaja	r
kak	aip
kaka	p
kakap	o
kaki	s
kakis	t
kakist	o
kakisto	c
kakistoc	r
kakistocr	a
kakistocra	c
kakistocrac	y
kal	aeimo
kala	m
kalam	a
kalama	z
kalamaz	o
kalamazo	o
kale	iy
kalei	d
kaleid	o
kaleido	s
kaleidos	c
kaleidosc	o
kaleidosco	p
kaleidoscop	ei
kaleidoscope	s
kaleidoscopi	c
kaleidoscopic	a
kaleidoscopica	l
kaleidoscopical	l
kaleidoscopicall	y
kaley	a
kaleya	r
kaleyar	d
kali	u
kaliu	m
kalm	u
kalmu	k
kalo	n
kalon	g
kam	ceip
kamc	h
kamch	a
kamcha	t
kamchat	k
kamchatk	a
kami	k
kamik	a
kamika	z
kamikaz	e
kamikaze	s
kamp	atu
kampa	l
kampal	a
kampt	u
kamptu	l
kamptul	i
kamptuli	c
kamptulic	o
kamptulico	n
kampu	c
kampuc	h
kampuch	e
kampuche	a
kan	aegjknsty
kana	kr
kanak	a
kanar	e
kanare	s
kanares	e
kang	a
kanga	r
kangar	o
kangaro	o
kangaroo	els
kangarooe	r
kangarool	i
kangarooli	k
kangaroolik	e
kanj	i
kank	a
kanka	k
kankak	e
kankake	e
kann	a
kanna	d
kannad	a
kans	a
kansa	ns
kant	i
kanti	a
kantia	n
kany	e
kao	ln
kaol	i
kaoli	n
kaolin	es
kaoline	s
kap	lop
kapl	a
kapla	n
kapo	k
kapp	a
kaq	abdenoqvy
kaqe	v
kar	aelmopst
kara	bckmot
karab	i
karabi	n
karabin	e
karabine	r
karac	h
karach	i
karak	o
karako	r
karakor	u
karakoru	m
karam	a
karama	z
karamaz	o
karamazo	v
karao	k
karaok	e
karaoke	s
karat	es
karate	is
karatei	s
karateis	t
karateist	s
kare	n
karm	ai
karma	s
karmi	c
karmic	a
karmica	l
karmical	l
karmicall	y
karo	l
kars	t
kart	is
karti	n
kartin	g
karting	s
kas	bhk
kasb	a
kasba	h
kash	m
kashm	i
kashmi	r
kask	a
kaska	s
kaskas	k
kaskask	i
kaskaski	a
kat	aehimoryz
kata	b
katab	a
kataba	t
katabat	i
katabati	c
kath	aeilry
katha	r
kathar	i
kathari	n
katharin	e
kathe	r
kather	i
katheri	n
katherin	e
kathi	o
kathio	n
kathl	e
kathle	e
kathlee	n
kathr	y
kathry	n
kati	e
katm	a
katma	n
katman	d
katmand	u
kato	ow
katoo	n
katow	i
katowi	c
katowic	e
katr	i
katri	n
katrin	a
katy	d
katyd	i
katydi	d
kau	afr
kaua	i
kauf	fm
kauff	m
kauffm	a
kauffma	n
kaufm	a
kaufma	n
kaw	a
kawa	s
kawas	a
kawasa	k
kawasak	i
kay	aorv
kaya	k
kayak	eis
kayake	dr
kayaker	s
kayaki	ns
kayakin	g
kayaking	s
kayakis	t
kaz	ao
kaza	ak
kazak	h
kazakh	s
kazakhs	t
kazakhst	a
kazakhsta	n
kazo	o
kb	abcdehiklmnopqrstuvxy
kba	rv
kbb	u
kbd	v
kbe	frw
kbh	ilrv
kbi	cflrsvw
kbk	cir
kbl	cijosv
kbn	v
kbo	h
kbp	ds
kbq	dp
kbr	rv
kbt	m
kbu	rv
kbx	w
kc	cejlmostuw
kce	bfqw
kceb	v
kcew	v
kcj	o
kcm	b
kcs	v
kcu	ah
kd	bdefijklmopstvwxy
kdb	sx
kdd	dq
kddq	v
kde	mz
kdem	v
kdf	rv
kdj	v
kdl	s
kdo	frsv
kdt	o
kdv	m
kdvm	v
kdx	rv
kdy	rv
ke	abcdefghijklmnopqrstuvwxyz
kea	tvyz
keat	os
keato	n
keb	aov
keba	b
kebab	s
kebo	b
kebob	s
kec	fk
ked	gq
kedg	e
kee	fgjlmnprsv
keeg	a
keega	n
keel	abehilsy
keela	g
keelag	e
keelb	o
keelbo	a
keelboa	t
keele	d
keelh	a
keelha	u
keelhau	l
keeli	n
keelin	g
keell	e
keelle	s
keelles	s
keen	aeilns
keena	n
keene	drs
keener	s
keenes	t
keeni	n
keenin	g
keenl	y
keenn	e
keenne	s
keennes	s
keenness	e
keennesse	s
keep	aeis
keepa	bs
keepab	il
keepabi	l
keepabil	i
keepabili	t
keepabilit	iy
keepabiliti	e
keepabilitie	s
keepabl	e
keepas	s
keepass	ix
keepassi	u
keepassiu	m
keepassx	c
keepe	r
keeper	ils
keeperi	n
keeperin	g
keeperl	e
keeperle	s
keeperles	s
keepers	h
keepersh	i
keepershi	p
keepership	s
keepi	n
keepin	g
keeping	s
keeps	a
keepsa	k
keepsak	e
kef	dfq
keg	lsu
kegl	e
kegle	r
kei	atv
keit	h
kej	i
keji	a
kejia	n
kek	a
kel	klpsvw
kelk	o
kelko	o
kell	eoy
kelle	ry
kello	g
kellog	g
kels	eo
kelse	y
kelso	n
kelv	i
kelvi	n
kelvin	s
kelw	i
kelwi	n
kem	pr
ken	bdinopstwyz
kend	a
kenda	l
kendal	l
keni	l
kenil	w
kenilw	o
kenilwo	r
kenilwor	t
kenilwort	h
kenn	aeiy
kenna	n
kenne	cdlty
kennec	o
kenneco	t
kennecot	t
kenned	y
kennel	eils
kennele	d
kenneli	n
kennelin	g
kennell	ei
kennelle	d
kennelli	n
kennellin	g
kennet	h
kenni	n
kennin	g
keno	s
kenos	hi
kenosh	a
kenosi	s
kens	i
kensi	n
kensin	g
kensing	t
kensingt	o
kensingto	n
kent	ou
kento	n
kentu	c
kentuc	k
kentuck	iy
kentucki	a
kentuckia	n
kenw	o
kenwo	o
kenwoo	d
keny	ao
kenyo	n
kenz	o
kep	ilrtv
kepl	e
keple	r
kepler	i
kepleri	a
kepleria	n
keq	a
ker	abcfmnoqru
kera	lst
keral	a
kerat	io
kerati	nt
keratit	i
keratiti	s
kerato	s
keratos	e
kerb	es
kerbe	d
kerbs	t
kerbst	o
kerbsto	n
kerbston	e
kerc	h
kerch	i
kerchi	e
kerchie	f
kerchief	s
kerm	i
kermi	t
kern	ei
kerne	l
kernel	ils
kerneli	n
kernelin	g
kernell	ei
kernelle	s
kernelles	s
kernelli	n
kernellin	g
kerni	gn
kernig	h
kernigh	a
kernigha	n
kernin	g
kero	su
keros	ei
kerose	n
kerosen	e
kerosene	s
kerosi	n
kerosin	e
kerosine	s
kerou	a
keroua	c
kerr	y
kes	ist
kess	l
kessl	e
kessle	r
kest	r
kestr	e
kestre	l
ket	cort
ketc	h
ketch	u
ketchu	p
ketchup	s
keto	ns
keton	e
ketos	i
ketosi	s
kett	el
kette	r
ketter	i
ketteri	n
ketterin	g
kettl	ei
kettle	dfrs
kettled	r
kettledr	u
kettledru	m
kettlef	u
kettlefu	l
kettli	n
kettlin	g
keu	d
kev	eiov
keve	l
kevi	n
kew	au
kewa	su
kewas	k
kewask	u
kewasku	m
kewau	n
kewaun	e
kewaune	e
kewu	v
kex	v
key	abceghilmnprsw
keya	g
keyag	e
keyb	o
keybo	a
keyboa	r
keyboar	d
keyboard	eims
keyboarde	dr
keyboarder	s
keyboardi	n
keyboardin	g
keyboardm	a
keyboardma	e
keyboardmae	s
keyboardmaes	t
keyboardmaest	r
keyboardmaestr	o
keyc	ahu
keyca	rs
keycar	d
keycas	t
keycast	r
keych	a
keycha	i
keychai	n
keychain	s
keycu	e
keye	drs
keyes	t
keyg	eu
keyge	n
keygu	a
keygua	r
keyguar	d
keyh	o
keyho	l
keyhol	e
keyhole	s
keyi	n
keyin	g
keyl	e
keyle	s
keyles	s
keym	a
keyma	k
keymak	e
keymake	r
keyn	eo
keyne	s
keynes	i
keynesi	a
keynesia	n
keyno	t
keynot	e
keynote	r
keyp	au
keypa	d
keypad	s
keypu	n
keypun	c
keypunc	h
keyr	i
keyri	n
keyrin	g
keys	ety
keyse	t
keyst	or
keysto	kn
keystok	e
keyston	e
keystr	o
keystro	k
keystrok	e
keystroke	s
keysy	m
keysym	s
keyw	ao
keywa	y
keywo	r
keywor	d
keyword	s
kf	abcefjlnsuv
kfa	v
kfb	v
kfe	dk
kff	v
kfn	cdhq
kfs	u
kfv	z
kg	joq
kh	ademnoprsuxz
kha	knrv
khak	i
khaki	els
khakie	d
khakil	i
khakili	k
khakilik	e
khan	a
khana	t
khanat	e
khar	t
khart	o
kharto	u
khartou	m
khd	w
khe	d
khed	i
khedi	v
khediv	e
khm	e
khme	r
khn	p
kho	mv
khr	uv
khru	s
khrus	h
khrush	c
khrushc	h
khrushch	e
khrushche	v
khrushchev	s
ki	abcdefgijklmnopqrstwx
kia	n
kian	g
kiang	s
kiangs	u
kib	beio
kibb	lu
kibbl	e
kibbu	t
kibbut	z
kibi	t
kibit	z
kibo	s
kibos	h
kic	k
kick	abeilosu
kicka	bp
kickab	l
kickabl	e
kickap	o
kickapo	o
kickb	a
kickba	c
kickbac	k
kickback	s
kicke	der
kicker	s
kicki	ns
kickin	g
kickis	h
kickl	e
kickle	s
kickles	s
kicko	f
kickof	f
kicks	t
kickst	a
kicksta	r
kickstar	t
kicku	p
kid	dlns
kidd	eiy
kidde	dr
kidder	ms
kidderm	i
kiddermi	n
kiddermin	s
kiddermins	t
kidderminst	e
kidderminste	r
kiddi	ens
kiddin	g
kidding	l
kiddingl	y
kiddis	h
kiddish	n
kiddishn	e
kiddishne	s
kiddishnes	s
kiddishness	e
kiddishnesse	s
kidl	i
kidli	k
kidlik	e
kidn	ae
kidna	p
kidnap	eips
kidnape	der
kidnapee	s
kidnaper	s
kidnapi	n
kidnapin	g
kidnaping	s
kidnapp	ei
kidnappe	der
kidnappee	s
kidnapper	s
kidnappi	n
kidnappin	g
kidnapping	s
kidne	y
kidney	ls
kidneyl	i
kidneyli	k
kidneylik	e
kids	k
kidsk	i
kidski	n
kie	flrvw
kief	f
kieff	e
kieffe	r
kiew	i
kiewi	t
kif	p
kig	a
kiga	l
kigal	i
kii	v
kij	i
kiji	j
kijij	i
kik	u
kiku	y
kikuy	u
kil	gilnot
kilg	o
kilgo	r
kilgor	e
kili	m
kilim	a
kilima	n
kiliman	j
kilimanj	a
kilimanja	r
kilimanjar	o
kill	aeijs
killa	b
killab	l
killabl	e
kille	bdr
killeb	r
killebr	e
killebre	w
killer	s
killi	n
killin	g
killing	lns
killingl	y
killingn	e
killingne	s
killingnes	s
killj	o
killjo	y
kiln	efis
kilne	d
kilnf	u
kilnfu	l
kilni	n
kilnin	g
kilo	bcghjlmstvw
kilob	iluy
kilobi	t
kilobit	s
kilobl	o
kiloblo	c
kilobloc	k
kilobu	c
kilobuc	k
kiloby	t
kilobyt	e
kilobyte	s
kiloc	ay
kiloca	l
kilocal	o
kilocalo	r
kilocalor	i
kilocalori	e
kilocy	c
kilocyc	l
kilocycl	e
kilog	r
kilogr	a
kilogra	m
kilogram	s
kiloh	em
kilohe	r
kiloher	t
kilohert	z
kilohertz	e
kilohertze	s
kiloj	o
kilojo	u
kilojou	l
kilojoul	e
kilojoule	s
kilol	i
kiloli	t
kilolit	er
kilolite	r
kilolitr	e
kilom	e
kilome	t
kilomet	er
kilomete	r
kilometer	s
kilometr	e
kilometre	s
kilos	e
kilose	c
kilosec	o
kiloseco	n
kilosecon	d
kilot	o
kiloto	n
kilov	o
kilovo	l
kilovol	t
kilovolt	a
kilovolta	g
kilovoltag	e
kilow	ao
kilowa	t
kilowat	t
kilowatt	as
kilowatta	g
kilowattag	e
kilowo	r
kilowor	d
kilt	eils
kilte	r
kilti	en
kiltin	g
kiltl	i
kiltli	k
kiltlik	e
kim	bo
kimb	ae
kimba	l
kimbal	l
kimbe	r
kimber	l
kimberl	y
kimo	n
kimon	o
kimono	es
kimonoe	d
kin	acdefgklnosv
kina	es
kinae	s
kinaes	t
kinaest	h
kinaesth	e
kinaesthe	st
kinaesthes	i
kinaesthesi	a
kinaesthet	i
kinaestheti	c
kinas	e
kinc	h
kinch	i
kinchi	n
kind	aehlnrs
kinde	rs
kinder	g
kinderg	a
kinderga	r
kindergar	t
kindergart	e
kindergarte	n
kindergarten	s
kindes	t
kindh	e
kindhe	a
kindhea	r
kindhear	t
kindheart	e
kindhearte	d
kindl	eiy
kindle	ds
kindli	eln
kindlie	rs
kindlies	t
kindlil	y
kindlin	eg
kindline	s
kindlines	s
kindn	e
kindne	s
kindnes	s
kindness	e
kindnesse	s
kindr	e
kindre	d
kine	cmrst
kinec	t
kinem	a
kinema	t
kinemat	i
kinemati	c
kinematic	s
kines	cit
kinesc	o
kinesco	p
kinescop	e
kinesi	o
kinesio	l
kinesiol	o
kinesiolo	g
kinesiolog	y
kinest	h
kinesth	e
kinesthe	st
kinesthes	i
kinesthesi	a
kinesthet	i
kinestheti	c
kinet	io
kineti	c
kinetic	as
kinetica	l
kinetical	l
kineticall	y
kineto	s
kinetos	c
kinetosc	o
kinetosco	p
kinetoscop	e
kinf	o
kinfo	l
kinfol	k
king	defhilmpsw
kingd	o
kingdo	m
kingdom	els
kingdome	d
kingdoml	e
kingdomle	s
kingdomles	s
kinge	drs
kinges	t
kingf	i
kingfi	s
kingfis	h
kingfish	e
kingfishe	r
kingfisher	s
kingh	o
kingho	o
kinghoo	d
kingi	n
kingin	g
kingl	eiy
kingle	st
kingles	s
kingless	n
kinglessn	e
kinglessne	s
kinglessnes	s
kinglessness	e
kinglessnesse	s
kingli	kn
kinglik	e
kinglin	e
kingline	s
kinglines	s
kingm	a
kingma	k
kingmak	e
kingmake	r
kingp	i
kingpi	n
kings	bhlt
kingsb	u
kingsbu	r
kingsbur	y
kingsh	i
kingshi	p
kingsl	e
kingsle	y
kingst	o
kingsto	nw
kingstow	n
kingw	o
kingwo	o
kingwoo	d
kink	aeilsy
kinka	j
kinkaj	o
kinkajo	u
kinke	d
kinki	n
kinkin	g
kinkl	e
kinkle	s
kinkles	s
kinl	e
kinle	s
kinles	s
kinn	ei
kinne	y
kinni	c
kinnic	k
kinnick	i
kinnicki	n
kinnickin	n
kinnickinn	i
kinnickinni	c
kins	efhmw
kinse	y
kinsf	o
kinsfo	l
kinsfol	k
kinsh	ai
kinsha	s
kinshas	h
kinshash	a
kinshi	p
kinsm	a
kinsma	n
kinsw	o
kinswo	m
kinswom	a
kinswoma	n
kio	svw
kios	k
kiosk	s
kiow	a
kip	lps
kipl	i
kipli	n
kiplin	g
kipp	ei
kippe	dr
kipper	eis
kippere	dr
kipperer	s
kipperi	n
kipperin	g
kippi	n
kippin	g
kiq	i
kiqi	v
kir	bcgikos
kirb	y
kirc	h
kirch	no
kirchn	e
kirchne	r
kircho	f
kirchof	f
kirg	h
kirgh	i
kirghi	z
kiri	b
kirib	a
kiriba	t
kiribat	i
kirk	lmpw
kirkl	a
kirkla	n
kirklan	d
kirkm	a
kirkma	n
kirkp	a
kirkpa	t
kirkpat	r
kirkpatr	i
kirkpatri	c
kirkpatric	k
kirkw	o
kirkwo	o
kirkwoo	d
kiro	v
kirs	t
kirst	e
kirste	n
kis	ms
kism	e
kisme	t
kiss	aeil
kissa	bg
kissab	il
kissabi	l
kissabil	i
kissabili	t
kissabilit	y
kissabl	e
kissag	e
kisse	drs
kisser	s
kissi	mn
kissim	m
kissimm	e
kissimme	e
kissin	g
kissing	s
kissl	e
kissle	s
kissles	s
kit	acefilst
kita	k
kitak	y
kitaky	u
kitakyu	s
kitakyus	h
kitakyush	u
kitc	h
kitch	e
kitche	n
kitchen	aelswy
kitchena	b
kitchenab	l
kitchenabl	e
kitchene	rt
kitchenet	t
kitchenett	e
kitchenl	e
kitchenle	s
kitchenles	s
kitchenw	a
kitchenwa	r
kitchenwar	e
kite	dlrs
kitel	i
kiteli	k
kitelik	e
kiter	s
kitf	u
kitfu	l
kiti	n
kitin	g
kitl	e
kitle	s
kitles	s
kitt	eisy
kitte	dn
kitten	ehils
kittene	d
kittenh	o
kittenho	o
kittenhoo	d
kitteni	ns
kittenin	g
kittenis	h
kittenl	i
kittenli	k
kittenlik	e
kitti	enw
kittie	s
kittin	g
kittiw	a
kittiwa	k
kittiwak	e
kitty	s
kiw	ai
kiwa	n
kiwan	i
kiwani	s
kiwi	s
kj	bcdjmnoqv
kjc	b
kjj	rv
kjm	b
kjn	v
kjo	ru
kjq	ahs
kjqs	v
kk	abcdehiklmotvwx
kka	vy
kkb	rvy
kkc	l
kkd	c
kke	tv
kkh	p
kkk	bhx
kkl	v
kkm	br
kkmb	v
kko	v
kl	abdefhilnoprstuvwxy
kla	nuvx
klan	s
klans	m
klansm	a
klansma	n
klau	s
klax	o
klaxo	n
klb	cdijqs
klbd	v
kld	jr
kle	iop
klei	n
klein	r
kleinr	o
kleinro	c
kleinroc	k
klep	t
klept	o
klepto	m
kleptom	a
kleptoma	n
kleptoman	i
kleptomani	a
kleptomania	c
klf	k
klh	z
kli	n
klin	e
kln	vw
klo	ekmsv
klos	v
klr	cdijqs
klrd	v
kls	v
klu	dltx
klud	g
kludg	e
kludge	s
klut	z
klx	u
klxu	v
kly	s
klys	t
klyst	r
klystr	o
klystro	n
km	abcefijnopqrstw
kma	vx
kmb	grv
kmc	s
kmcs	v
kmi	itz
kmj	s
kmn	fov
kn	abcdefgiklnoprsuvwxy
kna	cdeprsuv
knac	k
knack	s
knap	psw
knapp	e
knappe	r
knaps	a
knapsa	c
knapsac	k
knapsack	s
knapw	e
knapwe	e
knapwee	d
knau	e
knaue	r
knav	e
knave	rs
knaver	y
knb	otvxy
knc	pw
kne	aelrvwz
knea	d
knead	aeis
kneada	b
kneadab	il
kneadabi	l
kneadabil	i
kneadabili	t
kneadabilit	iy
kneadabiliti	e
kneadabilitie	s
kneadabl	e
kneade	dr
kneader	s
kneadi	n
kneadin	g
kneading	l
kneadingl	y
knee	cdhilps
kneec	a
kneeca	p
kneecap	ps
kneecapp	ei
kneecappe	dr
kneecapper	s
kneecappi	n
kneecappin	g
kneeh	o
kneeho	l
kneehol	e
kneei	n
kneein	g
kneel	eis
kneele	dr
kneeli	kn
kneelik	e
kneelin	g
kneeling	l
kneelingl	y
kneep	a
kneepa	dn
knel	lt
knell	s
knf	fprsv
kni	cfgstv
knic	k
knick	ek
knicke	r
knicker	bels
knickerb	o
knickerbo	c
knickerboc	k
knickerbock	e
knickerbocke	r
knickerbocker	s
knickerbockers	e
knickerbockerse	s
knickere	d
knickerl	e
knickerle	s
knickerles	s
knickers	e
knickerse	s
knickk	n
knickkn	a
knickkna	c
knickknac	k
knif	ei
knife	bdflrs
knifeb	o
knifebo	a
knifeboa	r
knifeboar	d
knifef	u
knifefu	l
knifel	ei
knifele	s
knifeles	s
knifeli	k
knifelik	e
knifer	s
knifi	n
knifin	g
knig	h
knigh	t
knight	ehils
knighte	ds
knightes	s
knighth	o
knightho	o
knighthoo	d
knighti	n
knightin	g
knightl	eiy
knightle	s
knightles	s
knightli	kn
knightlik	e
knightlin	g
knights	bh
knightsb	r
knightsbr	i
knightsbri	d
knightsbrid	g
knightsbridg	e
knightsh	i
knightshi	p
knis	h
knit	stw
knitt	aei
knitta	b
knittab	l
knittabl	e
knitte	r
knitter	s
knitti	n
knittin	g
knitw	e
knitwe	a
knitwea	r
knitwear	s
kniv	e
knive	s
knk	b
knl	pv
knn	depv
kno	bclpstuvwx
knob	bels
knobb	eiy
knobbe	d
knobbi	en
knobbie	rs
knobbies	t
knobbin	eg
knobbine	s
knobbines	s
knobe	l
knobel	o
knobelo	c
knobeloc	h
knobl	i
knobli	k
knoblik	e
knoc	k
knock	deilos
knockd	o
knockdo	w
knockdow	n
knocke	dr
knocker	s
knocki	n
knockin	g
knocking	s
knockl	e
knockle	s
knockles	s
knocko	u
knockou	t
knockout	s
knol	l
knoll	s
knos	s
knoss	o
knosso	s
knot	ghlstw
knotg	r
knotgr	a
knotgra	s
knotgras	s
knoth	o
knotho	l
knothol	e
knotl	ei
knotle	s
knotles	s
knotli	k
knotlik	e
knott	eiy
knotte	dr
knotter	s
knotti	n
knottin	eg
knottine	s
knottines	s
knotw	o
knotwo	r
knotwor	k
knou	t
know	aehilns
knowa	b
knowab	l
knowabl	e
knowe	r
knower	s
knowh	o
knowho	w
knowi	n
knowin	g
knowing	elns
knowinge	rs
knowinges	t
knowingl	y
knowingn	e
knowingne	s
knowingnes	s
knowingness	e
knowingnesse	s
knowl	et
knowle	ds
knowled	g
knowledg	ei
knowledge	adls
knowledgea	b
knowledgeab	il
knowledgeabi	l
knowledgeabil	i
knowledgeabili	t
knowledgeabilit	iy
knowledgeabiliti	e
knowledgeabilitie	s
knowledgeabl	ey
knowledgeable	n
knowledgeablen	e
knowledgeablene	s
knowledgeablenes	s
knowledgeableness	e
knowledgeablenesse	s
knowledgel	e
knowledgele	s
knowledgeles	s
knowledges	t
knowledgest	o
knowledgesto	r
knowledgestor	m
knowledgi	n
knowledgin	g
knowlt	o
knowlto	n
knox	v
knoxv	i
knoxvi	l
knoxvil	l
knoxvill	e
knp	b
knr	rstvxy
kns	bv
knu	cdrt
knuc	k
knuck	l
knuckl	eiy
knuckle	ds
knuckles	o
knuckleso	m
knucklesom	e
knuckli	en
knucklie	rs
knucklies	t
knucklin	g
knud	s
knuds	eo
knudse	n
knudso	n
knur	l
knurl	y
knut	hs
knuts	eo
knutse	n
knutso	n
kny	o
ko	abcdefhiklmnopqrstuvwxz
koa	jl
koaj	s
koal	a
koala	s
kob	aef
koba	y
kobay	a
kobaya	s
kobayas	h
kobayash	i
kobf	rv
koc	h
koch	a
kocha	b
kod	airv
koda	ck
kodac	h
kodach	r
kodachr	o
kodachro	m
kodachrom	e
kodi	a
kodia	k
koe	n
koen	i
koeni	g
koenig	s
koenigs	be
koenigsb	e
koenigsbe	r
koenigsber	g
koenigse	g
koenigseg	g
kof	u
koh	lo
kohl	er
kohle	r
kohlr	a
kohlra	b
kohlrab	i
koho	u
kohou	t
kohout	e
kohoute	k
koi	n
koin	e
kol	iu
koli	n
kolin	s
kolins	k
kolinsk	y
kolu	n
kom	bm
komm	a
komma	n
komman	d
kommand	a
kommanda	t
kommandat	u
kommandatu	r
kommandatur	a
kon	agir
koni	cm
konic	a
konim	e
konime	t
konimet	e
konimete	r
konr	a
konra	d
koo	bkot
koob	e
koobe	e
kooo	k
kop	ejp
kope	c
kopec	k
kopeck	s
kopj	e
kopp	e
koppe	r
kopper	s
koq	rv
kor	aeno
kora	dn
korad	j
koradj	i
kore	a
korea	n
korean	s
koro	m
korom	i
koromi	k
koromik	o
kos	ho
kosh	e
koshe	r
kosher	eis
koshere	d
kosheri	n
kosherin	g
koso	v
kosov	o
kot	lw
kotl	i
kotli	n
kotw	a
kotwa	l
kou	efu
kov	a
kova	c
kovac	s
kow	ahlt
kowa	l
kowal	es
kowale	w
kowalew	s
kowalews	k
kowalewsk	i
kowals	k
kowalsk	i
kowh	a
kowha	i
kowl	o
kowlo	o
kowloo	n
kowt	o
kowto	w
kox	bdv
koz	o
kp	abcdfghijnopqrtx
kpa	x
kpb	n
kpc	u
kpd	koptw
kpn	o
kpo	h
kpq	gu
kpr	u
kpx	rv
kq	abeijnquv
kqa	brv
kqb	r
kqn	bv
kqq	q
kqu	e
kque	u
kqueu	e
kr	abcdefhijklnoprstuvxyz
kra	efikmtu
krae	m
kraem	e
kraeme	r
kraf	t
krai	t
krak	aeo
kraka	t
krakat	o
krakato	a
krake	n
krako	w
kram	e
krame	r
krau	st
kraus	e
krb	bhstv
krc	rv
krd	v
kre	bmns
kreb	s
krem	l
kreml	i
kremli	n
kremlin	o
kremlino	l
kremlinol	o
kremlinolo	g
kremlinolog	iy
kremlinologi	s
kremlinologis	t
kren	v
kres	g
kresg	e
krf	v
krh	r
kri	elmrsv
krie	g
krieg	e
kriege	r
kril	l
krill	s
krim	m
krimm	e
krimme	r
kris	ht
krish	n
krishn	a
krist	ei
kriste	n
kristi	n
krj	qv
krl	cdijqsv
krld	v
krn	bp
kro	bmnv
krom	e
krome	s
kromes	k
kromesk	y
kron	e
krone	cr
kronec	k
kroneck	e
kronecke	r
krr	jq
krs	s
krt	n
kru	egs
krue	g
krueg	e
kruege	r
krug	e
kruge	r
krus	e
krv	fu
krvf	v
kry	fp
kryp	t
krypt	o
krypto	ln
krypton	s
ks	begilmnopqrsuwx
ksb	b
kse	r
ksi	rv
ksm	b
ksn	nq
kso	v
ksp	ox
ksq	t
ksr	b
kss	b
ksw	u
kt	adilmnoprstuv
kta	rsv
ktd	p
ktm	bp
ktmb	rsv
ktn	bdv
ktp	v
ktt	bz
ktv	v
ku	abcdehijlmnortuwy
kua	clrv
kual	a
kub	ce
kube	acr
kubea	d
kubead	m
kubec	t
kubect	l
kuber	n
kubern	e
kuberne	t
kubernet	e
kubernete	s
kuc	ho
kuch	e
kuche	n
kuco	i
kucoi	n
kud	ouz
kudo	s
kudz	u
kue	n
kuen	n
kuenn	i
kuenni	n
kuennin	g
kuh	n
kul	a
kula	k
kum	a
kuma	r
kun	g
kung	f
kungf	u
kur	dotv
kurd	i
kurdi	s
kurdis	h
kuro	m
kurom	i
kuromi	s
kut	r
kuu	v
kuw	au
kuwa	i
kuwai	t
kuwait	i
kuwu	v
kv	aefjnoswy
kva	s
kvas	s
kve	tv
kvet	c
kvetc	h
kvetch	eiy
kvetche	drs
kvetcher	s
kvetchi	n
kvetchin	g
kvf	bf
kvo	m
kvs	b
kvy	z
kw	abefhijkmnoptuvwxy
kwa	v
kwf	t
kwh	r
kwi	c
kwj	v
kwn	rsv
kwo	s
kwp	t
kwt	b
kwu	uv
kww	b
kwy	u
kx	abdeikpquvwx
kxi	z
kxx	n
ky	abcdefklmopruvxy
kya	t
kye	n
kyf	bpq
kyl	io
kyli	e
kylo	e
kym	co
kymc	o
kymo	g
kymog	r
kymogr	a
kymogra	p
kymograp	h
kyo	ct
kyoc	e
kyoce	r
kyocer	a
kyot	o
kyp	df
kyr	g
kyrg	y
kyrgy	z
kyrgyz	s
kyrgyzs	t
kyrgyzst	a
kyrgyzsta	n
kyu	v
kyy	afv
kz	acdefjnoqrv
kzc	m
kzd	j
kze	dq
kzj	v
kzn	m
kzo	v
kzq	f
kzr	v
