l	abcdefghijklmnopqrstuvwxyz
la	bdfijklmnopqrstvxy
lad	bfhkruvx
ladh	v
ladk	v
laj	q
lak	mp
lakm	v
lakp	v
lal	v
lao	b
laq	d
lat	v
lax	fu
lb	abcdefghijklmnopqrstuvwxyz
lba	adfhkmoqrstvw
lbak	rv
lbao	v
lbb	bhikmoprstuvxyz
lbbh	v
lbbi	v
lbbo	v
lbbr	v
lbbu	v
lbby	v
lbc	cfglstuv
lbcl	v
lbcu	v
lbd	befklmoqsv
lbdm	v
lbe	abcefhiklmoqrstvwz
lbea	v
lbef	v
lbei	v
lbeq	v
lber	v
lbez	v
lbf	bdfhkrstuvwz
lbfb	v
lbfd	rv
lbfk	rv
lbg	bhqrsuy
lbh	bdfghrsvz
lbhd	v
lbhr	v
lbhz	v
lbi	bfhrsuv
lbj	bijprstuv
lbjb	rsv
lbk	bjklrsv
lbkb	v
lbl	bdhjrsvwz
lblh	rv
lblj	v
lbls	rv
lblv	v
lbm	cdgprsuvz
lbmg	v
lbmp	rv
lbmv	v
lbn	bcdfilnorsv
lbnl	v
lbno	v
lbo	bcdefhjlopqrsuvw
lboh	v
lboo	v
lboq	v
lbou	v
lbp	bdfghmoruvz
lbq	dkorsy
lbqr	v
lbqs	v
lbr	bcdkorsuvx
lbrb	v
lbrc	v
lbrd	rv
lbrk	v
lbro	v
lbru	rv
lbs	abghiruv
lbt	boqstv
lbtt	v
lbu	chikmopqtuvy
lbum	v
lbuv	v
lbv	bdfimoprstvz
lbvf	v
lbw	hjosu
lbwh	v
lbwo	v
lbx	adeqruv
lby	adhqvz
lbz	efopu
lc	abcefhijklmnopqrstuvwy
lca	qv
lcb	k
lcc	k
lcf	dk
lcj	v
lck	v
lcl	kruv
lcm	r
lcn	lm
lco	fgl
lcq	n
lcr	or
lcs	t
lct	hoy
lcty	v
lcu	as
lcv	z
lcw	u
lcy	du
ld	adehijklnopqrstuvxyz
lda	qv
ldd	oq
lde	enu
ldh	frv
ldi	glv
ldj	bhmpw
ldjb	rv
ldjh	v
ldl	frsvw
ldn	bflrv
ldo	brv
ldp	fkow
ldq	l
ldr	cru
ldt	n
ldu	dfghikotuvxy
lduh	rv
lduk	rv
lduu	rv
ldx	rsv
ldy	rsv
le	behiklmnoqrtvw
leb	bf
lee	mv
leh	k
lei	k
lem	k
len	bdfqv
lenb	v
lenf	v
leo	bfktv
leok	v
leq	k
let	r
lf	acdefghjklmnpqrtuvwxz
lfa	rv
lfc	v
lfd	sv
lfe	v
lff	drv
lfh	rsv
lfk	a
lfn	bfnv
lfnb	v
lfnf	v
lfp	rsv
lfq	v
lfr	v
lft	brv
lfu	v
lfw	krv
lfz	v
lg	abeijklnuvxy
lgi	u
lgj	y
lgl	rv
lgx	v
lh	abdhimnrstuvwxz
lha	rv
lhd	s
lhh	bdoz
lhm	b
lhmb	v
lhn	bdfghilmopqrtux
lhno	v
lhnp	v
lhnr	v
lhnt	rv
lhnu	rv
lhs	krz
lht	b
lhu	v
lhw	f
lhz	abfhjopyz
lhzf	v
lhzh	v
lhzy	v
li	jloq
liq	lv
lj	bcdejkmnquvz
ljc	s
ljcs	v
ljd	u
ljj	ruv
ljm	b
ljn	y
ljq	au
lju	rv
ljz	kx
lk	abfhimnw
lka	v
lkb	k
lkbk	v
lkm	r
lkn	ov
ll	bdefhjklmnoqrstuvz
llb	bfmvw
lle	f
llf	k
llh	b
llj	v
lll	b
llm	btvw
llmb	v
llmt	v
lln	f
llo	bhs
llob	v
lloh	v
llt	o
llu	l
llul	v
llz	b
lm	bdefgklpv
lmb	gr
lmbr	v
lmf	k
lmg	v
lmk	rv
lml	v
lmp	v
ln	bdefghijklmnoqrtvxy
lnb	o
lnd	s
lne	q
lnf	flrsuvw
lnj	iopw
lnjw	v
lnm	v
lnn	fow
lno	bdfhiklrtuvx
lnok	v
lnot	v
lnou	rv
lnq	k
lnr	o
lnt	v
lnx	u
lny	k
lo	abcdefghijklmnopqrstuvwxyz
loa	abkmopqrstvwy
loak	v
loam	v
loao	v
lob	defghikorsvwxz
lobd	rv
lobh	v
lobi	rv
lobk	rv
lobo	v
lobr	v
lobw	rv
loc	adjklrstuvw
lock	v
lod	afklmoqrvxz
loda	v
lodl	v
loe	adefgimoqrsuvwyz
loed	rv
loee	rv
loem	v
loeu	rsv
lof	bdgmnstuyz
lofd	v
lofs	rv
lofu	v
lofz	v
log	fgorsvwy
loh	bmpu
loi	abfirsv
loj	abdjrsv
lojb	v
lok	abcdfhjklmrsvw
lokb	v
lokr	rv
lol	bfhklnoprtuvwz
lolf	v
lolk	v
lolo	frsvw
lolp	v
lolr	v
lom	cdfqrsuxz
lomx	v
lon	bdefghiklmopqrstuvxz
lonb	v
lone	rsv
lonf	v
lonh	v
loni	v
lonk	v
lonl	v
lono	frsv
lonp	v
lonq	v
lonr	v
lont	rv
lonu	rsv
loo	bcdefghjklmopqrstuvw
loob	v
lood	v
looh	rv
loom	rv
loop	v
loos	v
loot	v
lop	bdgoprstuvwxz
lopd	v
lopg	v
lopo	rv
lopu	rv
lopw	v
loq	abknoqrsuv
lor	abcdefhjlnqrsuvwx
lora	rsv
lorb	frsv
lorc	rv
lord	rsv
lorf	rsv
lorv	v
lorx	v
los	bdfhikoqrstuvxz
losb	v
losf	v
loso	v
losr	v
lot	bdemoqrstuvxz
lote	v
lou	imoqrtuvy
loum	v
louu	v
lov	afrstvz
lovf	v
low	bflrstvw
lowt	v
lox	dersv
loy	foprsuvyz
loyf	rv
loyo	v
loyp	v
loz	abfhjoprsvxyz
loza	v
lozb	v
lozf	rv
lozh	v
lozj	v
lozo	rsv
lozx	rv
lozy	v
lp	abcdefghijlmnopqrstuvwxy
lpa	bfqv
lpc	u
lpd	behkstuw
lpde	v
lpdk	v
lpds	v
lpe	fv
lpf	dk
lpg	c
lpgc	v
lpl	ruv
lpm	brtvw
lpmb	v
lpmt	v
lpn	bflm
lpo	k
lpp	v
lpq	cgknuv
lpqc	v
lpr	oru
lps	rv
lpt	bhorvy
lptb	v
lpty	v
lpu	frsv
lpv	bfhiouz
lpw	u
lpx	v
lpy	u
lq	bdeijklmnoprtuv
lqb	bky
lqe	v
lqn	nruvw
lqnu	v
lqnw	v
lqo	rv
lqr	buy
lqrb	v
lqt	bk
lr	abcdefijklnoqstuvwxz
lrb	b
lrbb	v
lrc	nrv
lrd	rsv
lre	bh
lreb	v
lrf	fw
lri	h
lrj	hrv
lrk	hj
lrl	rsv
lrn	d
lro	kr
lrq	dhu
lrs	ks
lrt	b
lru	rv
lrur	v
lrv	u
lrz	v
ls	adeglnoprvx
lsa	fkz
lsn	fkmop
lsnp	v
lso	v
lsp	v
lt	adikmnotv
lta	rv
ltd	p
lti	rv
ltm	bpr
ltmb	v
ltmp	rv
ltn	rsv
lto	t
ltt	abdefhmorsuvwyz
lttd	v
ltth	rv
lttm	v
ltto	v
ltts	rv
lttu	rsv
lttw	v
lu	abefiklorvwx
lua	rv
lub	p
lue	m
luf	h
lul	bcdfiklorsy
lulf	v
lull	v
lulr	v
luo	k
lur	p
luv	d
lv	adefksvy
lvf	f
lvs	v
lvy	v
lw	abfilnoqsuvw
lwb	j
lwl	hwz
lwn	rsv
lwo	o
lwq	b
lwv	ekuwxy
lww	bfk
lx	abdejklnptuvxz
lxd	v
lxe	v
lxl	v
lxn	f
lxp	rv
lxt	b
lxu	uv
lxz	r
ly	abdefhklopruvxyz
lya	rsv
lyb	kp
lyd	a
lyf	p
lyfp	v
lyh	p
lyk	k
lyl	v
lyo	a
lyp	vz
lyr	kp
lyu	f
lyx	v
lyy	d
lyz	k
lz	bdfjknopqrvz
lzb	j
lzd	j
lzj	v
lzk	a
lzn	f
lzo	jrv
lzp	ahy
lzph	v
lzq	f
lzr	fiw
lzz	fy
