m	abcdefghijklmnopqrstuvwxyz
ma	abcdefghijklmnopqrstuvwxyz
mab	e
mabe	l
mac	abcdeghiklmnopqrstuvwy
maca	bdopqrsuw
macab	r
macabr	e
macabre	l
macabrel	y
macad	a
macada	m
macadam	i
macadami	asz
macadamis	e
macadamiz	e
macap	p
macapp	ds
macappd	e
macappde	a
macappdea	l
macappdeal	s
macapps	t
macappst	o
macappsto	r
macappstor	e
macaq	u
macaqu	e
macar	ot
macaro	no
macaron	i
macaroni	aes
macaronia	n
macaronie	s
macaronis	m
macaroo	n
macart	h
macarth	u
macarthu	r
macas	s
macass	a
macassa	r
macau	l
macaul	a
macaula	y
macaulay	ai
macaulaya	n
macaulayi	s
macaulayis	m
macaulayism	s
macb	eor
macbe	t
macbet	h
macbo	o
macboo	k
macbook	ap
macbooka	i
macbookai	r
macbookp	r
macbookpr	o
macbr	i
macbri	d
macbrid	e
macd	ior
macdi	a
macdia	r
macdiar	m
macdiarm	i
macdiarmi	d
macdo	nu
macdon	a
macdona	l
macdonal	d
macdou	g
macdoug	a
macdouga	l
macdougal	l
macdr	a
macdra	w
mace	drs
maced	o
macedo	n
macedon	i
macedoni	a
macedonia	n
macer	a
macera	t
macerat	e
macg	r
macgr	e
macgre	g
macgreg	o
macgrego	r
mach	eios
mache	t
machet	e
machete	s
machi	acns
machia	nv
machiav	e
machiave	l
machiavel	l
machiavell	i
machiavelli	a
machiavellia	n
machic	o
machico	l
machicol	a
machicola	t
machicolat	e
machin	aei
machina	bt
machinab	il
machinabi	l
machinabil	i
machinabili	t
machinabilit	i
machinabiliti	e
machinabilitie	s
machinabl	e
machinat	eio
machinati	o
machinatio	n
machinato	r
machine	adlrst
machinea	b
machineab	i
machineabi	l
machineabil	i
machineabili	t
machineabilit	iy
machineabiliti	e
machineabilitie	s
machinel	i
machineli	k
machinelik	e
machiner	iy
machineri	e
machinerie	s
machinet	o
machineto	o
machinetoo	l
machinetool	e
machinetoole	d
machini	ns
machinin	g
machinis	t
machinist	s
machis	m
machism	o
macho	is
machoi	s
machois	m
machoism	s
maci	dn
macin	gt
macint	oy
macinto	s
macintos	h
macintosh	e
macintoshe	s
macinty	r
macintyr	e
mack	aeis
macka	y
macke	nry
macken	z
mackenz	i
mackenzi	e
macker	e
mackere	l
mackerel	is
mackereli	n
mackerelin	g
macki	n
mackin	ant
mackina	cw
mackinn	o
mackinno	n
mackint	o
mackinto	s
mackintos	h
mackintosh	e
mackintoshe	ds
macl	ae
macla	r
maclar	e
maclare	n
macle	o
macleo	d
macm	ai
macma	h
macmah	o
macmaho	n
macmi	l
macmil	l
macmill	a
macmilla	n
macn	e
macne	i
macnei	c
macneic	e
maco	ns
macos	bchmstvx
macosb	i
macosbi	g
macosbig	s
macosbigs	u
macosbigsu	r
macosc	a
macosca	t
macoscat	a
macoscata	l
macoscatal	i
macoscatali	n
macoscatalin	a
macosh	i
macoshi	g
macoshig	h
macoshigh	s
macoshighs	i
macoshighsi	e
macoshighsie	r
macoshighsier	r
macoshighsierr	a
macosm	o
macosmo	jn
macosmoj	a
macosmoja	v
macosmojav	e
macosmon	t
macosmont	e
macosmonte	r
macosmonter	e
macosmontere	y
macoss	eio
macosse	qr
macosseq	u
macossequ	o
macossequo	i
macossequoi	a
macosser	v
macosserv	e
macosserve	r
macossi	e
macossie	r
macossier	r
macossierr	a
macosso	n
macosson	o
macossono	m
macossonom	a
macost	a
macosta	h
macostah	o
macostaho	e
macosv	e
macosve	n
macosven	t
macosvent	u
macosventu	r
macosventur	a
macosx	cjlpst
macosxc	h
macosxch	e
macosxche	e
macosxchee	t
macosxcheet	a
macosxcheeta	h
macosxj	a
macosxja	g
macosxjag	u
macosxjagu	a
macosxjagua	r
macosxl	e
macosxle	o
macosxleo	p
macosxleop	a
macosxleopa	r
macosxleopar	d
macosxp	au
macosxpa	n
macosxpan	t
macosxpant	h
macosxpanth	e
macosxpanthe	r
macosxpu	m
macosxpum	a
macosxs	n
macosxsn	o
macosxsno	w
macosxsnow	l
macosxsnowl	e
macosxsnowle	o
macosxsnowleo	p
macosxsnowleop	a
macosxsnowleopa	r
macosxsnowleopar	d
macosxt	i
macosxti	g
macosxtig	e
macosxtige	r
macp	ar
macpa	i
macpai	n
macpain	t
macpr	o
macq	u
macqu	ai
macqua	r
macquar	i
macquari	e
macqui	l
macquil	l
macquill	a
macquilla	n
macr	aou
macra	m
macram	e
macro	bcdefglmnpst
macrob	ei
macrobe	n
macroben	t
macrobent	h
macrobenth	i
macrobenthi	c
macrobi	ao
macrobia	n
macrobio	t
macrobiot	i
macrobioti	c
macrobiotic	as
macrobiotica	l
macrobiotical	l
macrobioticall	y
macroc	elo
macroce	p
macrocep	h
macroceph	a
macrocepha	l
macrocephal	i
macrocephali	c
macrocl	i
macrocli	m
macroclim	a
macroclima	t
macroclimat	i
macroclimati	c
macroco	s
macrocos	m
macrocosm	is
macrocosmi	c
macrocosmic	a
macrocosmica	l
macrocosmical	l
macrocosmicall	y
macrod	i
macrodi	a
macrodia	g
macrodiag	o
macrodiago	n
macrodiagon	a
macrodiagona	l
macroe	c
macroec	o
macroeco	n
macroecon	o
macroecono	m
macroeconom	i
macroeconomi	c
macroeconomic	s
macrof	a
macrofa	u
macrofau	n
macrofaun	a
macrog	ln
macrogl	o
macroglo	s
macroglos	s
macrogloss	i
macroglossi	a
macrogn	a
macrogna	t
macrognat	h
macrognath	io
macrognathi	c
macrognatho	u
macrognathou	s
macrol	i
macroli	bn
macrolib	r
macrolibr	a
macrolibra	r
macrolibrar	y
macrolin	g
macroling	u
macrolingu	i
macrolingui	s
macrolinguis	t
macrolinguist	i
macrolinguisti	c
macrolinguistic	s
macrom	eo
macrome	dr
macromed	i
macromedi	a
macromer	i
macromeri	c
macromo	l
macromol	e
macromole	c
macromolec	u
macromolecu	l
macromolecul	e
macromolecule	s
macron	o
macrono	d
macronod	u
macronodu	l
macronodul	a
macronodula	r
macrop	ah
macropa	r
macropar	a
macropara	m
macroparam	e
macroparame	t
macroparamet	e
macroparamete	r
macroph	ay
macropha	gl
macrophag	eo
macrophago	u
macrophagou	s
macrophal	l
macrophall	i
macrophalli	c
macrophy	st
macrophys	i
macrophysi	c
macrophysic	a
macrophysica	l
macrophyt	i
macrophyti	c
macros	ceopt
macrosc	o
macrosco	p
macroscop	i
macroscopi	c
macroscopic	a
macroscopica	l
macrose	i
macrosei	s
macroseis	m
macroseism	i
macroseismi	c
macroso	c
macrosoc	i
macrosoci	o
macrosocio	l
macrosociol	o
macrosociolo	g
macrosociolog	iy
macrosociologi	c
macrosociologic	a
macrosociologica	l
macrosp	o
macrospo	r
macrospor	e
macrost	r
macrostr	u
macrostru	c
macrostruc	t
macrostruct	u
macrostructu	r
macrostructur	e
macrot	r
macrotr	i
macrotri	c
macrotric	h
macrotrich	i
macrotrichi	u
macrotrichiu	m
macru	m
macrum	o
macrumo	r
macrumor	s
macs	t
macst	u
macstu	d
macstud	i
macstudi	o
mact	iy
macti	p
mactip	s
macty	p
mactyp	e
macu	lp
macul	a
macula	rt
maculat	ei
maculati	o
maculatio	n
macup	d
macupd	a
macupda	t
macupdat	e
macupdate	d
macupdated	e
macupdatede	s
macupdatedes	k
macupdatedesk	t
macupdatedeskt	o
macupdatedeskto	p
macv	i
macvi	m
macw	o
macwo	r
macwor	l
macworl	d
mad	abcdefhiklmnorstvw
mada	gmr
madag	a
madaga	s
madagas	c
madagasc	a
madagasca	r
madam	es
madame	s
madar	o
madaro	s
madaros	i
madarosi	s
madb	v
madc	a
madca	p
madd	eio
madde	dnrs
madden	i
maddeni	n
maddenin	g
maddes	t
maddi	n
maddin	g
maddo	x
made	il
madei	r
madeir	a
madel	ei
madele	i
madelei	n
madelein	e
madeli	n
madelin	e
madh	oy
madho	u
madhou	s
madhous	e
madhy	a
madi	s
madis	ot
madiso	n
madist	o
madisto	r
madk	rv
madl	iy
madli	n
madlin	g
madm	ae
madma	gn
madmag	a
madmaga	z
madmagaz	i
madmagazi	n
madmagazin	e
madme	n
madn	e
madne	s
madnes	s
madness	e
madnesse	s
mado	n
madon	n
madonn	a
madonna	s
madr	ai
madra	s
madri	dg
madrig	a
madriga	l
mads	e
madse	n
madt	h
madth	u
madthu	m
madthum	b
madthumb	s
madw	o
madwo	m
madwom	a
madwoma	n
mae	lnsv
mael	s
maels	t
maelst	r
maelstr	o
maelstro	m
maen	a
maena	d
maes	t
maest	r
maestr	o
maev	e
maf	fi
maff	i
maffi	a
mafi	ao
mafio	s
mafios	io
mag	adefgilmnoprsuy
maga	z
magaz	i
magazi	n
magazin	eiy
magazine	drs
magazined	o
magazinedo	m
magaziner	y
magazini	ns
magazinin	g
magazinis	h
magd	a
magda	l
magdal	e
magdale	n
magdalen	e
mage	ln
magel	l
magell	a
magella	n
magellan	i
magellani	c
magen	t
magent	a
magenta	s
magf	i
magfi	l
magfil	m
magfilm	s
magg	io
maggi	e
maggo	t
maggot	sy
magi	cls
magic	aeiksu
magica	l
magical	il
magicali	t
magicalit	y
magicall	y
magice	d
magiced	e
magicede	n
magici	a
magicia	n
magician	s
magick	ei
magicke	d
magicki	n
magickin	g
magicu	i
magil	l
magis	t
magist	er
magiste	r
magister	i
magisteri	au
magisteria	l
magisteriu	m
magistr	a
magistra	clt
magistrac	y
magistrat	ei
magistrate	s
magistrates	h
magistratesh	i
magistrateshi	p
magistrateship	s
magistrati	c
magistratic	a
magistratica	l
magistratical	l
magistraticall	y
magl	e
magle	v
magm	a
magma	st
magmat	ai
magmati	cs
magmatic	a
magmatica	l
magmatical	l
magmaticall	y
magmatis	mt
magmatism	s
magn	aeiou
magna	dnt
magnad	u
magnadu	r
magnan	i
magnani	m
magnanim	io
magnanimi	t
magnanimit	y
magnanimo	u
magnanimou	s
magnanimous	ln
magnanimousl	y
magnanimousn	e
magnanimousne	s
magnanimousnes	s
magnanimousness	e
magnanimousnesse	s
magnat	e
magnate	s
magnates	h
magnatesh	i
magnateshi	p
magnateship	s
magne	st
magnes	i
magnesi	au
magnesia	n
magnesiu	m
magnesium	s
magnet	iors
magneti	cfstz
magnetic	ais
magnetica	l
magnetical	l
magneticall	y
magnetici	a
magneticia	n
magnetif	y
magnetis	eim
magnetise	drs
magnetisi	n
magnetisin	g
magnetism	s
magnetit	ei
magnetiti	c
magnetiz	aei
magnetiza	bt
magnetizab	il
magnetizabi	l
magnetizabil	i
magnetizabili	t
magnetizabilit	y
magnetizabl	e
magnetizat	i
magnetizati	o
magnetizatio	n
magnetize	drs
magnetizer	s
magnetizi	n
magnetizin	g
magneto	mns
magnetom	e
magnetome	t
magnetomet	e
magnetomete	r
magnetos	p
magnetosp	h
magnetosph	e
magnetosphe	r
magnetospher	e
magnetr	o
magnetro	n
magni	flt
magnif	iy
magnifi	ace
magnifia	b
magnifiab	l
magnifiabl	e
magnific	aeo
magnifica	t
magnificat	i
magnificati	o
magnificatio	n
magnifice	n
magnificen	ct
magnificenc	e
magnificent	ln
magnificentl	y
magnificentn	e
magnificentne	s
magnificentnes	s
magnificentness	e
magnificentnesse	s
magnifie	drs
magnify	i
magnifyi	n
magnifyin	g
magnil	o
magnilo	q
magniloq	u
magniloqu	e
magniloque	n
magniloquen	ct
magniloquenc	e
magnit	u
magnitu	d
magnitud	ei
magnitude	s
magnitudi	n
magnitudin	o
magnitudino	u
magnitudinou	s
magno	l
magnol	i
magnoli	a
magnu	ms
magnus	o
magnuso	n
mago	g
magp	i
magpi	e
magpie	s
magr	u
magru	d
magrud	e
magrude	r
mags	a
magsa	f
magsaf	e
magu	eis
mague	y
magui	r
maguir	e
maguire	s
magy	a
magya	r
mah	ajo
maha	rty
mahar	a
mahara	s
maharas	h
maharash	t
maharasht	r
maharashtr	a
mahat	m
mahatm	a
mahay	a
mahaya	n
mahayan	ai
mahayani	s
mahayanis	t
mahj	o
mahjo	n
mahjon	g
maho	gnu
mahog	a
mahoga	n
mahogan	iy
mahogani	e
mahoganie	s
mahon	e
mahone	y
mahou	t
mai	delmnsvz
maid	eikls
maide	n
maiden	hls
maidenh	ao
maidenha	i
maidenhai	r
maidenho	o
maidenhoo	d
maidenl	iy
maidenli	n
maidenlin	e
maidenline	s
maidenlines	s
maidens	h
maidensh	i
maidenshi	p
maidenship	s
maidi	s
maidis	h
maidish	n
maidishn	e
maidishne	s
maidishnes	s
maidishness	e
maidishnesse	s
maidk	i
maidki	n
maidl	i
maidli	n
maidlin	g
maids	e
maidse	r
maidser	v
maidserv	a
maidserva	n
maidservan	t
maie	r
mail	abefilmst
maila	b
mailab	il
mailabi	l
mailabil	i
mailabili	t
mailabilit	iy
mailabiliti	e
mailabilitie	s
mailabl	e
mailb	ao
mailba	g
mailbo	x
mailbox	e
mailboxe	s
maile	drs
mailes	t
mailf	e
mailfe	n
mailfen	c
mailfenc	e
maili	n
mailin	g
mailing	s
maill	eo
maille	s
mailles	s
maillo	t
mailm	ae
mailma	n
mailme	n
mails	e
mailse	r
mailser	v
mailserv	e
mailserve	r
mailt	o
maim	eis
maime	dr
maimed	ln
maimedl	y
maimedn	e
maimedne	s
maimednes	s
maimedness	e
maimednesse	s
maimer	s
maimi	n
maimin	g
main	efilmst
maine	ds
maines	t
mainf	r
mainfr	a
mainfra	m
mainfram	e
mainframe	s
maini	n
mainin	g
mainl	aiy
mainla	n
mainlan	d
mainli	n
mainlin	ei
mainline	drs
mainlini	n
mainlinin	g
mainm	a
mainma	s
mainmas	t
mains	aht
mainsa	i
mainsai	l
mainsail	s
mainsh	e
mainshe	e
mainshee	t
mainst	ar
mainsta	y
mainstay	s
mainstr	e
mainstre	a
mainstrea	m
mainstream	eis
mainstreame	dr
mainstreami	n
mainstreamin	g
maint	aeo
mainta	i
maintai	n
maintain	aeims
maintaina	b
maintainab	il
maintainabi	l
maintainabil	i
maintainabili	t
maintainabilit	iy
maintainabiliti	e
maintainabilitie	s
maintainabl	e
maintaine	dr
maintainer	s
maintaini	n
maintainin	g
maintainm	e
maintainme	n
maintainmen	t
mainte	n
mainten	a
maintena	bn
maintenab	i
maintenabi	l
maintenabil	i
maintenabili	t
maintenabilit	y
maintenan	c
maintenanc	e
maintenance	s
mainto	p
mais	o
maiso	n
maison	en
maisone	t
maisonet	t
maisonett	e
maisonette	s
maisonn	e
maisonne	t
maisonnet	t
maisonnett	e
maisonnette	s
maiz	e
maize	s
maj	aeouw
maje	s
majes	t
majest	iy
majesti	ce
majestic	an
majestica	l
majestical	ln
majesticall	y
majesticaln	e
majesticalne	s
majesticalnes	s
majesticn	e
majesticne	s
majesticnes	s
majestie	s
majo	lr
majol	i
majoli	c
majolic	a
major	cdeis
majorc	a
majord	o
majordo	m
majordom	o
majore	d
majori	nst
majorin	g
majoris	m
majorit	aiy
majorita	r
majoritar	i
majoritari	a
majoritaria	n
majoriti	e
majoritie	s
majors	h
majorsh	i
majorshi	p
maju	s
majus	c
majusc	u
majuscu	l
majuscul	e
mak	aeip
maka	b
makab	l
makabl	e
make	florsu
makef	ai
makefa	s
makefas	t
makefi	l
makefil	e
makel	e
makele	s
makeles	s
makeo	v
makeov	e
makeove	r
maker	ds
makerd	a
makerda	o
makes	h
makesh	i
makeshi	f
makeshif	t
makeshift	nsy
makeshiftn	e
makeshiftne	s
makeshiftnes	s
makeu	p
makeup	s
maki	n
makin	g
making	s
mal	acdefilnoprtw
mala	bcdgimprtwy
malab	a
malaba	r
malac	ho
malach	i
malachi	t
malachit	e
malaco	l
malacol	o
malacolo	g
malacolog	y
malad	ijmry
maladi	e
maladie	s
maladj	u
maladju	s
maladjus	t
maladjust	em
maladjuste	d
maladjustm	e
maladjustme	n
maladjustmen	t
maladm	i
maladmi	n
maladmin	i
maladmini	s
maladminis	t
maladminist	e
maladministe	r
maladr	o
maladro	i
maladroi	t
malag	au
malaga	s
malagas	y
malagu	e
malague	n
malaguen	a
malai	s
malais	e
malam	u
malamu	dt
malamut	e
malap	er
malape	r
malaper	t
malapr	o
malapro	p
malaprop	o
malapropo	s
malar	ik
malari	ao
malaria	ls
malario	u
malariou	s
malark	ey
malarke	y
malat	h
malath	i
malathi	o
malathio	n
malaw	i
malay	ais
malaya	l
malayal	a
malayala	m
malayi	z
malayiz	e
malayize	s
malays	i
malaysi	a
malaysia	n
malc	o
malco	ln
malcol	m
malcon	t
malcont	e
malconte	n
malconten	t
mald	ei
malde	n
maldi	v
maldiv	e
maldive	s
male	dfnrsv
maled	i
maledi	c
maledic	t
maledict	io
maledicti	o
maledictio	n
maledicto	r
maledictor	y
malef	ai
malefa	c
malefac	t
malefact	io
malefacti	o
malefactio	n
malefacto	r
malefactor	s
malefi	c
malefic	e
malefice	n
maleficen	ct
maleficenc	e
malen	e
malene	s
malenes	s
maleness	e
malenesse	s
males	t
malev	o
malevo	l
malevol	e
malevole	n
malevolen	ct
malevolenc	e
malf	eou
malfe	a
malfea	s
malfeas	a
malfeasa	n
malfeasan	ct
malfeasanc	e
malfo	r
malfor	m
malform	ae
malforma	t
malformat	i
malformati	o
malformatio	n
malformation	s
malforme	d
malfu	n
malfun	c
malfunc	t
malfunct	i
malfuncti	o
malfunctio	n
malfunction	eis
malfunctione	d
malfunctioni	n
malfunctionin	g
mali	bcgns
malib	u
malic	ei
malice	dfs
malicef	u
malicefu	l
malici	no
malicin	g
malicio	u
maliciou	s
malicious	ln
maliciousl	y
maliciousn	e
maliciousne	s
maliciousnes	s
malig	n
malign	aei
maligna	n
malignan	ct
malignanc	y
malignant	l
malignantl	y
maligne	r
maligni	t
malignit	y
malin	eg
maling	e
malinge	r
malis	m
mall	aeos
malla	r
mallar	d
malle	atu
mallea	b
malleab	il
malleabi	l
malleabil	i
malleabili	t
malleabilit	iy
malleabiliti	e
malleabilitie	s
malleabl	ey
malleable	i
malleablei	z
malleableiz	e
mallet	s
malleu	s
mallo	rw
mallor	cy
mallorc	a
maln	ou
malno	u
malnou	r
malnour	i
malnouri	s
malnouris	h
malnourish	e
malnourishe	d
malnu	t
malnut	r
malnutr	i
malnutri	t
malnutrit	i
malnutriti	o
malnutritio	n
malnutrition	s
malo	dn
malod	o
malodo	ru
malodor	o
malodoro	u
malodorou	s
malodou	r
malon	e
malone	y
malp	or
malpo	s
malpos	i
malposi	t
malposit	i
malpositi	o
malpositio	n
malpr	a
malpra	c
malprac	t
malpract	i
malpracti	c
malpractic	e
malpractice	s
malr	a
malra	u
malrau	x
malt	aehiorsy
malte	drs
maltes	e
malth	ou
maltho	u
malthou	s
malthous	e
malthu	s
malthus	i
malthusi	a
malthusia	n
malti	e
maltie	rs
malties	t
malto	bns
maltob	i
maltobi	o
maltobio	s
maltobios	e
maltobiose	s
maltos	e
maltose	s
maltr	e
maltre	a
maltrea	t
maltreat	eims
maltreate	dr
maltreater	s
maltreati	n
maltreatin	g
maltreatm	e
maltreatme	n
maltreatmen	t
maltreatment	s
malw	a
malwa	r
malwar	e
mam	abemp
mamb	ao
mame	l
mamel	u
mamelu	k
mameluk	e
mamm	aeioy
mamma	lrs
mammal	ils
mammali	a
mammalia	n
mammalian	s
mammall	i
mammalli	k
mammallik	e
mammar	iy
mammari	e
mammarie	s
mamme	e
mammi	f
mammif	e
mammife	r
mammifer	o
mammifero	u
mammiferou	s
mammo	nt
mammot	h
mammoth	s
mamp	p
mampp	r
mamppr	o
man	acdefghiklnoprstuvxyz
mana	cgkmt
manac	l
manacl	e
manag	eiu
manage	ademrs
managea	b
manageab	il
manageabi	l
manageabil	i
manageabili	t
manageabilit	iy
manageabiliti	e
manageabilitie	s
manageabl	ey
manageable	n
manageablen	e
manageablene	s
manageablenes	s
manageableness	e
manageablenesse	s
managem	e
manageme	n
managemen	t
management	as
managementa	l
manager	eis
managere	s
manageres	s
manageress	e
manageresse	s
manageri	a
manageria	l
managerial	l
manageriall	y
managers	h
managersh	i
managershi	p
managership	s
managi	n
managin	g
managu	a
manak	i
manaki	n
manam	a
manat	e
manate	e
manc	h
manch	eu
manche	s
manches	t
manchest	e
mancheste	r
manchu	r
manchur	i
manchuri	a
manchuria	n
mand	aeiory
manda	lmnrt
mandal	a
mandam	u
mandamu	s
mandar	i
mandari	n
mandarin	is
mandarini	cs
mandarinis	m
mandarinism	s
mandarins	h
mandarinsh	i
mandarinshi	p
mandat	eio
mandate	ds
mandati	n
mandatin	g
mandato	r
mandator	iy
mandatori	el
mandatorie	s
mandatoril	y
mande	l
mandel	b
mandelb	r
mandelbr	o
mandelbro	t
mandi	b
mandib	lu
mandibl	e
mandible	s
mandibu	l
mandibul	a
mandibula	r
mando	l
mandol	i
mandoli	n
mandr	aei
mandra	k
mandrak	e
mandre	l
mandri	l
mandril	l
mane	alsu
manea	t
maneat	i
maneati	n
maneatin	g
manel	e
manele	s
maneles	s
maneu	v
maneuv	e
maneuve	r
maneuver	aeis
maneuvera	b
maneuverab	il
maneuverabi	l
maneuverabil	i
maneuverabili	t
maneuverabilit	iy
maneuverabiliti	e
maneuverabilitie	s
maneuverabl	e
maneuvere	dr
maneuverer	s
maneuveri	n
maneuverin	g
manf	ru
manfr	e
manfre	d
manfu	l
mang	aeilory
manga	n
mangan	ei
mangane	s
manganes	ei
manganese	s
manganesi	a
manganesia	n
mangani	n
mange	r
manger	s
mangi	ln
mangil	y
mangin	e
mangine	s
mangines	s
mangl	ei
mangle	drs
mangler	s
mangli	n
manglin	g
mango	es
mangoe	s
mangos	t
mangost	e
mangoste	e
mangostee	n
mangr	o
mangro	v
mangrov	e
mangrove	s
manh	aou
manha	nt
manhan	d
manhand	l
manhandl	e
manhat	t
manhatt	a
manhatta	n
manhattan	i
manhattani	z
manhattaniz	e
manhattanize	s
manho	lo
manhol	e
manhole	s
manhoo	d
manhood	s
manhu	n
manhun	t
mani	acefklopt
mania	cs
maniac	as
maniaca	l
manic	ahosu
manica	l
manical	l
manicall	y
manich	e
maniche	e
manicu	r
manicur	ei
manicure	ds
manicuri	ns
manicurin	g
manicuris	t
manie	s
manif	eo
manife	s
manifes	t
manifest	aeilnos
manifesta	bt
manifestab	l
manifestabl	e
manifestat	i
manifestati	o
manifestatio	n
manifestation	ais
manifestationa	l
manifestationi	s
manifestationis	t
manifeste	dr
manifester	s
manifesti	nv
manifestin	g
manifestiv	e
manifestl	y
manifestn	e
manifestne	s
manifestnes	s
manifestness	e
manifestnesse	s
manifesto	eis
manifestoe	ds
manifestoi	n
manifestoin	g
manifo	l
manifol	d
manifold	eilns
manifolde	d
manifoldi	n
manifoldin	g
manifoldl	y
manifoldn	e
manifoldne	s
manifoldnes	s
manifoldness	e
manifoldnesse	s
manik	i
maniki	n
manil	a
manio	c
manip	lu
manipl	e
manipu	l
manipul	a
manipula	bt
manipulab	il
manipulabi	l
manipulabil	i
manipulabili	t
manipulabilit	y
manipulabl	e
manipulat	aeio
manipulata	b
manipulatab	l
manipulatabl	e
manipulate	ds
manipulati	nov
manipulatin	g
manipulatio	n
manipulation	s
manipulativ	e
manipulative	lns
manipulativel	y
manipulativen	e
manipulativene	s
manipulativenes	s
manipulativeness	e
manipulativenesse	s
manipulato	r
manipulator	sy
manit	o
manito	bw
manitob	a
manitow	o
manitowo	c
mank	io
manki	n
mankin	d
mankind	s
manko	w
mankow	s
mankows	k
mankowsk	i
manl	eiy
manle	sy
manles	s
manless	ln
manlessl	y
manlessn	e
manlessne	s
manlessnes	s
manlessness	e
manlessnesse	s
manli	ehln
manlie	rs
manlies	t
manlih	o
manliho	o
manlihoo	d
manlil	y
manlin	e
manline	s
manlines	s
manliness	e
manlinesse	s
mann	aei
manne	dqrs
manneq	u
mannequ	i
mannequi	n
manner	eils
mannere	d
manneri	s
manneris	mt
mannerism	s
mannerist	is
manneristi	c
manneristic	a
manneristica	l
manneristical	l
manneristicall	y
mannerl	ey
mannerle	s
mannerles	s
mannes	s
manness	e
mannesse	s
manni	ns
mannin	g
mannis	h
mano	emr
manoe	u
manoeu	v
manoeuv	r
manoeuvr	ae
manoeuvra	b
manoeuvrab	il
manoeuvrabi	l
manoeuvrabil	i
manoeuvrabili	t
manoeuvrabilit	y
manoeuvrabl	e
manoeuvre	drs
manom	e
manome	t
manomet	er
manomete	r
manometer	s
manometr	i
manometri	c
manor	is
manori	a
manoria	l
manorial	i
manoriali	s
manorialis	m
manorialism	s
manors	h
manorsh	i
manorshi	p
manp	ao
manpa	c
manpac	k
manpo	w
manpow	e
manpowe	r
manpower	s
mans	aefilou
mansa	r
mansar	d
manse	r
manser	v
manserv	a
manserva	n
manservan	t
mansf	i
mansfi	e
mansfie	l
mansfiel	d
mansi	o
mansio	n
mansion	rs
mansionr	y
mansl	a
mansla	u
manslau	g
manslaug	h
manslaugh	t
manslaught	e
manslaughte	r
manslaughter	eios
manslaughtere	dr
manslaughteri	n
manslaughterin	g
manslaughtero	u
manslaughterou	s
manso	n
mansu	e
mansue	t
mansuet	u
mansuetu	d
mansuetud	e
mant	eil
mante	als
mantea	u
manteau	x
mantel	eps
mantele	t
mantelp	i
mantelpi	e
mantelpie	c
mantelpiec	e
mantelpiece	s
manti	cls
mantil	l
mantill	a
mantis	es
mantise	s
mantiss	a
mantissa	s
mantl	ei
mantle	dprstw
mantlep	i
mantlepi	e
mantlepie	c
mantlepiec	e
mantler	o
mantlero	c
mantleroc	k
mantlew	i
mantlewi	s
mantlewis	e
mantli	n
mantlin	g
manu	acefmrs
manua	l
manual	ils
manuali	s
manualis	t
manuall	y
manuc	o
manuco	d
manucod	e
manue	l
manuf	a
manufa	c
manufac	t
manufact	ou
manufacto	r
manufactor	y
manufactu	r
manufactur	aei
manufactura	bl
manufacturab	il
manufacturabi	l
manufacturabil	i
manufacturabili	t
manufacturabilit	iy
manufacturabiliti	e
manufacturabilitie	s
manufacturabl	e
manufacture	drs
manufacturer	s
manufacturi	n
manufacturin	g
manufacturing	s
manum	i
manumi	st
manumis	s
manumiss	i
manumissi	o
manumissio	n
manur	ei
manure	dmrsy
manurem	e
manureme	n
manuremen	t
manurer	s
manuri	an
manuria	l
manurial	l
manuriall	y
manurin	g
manus	c
manusc	r
manuscr	i
manuscri	p
manuscrip	t
manuscript	asu
manuscripta	l
manuscriptu	r
manuscriptur	a
manuscriptura	l
manv	i
manvi	l
manvil	l
manvill	e
many	n
manyn	e
manyne	s
manynes	s
manz	a
manza	n
manzan	i
manzani	t
manzanit	a
mao	berv
maor	i
maori	s
map	lpqsv
mapl	ei
maple	cls
maplec	r
maplecr	e
maplecre	s
maplecres	t
maplel	i
mapleli	k
maplelik	e
maples	s
mapli	k
maplik	e
mapp	aeiy
mappa	b
mappab	l
mappabl	e
mappe	dr
mapper	s
mappi	ns
mappin	g
mapping	s
mappis	t
mapq	u
mapqu	e
mapque	s
mapques	t
maq	deijux
maqd	v
maqu	e
maque	t
maquet	t
maquett	e
mar	abcdegijklmoqrstvxyz
mara	bcstu
marab	o
marabo	u
marabou	t
marac	a
maraca	s
maras	c
marasc	a
marat	h
marath	o
maratho	n
marathon	es
marathone	r
marau	d
marb	l
marbl	eiy
marble	lrs
marblel	i
marbleli	k
marblelik	e
marbler	s
marbli	n
marblin	g
marc	ehiouy
marce	al
marcea	u
marcel	l
marcell	o
march	eil
marche	drs
marchi	no
marchin	g
marchio	n
marchion	e
marchione	s
marchiones	s
marchl	i
marchli	k
marchlik	e
marci	a
marco	st
marcot	t
marcott	e
marcu	s
mard	i
mardi	s
mare	s
marg	aeioru
marga	r
margar	ei
margare	t
margari	n
margarin	e
margarine	s
marge	nr
margen	t
marger	y
margi	n
margin	aeils
margina	lt
marginal	ils
marginali	atz
marginalit	iy
marginaliti	e
marginalitie	s
marginaliz	e
marginall	y
marginat	e
margine	d
margini	n
marginin	g
marginl	e
marginle	s
marginles	s
margr	a
margra	v
margrav	e
margu	e
margue	r
marguer	i
margueri	t
marguerit	e
mari	aceghjlmnost
maria	dhn
mariad	b
marian	an
mariann	e
maric	u
maricu	l
maricul	t
maricult	u
maricultu	r
maricultur	e
marie	t
mariet	t
mariett	a
marig	o
marigo	l
marigol	d
marih	u
marihu	a
marihua	n
marihuan	a
marihuana	s
marij	u
mariju	a
marijua	n
marijuan	a
marijuana	s
maril	y
marily	n
marim	b
marimb	a
marin	aeo
marina	dst
marinad	ei
marinade	ds
marinadi	n
marinadin	g
marinat	ei
marinate	ds
marinati	no
marinatin	g
marinatio	n
marination	s
marine	rs
mariner	s
mario	ln
mariol	a
mariola	t
mariolat	r
mariolatr	y
marion	e
marione	t
marionet	t
marionett	e
maris	h
marit	ai
marita	l
marital	il
maritali	t
maritalit	y
maritall	y
mariti	m
maritim	e
marj	o
marjo	r
marjor	aiy
marjora	m
marjori	e
mark	adehiklmostu
marka	b
markab	l
markabl	e
markd	o
markdo	w
markdow	n
marke	drt
marked	ln
markedl	y
markedn	e
markedne	s
markednes	s
markedness	e
markednesse	s
marker	s
market	aeips
marketa	b
marketab	il
marketabi	l
marketabil	i
marketabili	t
marketabilit	iy
marketabiliti	e
marketabilitie	s
marketabl	ey
marketable	n
marketablen	e
marketablene	s
marketablenes	s
marketableness	e
marketablenesse	s
markete	der
marketee	r
marketer	s
marketi	n
marketin	g
marketing	s
marketp	l
marketpl	a
marketpla	c
marketplac	e
marketplace	s
markh	a
markha	m
marki	ns
markin	g
marking	s
markis	m
markk	a
markl	e
markle	s
markles	s
markm	y
markmy	w
markmyw	o
markmywo	r
markmywor	d
markmyword	s
marko	v
markov	i
markovi	at
markovia	n
markovit	z
marks	m
marksm	ae
marksma	n
marksman	s
marksmans	h
marksmansh	i
marksmanshi	p
marksmanship	s
marksme	n
markt	e
markte	x
marktex	t
marku	ps
marl	beioy
marlb	o
marlbo	r
marlbor	o
marlboro	u
marlborou	g
marlboroug	h
marle	ny
marlen	e
marli	nt
marlin	e
marlit	e
marlo	w
marlow	e
marm	ao
marma	l
marmal	a
marmala	d
marmalad	ey
marmalade	s
marmo	st
marmos	e
marmose	t
maro	co
maroc	a
maroca	i
marocai	n
maroo	n
maroon	eis
maroone	d
marooni	n
maroonin	g
marq	u
marqu	ei
marque	et
marquee	s
marquet	rt
marquetr	y
marquett	e
marqui	s
marquis	ae
marquisa	t
marquisat	e
marquise	t
marquiset	t
marquisett	e
marr	aioy
marra	mt
marrat	e
marri	aeo
marria	g
marriag	e
marriage	as
marriagea	b
marriageab	il
marriageabi	l
marriageabil	i
marriageabili	t
marriageabilit	y
marriageabl	e
marrie	drs
married	ls
marriedl	y
marrier	s
marrio	t
marriot	t
marro	w
marrow	eisy
marrowe	d
marrowi	s
marrowis	h
marry	i
marryi	n
marryin	g
mars	ehu
marse	dix
marsed	i
marsedi	t
marsei	l
marseil	l
marseill	e
marseille	s
marsex	p
marsexp	l
marsexpl	o
marsexplo	r
marsexplor	a
marsexplora	t
marsexplorat	i
marsexplorati	o
marsexploratio	n
marsexploration	r
marsexplorationr	o
marsexplorationro	v
marsexplorationrov	e
marsexplorationrove	r
marsexplorationrover	ab
marsh	aelmy
marsha	l
marshal	ceils
marshalc	i
marshalci	e
marshalcie	s
marshale	drs
marshaler	s
marshales	s
marshali	n
marshalin	g
marshall	eis
marshalle	dr
marshaller	s
marshalli	n
marshallin	g
marshals	h
marshalsh	i
marshalshi	p
marshalship	s
marshe	s
marshl	ai
marshla	n
marshlan	d
marshli	k
marshlik	e
marshm	a
marshma	l
marshmal	l
marshmall	o
marshmallo	w
marsu	p
marsup	i
marsupi	au
marsupia	lt
marsupial	s
marsupiat	e
marsupiu	m
mart	ehilsy
marte	n
marth	a
marti	an
martia	ln
martial	iln
martiali	st
martialis	mt
martialism	s
martialist	s
martialit	y
martiall	y
martialn	e
martialne	s
martialnes	s
martialness	e
martialnesse	s
martian	s
martin	egims
martine	tz
marting	a
martinga	l
martingal	e
martini	q
martiniq	u
martiniqu	e
martinm	a
martinma	s
martins	o
martinso	n
martl	e
martle	t
marty	r
martyr	dils
martyrd	o
martyrdo	m
martyri	ansz
martyria	l
martyrin	g
martyris	h
martyriz	aei
martyriza	t
martyrizat	i
martyrizati	o
martyrizatio	n
martyrization	s
martyrize	ds
martyrizi	n
martyrizin	g
martyrl	iy
martyrli	k
martyrlik	e
marv	ei
marve	l
marvel	eilmos
marvele	d
marveli	n
marvelin	g
marvell	eio
marvelle	dr
marvelli	n
marvellin	g
marvelling	l
marvellingl	y
marvello	u
marvellou	s
marvellous	l
marvellousl	y
marvelm	e
marvelme	n
marvelmen	t
marvelment	s
marvelo	u
marvelou	s
marvelous	ln
marvelousl	y
marvelousn	e
marvelousne	s
marvelousnes	s
marvi	n
marx	i
marxi	as
marxia	n
marxis	mt
marxism	s
marxist	s
mary	l
maryl	a
maryla	n
marylan	d
maryland	e
marylande	r
marylander	s
marz	i
marzi	p
marzip	a
marzipa	n
marzipan	ns
marzipann	ei
marzipanne	d
marzipanni	n
marzipannin	g
mas	cehikoqst
masc	aou
masca	r
mascar	a
mascara	eis
mascarae	d
mascarai	n
mascarain	g
masco	nt
mascot	rs
mascotr	y
mascu	l
mascul	i
masculi	n
masculin	ei
masculine	lns
masculinel	y
masculinen	e
masculinene	s
masculinenes	s
masculineness	e
masculinenesse	s
masculini	t
masculinit	iy
masculiniti	e
masculinitie	s
mase	r
maser	au
masera	t
maserat	i
mash	eis
mashe	ds
mashi	n
mashin	g
mashing	s
masi	o
masio	n
mask	aeils
maska	b
maskab	l
maskabl	e
maske	dr
maski	n
maskin	g
masking	s
maskl	i
maskli	k
masklik	e
maso	cn
masoc	h
masoch	i
masochi	s
masochis	mt
masochism	s
masochist	is
masochisti	c
masochistic	a
masochistica	l
masochistical	l
masochisticall	y
mason	eirs
masone	dr
masoni	cnt
masonin	g
masonit	e
masonr	iy
masonri	e
masonrie	ds
masq	u
masqu	e
masque	rs
masquer	a
masquera	d
masquerad	ei
masquerade	drs
masquerader	s
masqueradi	n
masqueradin	g
mass	aei
massa	cg
massac	hr
massach	u
massachu	s
massachus	e
massachuse	t
massachuset	t
massachusett	s
massacr	ei
massacre	drs
massacrer	s
massacri	n
massacrin	g
massag	ei
massage	drs
massager	s
massagi	ns
massagin	g
massagis	t
massagist	s
masse	drsuy
massed	l
massedl	y
masses	t
masseu	rs
masseus	e
massi	fnv
massin	eg
massine	s
massines	s
massiv	ei
massive	lns
massivel	y
massiven	e
massivene	s
massivenes	s
massiveness	e
massivenesse	s
massivi	t
massivit	iy
massiviti	e
massivitie	s
mast	ehilosu
maste	cdr
mastec	t
mastect	o
mastecto	m
mastectom	y
master	bcefhilmpsy
masterb	a
masterba	t
masterbat	i
masterbati	no
masterbatin	g
masterbatio	n
masterc	a
masterca	r
mastercar	d
mastere	dr
masterf	u
masterfu	l
masterful	l
masterfull	y
masterh	o
masterho	o
masterhoo	d
masteri	en
masterie	s
masterin	g
mastering	s
masterl	y
masterm	i
mastermi	n
mastermin	d
mastermind	eis
masterminde	d
mastermindi	n
mastermindin	g
masterp	i
masterpi	e
masterpie	c
masterpiec	e
masterpiece	s
masters	ht
mastersh	i
mastershi	p
mastership	s
masterst	r
masterstr	o
masterstro	k
masterstrok	e
masth	e
masthe	a
masthea	d
masti	cft
mastic	a
mastica	t
masticat	eio
masticati	o
masticatio	n
masticato	r
masticator	y
mastif	f
mastit	i
mastiti	s
mastl	i
mastli	k
mastlik	e
masto	di
mastod	o
mastodo	n
mastoi	d
mastoid	i
mastoidi	t
mastoidit	i
mastoiditi	s
mastu	r
mastur	b
masturb	a
masturba	t
masturbat	eio
masturbate	ds
masturbati	no
masturbatin	g
masturbatio	n
masturbato	r
masturbator	sy
mat	acehilrstuvz
mata	d
matad	o
matado	r
matc	h
match	abeilms
matcha	b
matchab	l
matchabl	e
matchb	o
matchbo	ox
matchboo	k
matchbox	e
matchboxe	s
matche	drs
matcher	s
matchi	n
matchin	g
matching	s
matchl	eo
matchle	s
matchles	s
matchlo	c
matchloc	k
matchm	a
matchma	k
matchmak	ei
matchmake	r
matchmaki	n
matchmakin	g
matchs	t
matchst	i
matchsti	c
matchstic	k
matchstick	s
mate	dhorsy
mateh	o
mateho	o
matehoo	d
mater	fin
materf	a
materfa	m
materfam	i
materfami	l
materfamil	i
materfamili	a
materfamilia	s
materi	a
materia	l
material	ilns
materiali	stz
materialis	eimt
materialise	ds
materialisi	n
materialisin	g
materialism	s
materialist	is
materialisti	c
materialistic	a
materialistica	l
materialistical	l
materialisticall	y
materialit	y
materializ	aei
materializa	t
materializat	i
materializati	o
materializatio	n
materialize	drs
materializer	s
materializi	n
materializin	g
materiall	y
materialn	e
materialne	s
materialnes	s
materialness	e
materialnesse	s
matern	ai
materna	l
maternal	il
maternali	s
maternalis	mt
maternalism	s
maternalist	i
maternalisti	c
maternall	y
materni	t
maternit	iy
materniti	e
maternitie	s
math	eist
mathe	mw
mathem	a
mathema	t
mathemat	i
mathemati	ck
mathematic	ais
mathematica	l
mathematical	l
mathematicall	y
mathematici	a
mathematicia	n
mathematician	s
mathematics	e
mathematicse	s
mathew	s
mathews	o
mathewso	n
mathi	ae
mathia	s
mathie	u
matht	y
mathty	p
mathtyp	e
mati	lns
matil	d
matild	a
matin	eg
matine	e
mating	s
matis	s
matiss	e
matisse	s
matl	ae
matla	b
matle	s
matles	s
matr	io
matri	aclmx
matria	r
matriar	c
matriarc	h
matriarch	aisy
matriarcha	lt
matriarchal	i
matriarchali	s
matriarchalis	m
matriarchalism	s
matriarchat	e
matriarchi	e
matriarchie	s
matric	eiu
matrice	s
matrici	d
matricid	ae
matricida	l
matricide	s
matricu	l
matricul	a
matricula	nt
matriculan	t
matriculat	ei
matriculati	o
matriculatio	n
matril	i
matrili	n
matrilin	e
matriline	a
matrilinea	lr
matrim	o
matrimo	n
matrimon	iy
matrimoni	ae
matrimonia	l
matrimonie	s
matrix	e
matrixe	s
matro	ins
matroi	d
matron	ahils
matrona	gl
matronag	e
matronh	o
matronho	o
matronhoo	d
matronhood	s
matroni	s
matronis	m
matronl	y
matrons	h
matronsh	i
matronshi	p
matronship	s
matros	k
matrosk	a
mats	ou
matso	n
matsu	m
matsum	o
matsumo	t
matsumot	o
matt	ehiors
matte	drs
matted	ln
mattedl	y
mattedn	e
mattedne	s
mattednes	s
mattedness	e
mattednesse	s
matter	efilsy
mattere	d
matterf	u
matterfu	l
matteri	ns
matterin	g
matteris	h
matterl	e
matterle	s
matterles	s
mattes	t
matth	ei
matthe	w
matthew	s
matthi	a
matthia	s
matti	en
mattin	g
matto	c
mattoc	k
mattr	e
mattre	s
mattres	s
mattress	e
mattresse	s
matts	o
mattso	n
matu	rt
matur	aei
matura	t
maturat	ei
maturati	o
maturatio	n
mature	dlmnrs
maturel	y
maturem	e
matureme	n
maturemen	t
maturement	s
maturen	e
maturene	s
maturenes	s
matureness	e
maturenesse	s
maturer	s
matures	t
maturi	nt
maturin	g
maturit	iy
maturiti	e
maturitie	s
matut	i
matuti	n
matutin	a
matutina	l
matz	o
matzo	st
matzot	h
mau	dgilnrsv
maud	el
maudl	i
maudli	n
maug	r
maugr	e
maul	eis
maule	dr
mauli	n
maulin	g
maun	d
maund	e
maunde	r
maur	eiv
maure	e
mauree	n
mauri	cnt
mauric	ei
maurici	o
maurin	e
maurit	ai
maurita	n
mauritan	i
mauritani	a
mauriti	u
mauritiu	s
maus	eo
mause	r
mauso	l
mausol	e
mausole	u
mausoleu	m
mauv	ei
mauve	rs
mauves	t
mauvi	s
mauvis	h
mav	aei
mava	r
mave	nr
maver	i
maveri	c
maveric	k
maverick	s
mavi	ns
maw	kr
mawk	i
mawki	s
mawkis	h
max	eimostw
maxe	drs
maxes	t
maxi	lmn
maxil	l
maxill	a
maxilla	r
maxillar	y
maxim	aisu
maxima	lt
maximal	l
maximall	y
maximat	i
maximati	o
maximatio	n
maximation	s
maximi	lnsz
maximil	i
maximili	a
maximilia	n
maximis	eit
maximise	ds
maximisi	n
maximisin	g
maximiz	aei
maximiza	t
maximizat	i
maximizati	o
maximizatio	n
maximization	s
maximize	drs
maximizer	s
maximizi	n
maximizin	g
maximu	m
maximum	ls
maximuml	y
maxin	eg
maxm	i
maxmi	n
maxmin	d
maxo	n
maxt	o
maxto	r
maxw	e
maxwe	l
maxwel	l
maxwell	i
maxwelli	a
maxwellia	n
may	abdefhilnop
maya	n
mayan	s
mayb	ae
mayba	c
maybac	h
maybe	s
mayd	a
mayda	y
mayday	s
maye	dnr
mayf	al
mayfa	i
mayfai	r
mayfl	oy
mayflo	w
mayflow	e
mayflowe	r
mayh	ae
mayha	p
mayhe	m
mayi	n
mayin	g
mayl	a
mayla	w
maylaw	n
mayn	a
mayna	r
maynar	d
mayo	nrt
mayon	n
mayonn	a
mayonna	i
mayonnai	s
mayonnais	e
mayonnaise	ds
mayor	adels
mayora	l
mayoral	t
mayoralt	y
mayord	o
mayordo	m
mayore	s
mayores	s
mayoress	e
mayoresse	s
mayorl	e
mayorle	t
mayors	h
mayorsh	i
mayorshi	p
mayorship	s
mayot	t
mayott	e
mayp	o
maypo	lp
maypol	e
maz	adeiy
maza	r
mazar	i
mazari	n
mazarin	e
mazd	ae
mazda	ei
mazdae	a
mazdaea	n
mazdai	s
mazdais	t
mazde	ai
mazdea	n
mazdei	s
mazdeis	t
maze	dflms
mazed	ln
mazedl	y
mazedn	e
mazedne	s
mazednes	s
mazef	u
mazefu	l
mazel	i
mazeli	k
mazelik	e
mazem	e
mazeme	n
mazemen	t
mazi	n
mazin	g
mb	abcdefghijklmnopqrsuvwxyz
mba	abcdfjoqrstvwx
mbab	a
mbaba	n
mbaban	e
mbaf	v
mbb	bdfhksvyz
mbbb	v
mbbf	v
mbc	chj
mbd	mrv
mbdm	v
mbe	dfhikmrswz
mbed	rsv
mbf	bdfk
mbfb	v
mbfd	v
mbg	n
mbgn	rv
mbh	rv
mbi	av
mbj	djovy
mbk	fv
mbl	ahloruxy
mbly	v
mbm	abefgipuw
mbmb	v
mbmf	v
mbn	cfiloprstuvz
mbnp	v
mbnt	v
mbo	dr
mbor	rv
mbp	fhosvz
mbq	jp
mbr	bru
mbrr	rv
mbs	bv
mbu	emop
mbv	v
mbx	deuv
mby	bdmt
mbyt	e
mbz	o
mc	abcdefghijklmnopqrsuvwy
mca	dflrv
mcad	a
mcada	m
mcadam	s
mcaf	e
mcafe	e
mcal	lp
mcall	i
mcalli	s
mcallis	t
mcallist	e
mcalliste	r
mcalp	i
mcalpi	n
mcalpin	e
mcar	t
mcart	h
mcarth	u
mcarthu	r
mcav	o
mcavo	y
mcb	r
mcbr	i
mcbri	d
mcbrid	e
mcc	ahloruv
mcca	bfilnru
mccab	e
mccaf	ef
mccaff	r
mccaffr	e
mccaffre	y
mccai	n
mccal	l
mccall	u
mccallu	m
mccan	n
mccar	rt
mccarr	o
mccarro	n
mccart	hny
mccarth	y
mccarthy	i
mccarthyi	s
mccarthyis	m
mccartn	e
mccartne	y
mccau	l
mccaul	e
mccaule	y
mccl	aeou
mccla	i
mcclai	n
mccle	al
mcclea	n
mcclel	l
mcclell	a
mcclella	n
mcclellan	d
mcclo	s
mcclos	k
mcclosk	e
mccloske	y
mcclu	rs
mcclur	e
mcclus	k
mcclusk	e
mccluske	y
mcco	nruy
mccon	n
mcconn	e
mcconne	l
mcconnel	l
mccor	mq
mccorm	ai
mccorma	c
mccormac	k
mccormi	c
mccormic	k
mccorq	u
mccorqu	o
mccorquo	d
mccorquod	a
mccorquoda	l
mccorquodal	e
mccou	r
mccour	t
mccr	aeo
mccra	c
mccrac	k
mccrack	e
mccracke	n
mccre	a
mccrea	d
mccread	y
mccro	n
mccron	e
mccu	l
mccul	l
mccull	o
mccullo	cu
mcculloc	h
mccullou	g
mcculloug	h
mcd	aejo
mcda	n
mcdan	i
mcdani	e
mcdanie	l
mcde	r
mcder	m
mcderm	o
mcdermo	t
mcdermot	t
mcdo	nuw
mcdon	ano
mcdona	l
mcdonal	d
mcdonald	s
mcdonn	e
mcdonne	l
mcdonnel	l
mcdono	u
mcdonou	g
mcdonoug	h
mcdou	g
mcdoug	a
mcdouga	l
mcdougal	l
mcdow	e
mcdowe	l
mcdowel	l
mce	belnvw
mceb	v
mcel	hr
mcelh	a
mcelha	n
mcelhan	e
mcelhane	y
mcelr	o
mcelro	y
mcen	r
mcenr	o
mcenro	e
mcev	o
mcevo	y
mcew	aev
mcewa	n
mcewe	n
mcf	a
mcfa	dlr
mcfad	d
mcfadd	e
mcfadde	n
mcfal	l
mcfar	l
mcfarl	a
mcfarla	n
mcfarlan	de
mcg	aehioru
mcga	r
mcgar	r
mcgarr	y
mcge	e
mcgh	e
mcghe	e
mcgi	ln
mcgil	l
mcgin	lnt
mcginl	e
mcginle	y
mcginn	i
mcginni	s
mcgint	y
mcgo	vw
mcgov	e
mcgove	r
mcgover	n
mcgow	a
mcgowa	n
mcgr	ae
mcgra	tw
mcgrat	h
mcgre	g
mcgreg	o
mcgrego	r
mcgu	i
mcgui	gnr
mcguig	a
mcguiga	n
mcguin	n
mcguinn	e
mcguinne	s
mcguinnes	s
mcguir	e
mch	au
mcha	l
mchal	e
mchu	g
mchug	h
mci	nv
mcin	nt
mcinn	e
mcinne	s
mcint	oy
mcinto	s
mcintos	h
mcinty	r
mcintyr	e
mciv	o
mcivo	r
mcj	v
mck	aein
mcka	y
mcke	acenos
mckea	n
mckec	h
mckech	n
mckechn	i
mckechni	e
mcken	dnz
mckend	r
mckendr	i
mckendri	c
mckendric	k
mckenn	a
mckenz	i
mckenzi	e
mckeo	nw
mckeow	n
mckes	s
mckess	o
mckesso	n
mcki	n
mckin	lns
mckinl	ae
mckinla	y
mckinle	y
mckinn	eo
mckinne	y
mckinno	n
mckins	e
mckinse	y
mckn	i
mckni	g
mcknig	h
mcknigh	t
mcl	aeouv
mcla	cnru
mclac	h
mclach	l
mclachl	a
mclachla	n
mclan	a
mclana	h
mclanah	a
mclanaha	n
mclar	e
mclare	n
mclau	g
mclaug	h
mclaugh	l
mclaughl	i
mclaughli	n
mcle	alno
mclea	n
mclel	l
mclell	a
mclella	n
mclen	n
mclenn	a
mclenna	n
mcleo	d
mclo	u
mclou	g
mcloug	h
mclough	l
mcloughl	i
mcloughli	n
mclu	h
mcluh	a
mcluha	n
mcm	aiu
mcma	hnrs
mcmah	o
mcmaho	n
mcman	au
mcmana	m
mcmanam	a
mcmanama	n
mcmanu	s
mcmar	t
mcmart	i
mcmarti	n
mcmas	t
mcmast	e
mcmaste	r
mcmi	l
mcmil	l
mcmill	a
mcmilla	n
mcmu	lr
mcmul	l
mcmull	ae
mcmulla	n
mcmulle	n
mcmur	d
mcmurd	o
mcn	aeruv
mcna	bilmu
mcnai	r
mcnal	l
mcnall	y
mcnam	a
mcnama	r
mcnamar	a
mcnau	g
mcnaug	h
mcnaugh	t
mcnaught	o
mcnaughto	n
mcne	ai
mcnea	l
mcneal	y
mcnei	l
mcneil	l
mcnu	l
mcnul	t
mcnult	y
mco	lrsv
mcp	hu
mcph	e
mcphe	er
mcpher	s
mcphers	o
mcpherso	n
mcq	u
mcqu	ae
mcqua	i
mcquai	d
mcque	e
mcquee	n
mcr	as
mcra	e
mcs	behklruvw
mcsh	a
mcsha	n
mcshan	e
mcsw	v
mcu	a
mcw	civ
mcwi	l
mcwil	l
mcwill	i
mcwilli	a
mcwillia	m
mcwilliam	s
md	abcdegijkmnoqstvwxy
mda	v
mdb	s
mdc	r
mde	emqz
mdg	v
mdi	l
mdj	v
mdm	r
mdn	fmv
mdo	v
mdq	l
mdt	b
mdv	m
mdy	vy
me	abcdefgiklmnoprstvwxyz
mea	dglnst
mead	eo
meado	w
meadow	eilsy
meadowe	d
meadowi	n
meadowin	g
meadowl	e
meadowle	s
meadowles	s
meadows	w
meadowsw	e
meadowswe	e
meadowswee	t
meag	er
meage	r
meager	ln
meagerl	y
meagern	e
meagerne	s
meagernes	s
meagr	e
meagre	ln
meagrel	y
meagren	e
meagrene	s
meagrenes	s
meal	ailstwy
meala	b
mealab	l
mealabl	e
meali	e
meall	e
mealle	s
mealles	s
mealt	i
mealti	m
mealtim	e
mealtime	s
mealw	o
mealwo	r
mealwor	m
mean	deilnstw
meand	e
meande	r
meander	eis
meandere	dr
meanderer	s
meanderi	n
meanderin	g
meandering	l
meanderingl	y
meane	rs
meaner	s
meanes	t
meani	in
meanii	n
meaniin	g
meanin	g
meaning	flns
meaningf	u
meaningfu	l
meaningful	ln
meaningfull	y
meaningfuln	e
meaningfulne	s
meaningfulnes	s
meaningfulness	e
meaningfulnesse	s
meaningl	ey
meaningle	s
meaningles	s
meaningless	ln
meaninglessl	y
meaninglessn	e
meaninglessne	s
meaninglessnes	s
meaninglessness	e
meaninglessnesse	s
meaningn	e
meaningne	s
meaningnes	s
meaningness	e
meaningnesse	s
meanl	ey
meanle	s
meanles	s
meann	e
meanne	s
meannes	s
meanness	e
meannesse	s
means	p
meansp	i
meanspi	r
meanspir	i
meanspiri	t
meanspirit	e
meanspirite	d
meant	i
meanti	m
meantim	e
meantime	s
meanw	h
meanwh	i
meanwhi	l
meanwhil	e
meanwhile	s
meas	lu
measl	eiy
measle	ds
measles	e
measlese	s
measli	e
measlie	rs
measlies	t
measu	r
measur	aei
measura	b
measurab	il
measurabi	l
measurabil	i
measurabili	t
measurabilit	iy
measurabiliti	e
measurabilitie	s
measurabl	ey
measurable	n
measurablen	e
measurablene	s
measurablenes	s
measurableness	e
measurablenesse	s
measure	dlmrs
measurel	e
measurele	s
measureles	s
measurem	e
measureme	n
measuremen	t
measurement	s
measurer	s
measuri	n
measurin	g
meat	beilsy
meatb	a
meatba	l
meatbal	l
meatball	s
meate	ad
meatea	t
meateat	i
meateati	n
meateatin	g
meati	eln
meatie	rs
meaties	t
meatil	y
meatin	e
meatine	s
meatines	s
meatiness	e
meatinesse	s
meatl	e
meatle	s
meatles	s
meatless	n
meatlessn	e
meatlessne	s
meatlessnes	s
meb	r
mebr	a
mebra	n
mebran	e
mec	ch
mecc	a
mecca	ns
meccan	s
mech	a
mecha	n
mechan	io
mechani	csz
mechanic	ais
mechanica	l
mechanical	ilns
mechanicali	stz
mechanicalis	m
mechanicalit	iy
mechanicaliti	e
mechanicalitie	s
mechanicaliz	ae
mechanicaliza	t
mechanicalizat	i
mechanicalizati	o
mechanicalizatio	n
mechanicall	y
mechanicaln	e
mechanicalne	s
mechanicalnes	s
mechanicalness	e
mechanicalnesse	s
mechanici	a
mechanicia	n
mechanis	eimt
mechanise	ds
mechanisi	n
mechanisin	g
mechanism	is
mechanismi	c
mechanist	i
mechanisti	c
mechaniz	aei
mechaniza	bt
mechanizab	l
mechanizabl	e
mechanizat	i
mechanizati	o
mechanizatio	n
mechanization	s
mechanize	drs
mechanizer	s
mechanizi	n
mechanizin	g
mechano	t
mechanot	h
mechanoth	e
mechanothe	r
mechanother	o
mechanothero	p
mechanotherop	y
med	adefilu
meda	il
medai	l
medail	l
medaill	o
medaillo	n
medaillon	s
medal	eils
medale	dt
medali	ns
medalin	g
medalis	t
medall	ei
medalle	d
medalli	cnos
medallin	g
medallio	n
medallion	s
medallis	t
medallist	s
medd	l
meddl	ei
meddle	drs
meddler	s
meddles	o
meddleso	m
meddlesom	e
meddli	n
meddlin	g
meddling	l
meddlingl	y
mede	a
medf	io
medfi	e
medfie	l
medfiel	d
medfo	r
medfor	d
medi	acenotu
media	celnpstw
mediac	iy
mediaci	e
mediacie	s
mediae	v
mediaev	a
mediaeva	l
mediaeval	ls
mediaevall	y
median	ls
medianl	y
mediap	l
mediapl	a
mediapla	y
mediaplay	e
mediaplaye	r
mediat	eio
mediate	dlns
mediatel	y
mediaten	e
mediatene	s
mediatenes	s
mediateness	e
mediatenesse	s
mediati	no
mediatin	g
mediatio	n
mediation	s
mediato	r
mediator	i
mediatori	a
mediatoria	l
mediaw	i
mediawi	k
mediawik	i
medic	aios
medica	bilmrt
medicab	l
medicabl	e
medicai	d
medical	ls
medicall	y
medicam	e
medicame	n
medicamen	t
medicar	e
medicat	i
medicati	ov
medicatio	n
medication	s
medicativ	e
medici	ns
medicin	aei
medicina	l
medicinal	ls
medicinall	y
medicine	ds
medicini	n
medicinin	g
medie	v
mediev	a
medieva	l
medieval	ls
medievall	y
medin	a
medio	c
medioc	r
mediocr	ei
mediocre	l
mediocrel	y
mediocri	st
mediocris	t
mediocrit	y
medit	ae
medita	nt
meditan	t
meditat	eio
meditate	drs
meditati	nov
meditatin	g
meditating	l
meditatingl	y
meditatio	n
meditation	s
meditativ	e
meditato	r
meditator	s
medite	r
mediter	r
mediterr	a
mediterra	n
mediterran	e
mediterrane	a
mediterranea	n
mediterranean	i
mediterraneani	z
mediterraneaniz	ae
mediterraneaniza	t
mediterraneanizat	i
mediterraneanizati	o
mediterraneanizatio	n
mediterraneanization	s
mediterraneanize	s
mediu	m
medium	ils
mediumi	s
mediumis	mt
mediumist	i
mediumisti	c
mediuml	y
medl	aei
medla	r
medle	y
medley	es
medleye	rs
medleyes	t
medli	n
medlin	e
medu	ls
medul	l
medull	a
medulla	r
medullar	y
medus	a
medusa	n
mee	dkrtv
meek	eln
meeke	rs
meekes	t
meekl	y
meekn	e
meekne	s
meeknes	s
meekness	e
meeknesse	s
meer	s
meers	c
meersc	h
meersch	a
meerscha	u
meerschau	m
meet	ceilnsu
meetc	u
meetcu	t
meetcut	e
meete	r
meeter	s
meeti	n
meetin	g
meeting	ehs
meetinge	r
meetingh	o
meetingho	u
meetinghou	s
meetinghous	e
meetl	y
meetn	e
meetne	s
meetnes	s
meetu	p
mef	l
meg	aio
mega	bcdfhlmnpstvw
megab	aiuy
megaba	ru
megabau	d
megabi	t
megabit	s
megabu	c
megabuc	k
megaby	t
megabyt	e
megabyte	s
megac	y
megacy	c
megacyc	l
megacycl	e
megad	e
megade	a
megadea	t
megadeat	h
megaf	o
megafo	gs
megafos	s
megafoss	i
megafossi	l
megah	e
megahe	r
megaher	t
megahert	z
megal	io
megali	t
megalit	h
megalith	i
megalithi	c
megalo	mp
megalom	a
megaloma	n
megaloman	i
megalomani	a
megalomania	c
megalop	o
megalopo	l
megalopol	i
megalopoli	s
megam	p
megamp	e
megampe	r
megamper	e
megan	u
meganu	c
meganuc	l
meganucl	e
meganucle	u
meganucleu	s
megap	hi
megaph	oy
megapho	n
megaphon	ei
megaphone	ds
megaphoni	cns
megaphonic	a
megaphonica	l
megaphonical	l
megaphonicall	y
megaphonin	g
megaphonis	t
megaphy	l
megaphyl	l
megaphyll	o
megaphyllo	u
megaphyllou	s
megapi	x
megapix	e
megapixe	l
megapixel	s
megas	t
megast	r
megastr	u
megastru	c
megastruc	t
megastruct	u
megastructu	r
megastructur	a
megastructura	l
megat	o
megato	n
megav	o
megavo	l
megavol	t
megaw	ao
megawa	t
megawat	t
megawo	r
megawor	d
megaword	s
megi	l
megil	l
megill	a
megilla	h
mego	h
megoh	m
mei	ejlos
meie	r
meij	i
meil	i
meili	s
meilis	e
meilise	a
meilisea	r
meilisear	c
meilisearc	h
meio	st
meios	ei
meiose	s
meiosi	s
meiot	i
meioti	c
meiotic	a
meiotica	l
meiotical	l
meioticall	y
meis	t
meist	e
meiste	r
meister	s
meisters	i
meistersi	n
meistersin	g
meistersing	e
meistersinge	r
mek	ov
meko	n
mekon	g
mel	abcdeiloptv
mela	mn
melam	ip
melami	n
melamin	e
melamp	u
melampu	s
melan	cegio
melanc	h
melanch	o
melancho	l
melanchol	iy
melancholi	acelns
melancholia	c
melancholie	s
melancholil	y
melancholin	e
melancholine	s
melancholines	s
melancholiness	e
melancholinesse	s
melancholis	h
melane	s
melanes	i
melanesi	a
melanesia	n
melang	e
melani	ens
melanin	ls
melaninl	i
melaninli	k
melaninlik	e
melanis	m
melano	m
melanom	a
melb	o
melbo	u
melbou	r
melbour	n
melbourn	e
melc	h
melch	e
melche	r
mele	e
melee	s
meli	nos
melin	d
melind	a
melio	r
melior	a
meliora	t
meliorat	ei
meliorati	ov
melioratio	n
meliorativ	e
melis	as
melisa	n
melisan	d
melisand	e
meliss	a
mell	io
melli	f
mellif	l
mellifl	u
melliflu	eo
melliflue	n
mellifluen	c
mellifluenc	e
mellifluo	u
mellifluou	s
mello	nw
mellow	eilns
mellowe	drs
mellowes	t
mellowi	n
mellowin	g
mellowl	y
mellown	e
mellowne	s
mellownes	s
mellowness	e
mellownesse	s
mellows	p
mellowsp	e
mellowspe	a
mellowspea	k
melo	dn
melod	eiry
melode	o
melodeo	n
melodi	ceosz
melodic	as
melodica	l
melodical	l
melodicall	y
melodie	s
melodio	u
melodiou	s
melodious	ln
melodiousl	y
melodiousn	e
melodiousne	s
melodiousnes	s
melodiousness	e
melodiousnesse	s
melodis	et
melodiz	e
melodr	a
melodra	m
melodram	a
melodrama	st
melodramat	i
melodramati	cs
melodramatic	a
melodramatica	l
melodramatical	l
melodramaticall	y
melodramatis	t
melodramatist	s
melody	ls
melodyl	e
melodyle	s
melodyles	s
melon	ilrs
meloni	es
melonie	r
melonier	e
melonis	t
melonl	i
melonli	k
melonlik	e
melonr	y
melp	o
melpo	m
melpom	e
melpome	n
melpomen	e
melt	adeioswy
melta	b
meltab	i
meltabi	l
meltabil	i
meltabili	t
meltabilit	i
meltabiliti	e
meltabilitie	s
meltd	o
meltdo	w
meltdow	n
melte	dr
melter	s
melti	n
meltin	g
melting	ln
meltingl	y
meltingn	e
meltingne	s
meltingnes	s
meltingness	e
meltingnesse	s
melto	n
meltw	a
meltwa	t
meltwat	e
meltwate	r
melv	io
melvi	ln
melvil	l
melvill	e
melvo	r
melvor	i
melvori	d
melvorid	l
melvoridl	e
mem	beops
memb	er
membe	r
member	eos
membere	s
memberes	s
membero	f
memberof	p
memberofp	a
memberofpa	r
memberofpar	l
memberofparl	i
memberofparli	a
memberofparlia	m
memberofparliam	e
memberofparliame	n
memberofparliamen	t
members	h
membersh	i
membershi	p
membership	s
membr	a
membra	n
membran	aeo
membrana	l
membrane	dls
membranel	e
membranele	s
membraneles	s
membrano	iu
membranoi	d
membranou	s
meme	n
memen	t
mement	o
memento	es
mementoe	s
memo	irs
memoi	r
memoir	s
memor	aiy
memora	bn
memorab	il
memorabi	l
memorabil	ei
memorabili	at
memorabilit	y
memorabl	ey
memorable	n
memorablen	e
memorablene	s
memorablenes	s
memorableness	e
memorablenesse	s
memoran	d
memorand	au
memorandu	m
memorandum	s
memori	aesz
memoria	l
memorial	ils
memoriali	sz
memorialis	et
memorializ	e
memoriall	y
memorie	s
memoris	aei
memorisa	b
memorisab	l
memorisabl	e
memorise	ds
memorisi	n
memorisin	g
memoriz	aei
memoriza	bt
memorizab	l
memorizabl	e
memorizat	i
memorizati	o
memorizatio	n
memorization	s
memorize	drs
memorizer	s
memorizi	n
memorizin	g
memory	l
memoryl	e
memoryle	s
memoryles	s
memp	h
memph	i
memphi	s
mems	a
memsa	h
memsah	i
memsahi	b
men	abcdefilnopstuvz
mena	cgr
menac	ei
menace	dfmrs
menacef	u
menacefu	l
menacem	e
menaceme	n
menacemen	t
menacer	s
menaci	n
menacin	g
menacing	l
menacingl	y
menag	e
menage	r
menager	i
menageri	e
menar	c
menarc	h
menarch	e
menc	k
menck	e
mencke	n
mend	aeios
menda	bc
mendab	l
mendabl	e
mendac	i
mendaci	ot
mendacio	u
mendaciou	s
mendacit	y
mende	dlr
mendel	eis
mendele	v
mendelev	i
mendelevi	u
mendeleviu	m
mendeli	asz
mendelia	n
mendelis	m
mendeliz	e
mendelize	s
mendels	s
mendelss	o
mendelsso	h
mendelssoh	n
mender	s
mendi	cn
mendic	a
mendica	n
mendican	ct
mendicanc	y
mendin	g
mending	s
mendo	z
mendoz	a
mene	l
menel	a
menela	u
menelau	s
menf	o
menfo	l
menfol	k
menfolk	s
meni	ans
menia	l
menial	ls
meniall	y
menin	g
mening	ei
meninge	a
meningea	l
meningi	t
meningit	i
meningiti	ds
meningitid	e
meningitide	s
meningitis	e
meningitise	s
menis	c
menisc	u
meniscu	s
menl	o
menn	o
menno	n
mennon	i
mennoni	t
mennonit	e
mennonite	s
meno	lmpr
menol	o
menolo	g
menolog	y
menom	i
menomi	n
menomin	e
menomine	e
menop	a
menopa	u
menopau	s
menopaus	e
menor	ac
menora	h
menorc	a
mens	acetu
mensa	l
mensc	h
mense	s
menst	r
menstr	u
menstru	au
menstrua	lt
menstrual	l
menstruall	y
menstruat	ei
menstruate	ds
menstruati	no
menstruatin	g
menstruatio	n
menstruu	m
mensu	r
mensur	a
mensura	blt
mensurab	il
mensurabi	l
mensurabil	i
mensurabili	t
mensurabilit	y
mensurabl	e
mensurat	i
mensurati	o
mensuratio	n
ment	ahio
menta	lt
mental	ils
mentali	stz
mentalis	t
mentalist	i
mentalisti	c
mentalit	iy
mentaliti	e
mentalitie	s
mentaliz	e
mentall	y
mentat	i
mentati	o
mentatio	n
menth	eo
menthe	n
menthen	e
mentho	l
menthol	a
menthola	t
mentholat	e
mentholate	d
menti	ou
mentio	n
mention	aeis
mentiona	b
mentionab	l
mentionabl	e
mentione	dr
mentioner	s
mentioni	n
mentionin	g
mentiu	m
mento	r
mentor	eis
mentore	d
mentori	an
mentoria	l
mentorin	g
mentors	h
mentorsh	i
mentorshi	p
mentorship	s
menu	is
menui	t
menuit	e
menuite	m
menz	i
menzi	e
menzie	s
meo	w
mep	hsv
meph	i
mephi	st
mephis	t
mephist	o
mephisto	p
mephistop	h
mephistoph	e
mephistophe	l
mephistophel	e
mephistophele	s
mephit	i
mephiti	s
mer	bcegilmorsv
merb	r
merbr	o
merbro	m
merbrom	i
merbromi	n
merc	aehikuy
merca	nt
mercan	t
mercant	i
mercanti	l
mercantil	ei
mercantili	s
mercantilis	t
mercat	o
mercato	r
merce	dnr
merced	e
mercede	s
mercedes	b
mercedesb	e
mercedesbe	n
mercedesben	z
mercen	a
mercena	r
mercenar	iy
mercenari	aeln
mercenaria	n
mercenarie	s
mercenaril	y
mercenarin	e
mercenarine	s
mercenarines	s
mercenariness	e
mercenarinesse	s
mercer	iy
merceri	sz
merceris	e
merceriz	e
merch	a
mercha	n
merchan	dt
merchand	i
merchandi	sz
merchandis	aei
merchandisa	b
merchandisab	l
merchandisabl	e
merchandise	drs
merchandiser	s
merchandisi	n
merchandisin	g
merchandising	s
merchandiz	ei
merchandize	ds
merchandizi	n
merchandizin	g
merchandizing	s
merchant	aehlms
merchanta	b
merchantab	il
merchantabi	l
merchantabil	i
merchantabili	t
merchantabilit	y
merchantabl	e
merchante	d
merchanth	o
merchantho	o
merchanthoo	d
merchantl	y
merchantm	a
merchantma	n
merci	efl
mercie	s
mercif	u
mercifu	l
merciful	ln
mercifull	y
mercifuln	e
mercifulne	s
mercifulnes	s
mercifulness	e
mercifulnesse	s
mercil	e
mercile	s
merciles	s
merciless	ln
mercilessl	y
mercilessn	e
mercilessne	s
mercilessnes	s
mercilessness	e
mercilessnesse	s
mercu	r
mercur	ioy
mercuri	ace
mercuria	l
mercurie	s
mercuro	cu
mercuroc	h
mercuroch	r
mercurochr	o
mercurochro	m
mercurochrom	e
mercurou	s
mercy	s
mere	dlnrst
mered	i
meredi	t
meredit	h
merel	y
meren	e
merene	s
merenes	s
meres	t
meret	r
meretr	i
meretri	c
meretric	i
meretrici	o
meretricio	u
meretriciou	s
merg	aei
merga	n
mergan	s
mergans	e
merganse	r
merge	dnrs
mergen	c
mergenc	e
mergence	s
merger	s
mergi	n
mergin	g
meri	dnstw
merid	i
meridi	ao
meridia	n
meridian	s
meridio	n
meridion	a
meridiona	l
merin	go
mering	u
meringu	e
meringue	s
meris	t
merist	e
meriste	m
merit	aeilos
merita	b
meritab	l
meritabl	e
merite	d
merited	l
meritedl	y
meriti	n
meritin	g
meritl	e
meritle	s
meritles	s
merito	cr
meritoc	r
meritocr	a
meritocra	ct
meritocrac	iy
meritocraci	e
meritocracie	s
meritocrat	i
meritocrati	c
meritor	i
meritori	o
meritorio	u
meritoriou	s
meritorious	ln
meritoriousl	y
meritoriousn	e
meritoriousne	s
meritoriousnes	s
meriw	e
meriwe	t
meriwet	h
meriweth	e
meriwethe	r
merl	eio
merli	n
merlo	n
merm	a
merma	in
mermai	d
mermaid	s
mero	h
meroh	e
merohe	d
merohed	r
merohedr	a
merohedra	l
merr	iy
merri	acelmnt
merria	m
merric	k
merrie	rs
merries	t
merril	ly
merrim	ae
merrima	c
merrimac	k
merrime	n
merrimen	t
merriment	s
merrin	e
merrine	s
merrines	s
merriness	e
merrinesse	s
merrit	t
merry	ms
merrym	a
merryma	k
merrymak	ei
merrymaki	n
merrymakin	g
mers	e
merse	y
mersey	s
merseys	i
merseysi	d
merseysid	e
merv	i
mervi	n
mes	abcehmoqst
mesc	a
mesca	l
mescal	i
mescali	n
mescalin	e
mese	en
mesee	m
meseem	s
mesen	t
mesent	e
mesente	r
mesenter	y
mesh	wy
meshw	o
meshwo	r
meshwor	k
mesm	e
mesme	r
mesmer	i
mesmeri	csz
mesmeris	eimt
mesmerise	ds
mesmerisi	n
mesmerisin	g
mesmeriz	aei
mesmeriza	bt
mesmerizab	il
mesmerizabi	l
mesmerizabil	i
mesmerizabili	t
mesmerizabilit	y
mesmerizabl	e
mesmerizat	i
mesmerizati	o
mesmerizatio	n
mesmerization	s
mesmerize	drs
mesmerizer	s
mesmerizi	n
mesmerizin	g
mesmerizing	l
mesmerizingl	y
meso	lmnpstz
mesol	i
mesoli	t
mesolit	h
mesolith	i
mesolithi	c
mesom	o
mesomo	r
mesomor	p
mesomorp	h
mesomorph	i
mesomorphi	c
mesop	ho
mesoph	y
mesophy	l
mesophyl	l
mesophyll	s
mesopo	t
mesopot	a
mesopota	m
mesopotam	i
mesopotami	a
mesopotamia	n
mesos	p
mesosp	h
mesosph	e
mesosphe	r
mesospher	ei
mesosphere	s
mesospheri	c
mesot	h
mesoth	eo
mesothe	l
mesothel	i
mesotheli	o
mesothelio	m
mesotheliom	a
mesotho	r
mesothor	i
mesothori	u
mesothoriu	m
mesoz	o
mesozo	i
mesozoi	c
mesq	u
mesqu	i
mesqui	t
mesquit	e
mess	aeimry
messa	gr
messag	ei
message	dls
messagel	e
messagele	s
messageles	s
messagi	n
messagin	g
messar	i
messe	dns
messen	g
messeng	e
messenge	r
messenger	eis
messengere	d
messengeri	n
messengerin	g
messengers	h
messengersh	i
messengershi	p
messi	aeln
messia	hns
messiah	s
messiahs	h
messiahsh	i
messiahshi	p
messiahship	s
messian	i
messiani	cs
messianic	a
messianica	l
messianical	l
messianicall	y
messianis	m
messias	e
messiase	s
messie	rs
messies	t
messil	y
messin	eg
messine	s
messines	s
messiness	e
messinesse	s
messm	a
messma	t
messmat	e
messr	s
mest	i
mesti	z
mestiz	o
met	acehiorstz
meta	bcdfglmnpstvz
metab	io
metabi	o
metabio	l
metabiol	o
metabiolo	g
metabiolog	i
metabiologi	c
metabiologic	a
metabiologica	l
metabo	l
metabol	i
metaboli	csz
metabolis	em
metabolism	s
metaboliz	e
metac	aior
metaca	r
metacar	p
metacarp	au
metacarpa	l
metacarpu	s
metaci	nr
metacin	n
metacinn	a
metacinna	b
metacinnab	a
metacinnaba	r
metacir	c
metacirc	u
metacircu	l
metacircul	a
metacircula	r
metacircular	i
metacirculari	t
metacircularit	y
metaco	mn
metacom	m
metacomm	u
metacommu	n
metacommun	i
metacommuni	c
metacommunic	a
metacommunica	t
metacommunicat	i
metacommunicati	ov
metacommunicatio	n
metacommunication	a
metacommunicationa	l
metacommunicativ	e
metacon	aeiu
metacona	l
metaconi	d
metaconu	l
metaconul	e
metacr	iy
metacri	t
metacrit	i
metacriti	c
metacry	s
metacrys	t
metad	a
metada	t
metadat	a
metaf	i
metafi	l
metafil	e
metag	en
metage	no
metagen	e
metagene	s
metagenes	i
metagenesi	s
metageo	m
metageom	e
metageome	t
metageomet	r
metageometr	iy
metageometri	c
metageometric	a
metageometrica	l
metagn	a
metagna	t
metagnat	h
metagnath	i
metagnathi	s
metagnathis	m
metal	aeilsw
metala	n
metalan	g
metalang	u
metalangu	a
metalangua	g
metalanguag	e
metale	dg
metaleg	a
metalega	l
metali	nsz
metalin	g
metaling	u
metalingu	i
metalingui	s
metalinguis	t
metalinguist	i
metalinguisti	c
metalinguistic	s
metalis	i
metalisi	n
metalisin	g
metaliz	ai
metaliza	t
metalizat	i
metalizati	o
metalizatio	n
metalizi	n
metalizin	g
metall	eiou
metalle	i
metallei	t
metalleit	iy
metalleiti	e
metalleitie	s
metalli	cfz
metallic	ais
metallica	l
metallical	l
metallicall	y
metallici	t
metallicit	iy
metalliciti	e
metallicitie	s
metallif	e
metallife	r
metallifer	o
metallifero	u
metalliferou	s
metalliz	a
metalliza	t
metallizat	i
metallizati	o
metallizatio	n
metallization	s
metallo	gi
metallog	r
metallogr	a
metallogra	p
metallograp	h
metalloi	d
metallu	r
metallur	g
metallurg	iy
metallurgi	ces
metallurgic	a
metallurgica	l
metallurgical	l
metallurgicall	y
metallurgie	s
metallurgis	t
metallurgist	s
metalw	ao
metalwa	r
metalwar	e
metalwo	r
metalwor	k
metalwork	e
metalworke	r
metam	aeio
metama	st
metamas	k
metamat	h
metamath	e
metamathe	m
metamathem	a
metamathema	t
metamathemat	i
metamathemati	c
metamathematic	a
metamathematica	l
metame	r
metamer	e
metami	c
metamic	t
metamict	in
metamicti	z
metamictiz	a
metamictiza	t
metamictizat	i
metamictizati	o
metamictizatio	n
metamictn	e
metamictne	s
metamictnes	s
metamo	r
metamor	p
metamorp	h
metamorph	io
metamorphi	cs
metamorphic	a
metamorphica	l
metamorphical	l
metamorphicall	y
metamorphis	m
metamorpho	s
metamorphos	ei
metamorphose	s
metamorphosi	cs
metan	eo
metane	p
metanep	h
metaneph	r
metanephr	i
metanephri	d
metanephrid	i
metanephridi	au
metanephridia	l
metanephridiu	m
metano	t
metanot	u
metanotu	m
metap	ho
metaph	aory
metapha	s
metaphas	e
metapho	nr
metaphon	iy
metaphoni	cz
metaphoniz	e
metaphonize	d
metaphor	is
metaphori	c
metaphoric	a
metaphorica	l
metaphorical	ln
metaphoricall	y
metaphoricaln	e
metaphoricalne	s
metaphoricalnes	s
metaphoricalness	e
metaphoricalnesse	s
metaphr	a
metaphra	s
metaphras	e
metaphy	s
metaphys	i
metaphysi	c
metaphysic	ais
metaphysica	l
metaphysical	l
metaphysicall	y
metaphysici	a
metaphysicia	n
metapo	d
metapod	i
metapodi	au
metapodia	l
metapodiu	m
metas	cet
metasc	i
metasci	e
metascie	n
metascien	t
metascient	i
metascienti	f
metascientif	i
metascientifi	c
metascientific	a
metascientifica	l
metascientifical	l
metascientificall	y
metase	a
metasea	r
metasear	c
metasearc	h
metast	ae
metasta	st
metastas	ei
metastasi	sz
metastasiz	e
metastat	i
metastati	c
metaste	r
metaster	n
metastern	au
metasterna	l
metasternu	m
metat	ah
metata	r
metatar	s
metatars	au
metatarsa	l
metatarsu	s
metath	e
metathe	s
metathes	i
metathesi	s
metav	aeo
metava	r
metavar	i
metavari	a
metavaria	b
metavariab	l
metavariabl	e
metave	r
metaver	s
metavers	e
metavo	l
metavol	c
metavolc	a
metavolca	n
metavolcan	i
metavolcani	c
metaz	o
metazo	a
metazoa	n
metc	a
metca	l
metcal	f
mete	dmors
metem	p
metemp	s
metemps	y
metempsy	c
metempsyc	h
metempsych	o
metempsycho	s
metempsychos	i
metempsychosi	s
meteo	r
meteor	ailos
meteori	ctz
meteoric	a
meteorica	l
meteorical	l
meteoricall	y
meteorit	ei
meteoriti	c
meteoriz	e
meteorl	i
meteorli	k
meteorlik	e
meteoro	il
meteoroi	d
meteorol	o
meteorolo	g
meteorolog	iy
meteorologi	ces
meteorologic	a
meteorologica	l
meteorological	l
meteorologicall	y
meteorologie	s
meteorologis	t
meteorologist	s
meter	aeils
metera	g
meterag	e
metere	d
meteri	n
meterin	g
meterl	e
meterle	s
meterles	s
metes	t
metest	r
metestr	o
metestro	u
metestrou	s
meth	aeiouy
metha	n
methan	eo
methane	s
methano	l
methanol	is
methanoli	c
methe	g
metheg	l
methegl	i
methegli	n
methi	n
methin	k
methink	s
metho	d
method	ilos
methodi	csz
methodic	a
methodica	l
methodical	ln
methodicall	y
methodicaln	e
methodicalne	s
methodicalnes	s
methodicalness	e
methodicalnesse	s
methodis	emt
methodist	is
methodisti	c
methodiz	e
methodl	e
methodle	s
methodles	s
methodo	l
methodol	o
methodolo	g
methodolog	iy
methodologi	ces
methodologic	a
methodologica	l
methodological	l
methodologicall	y
methodologie	s
methodologis	t
methodologist	s
methu	es
methue	n
methus	e
methuse	l
methusel	a
methusela	h
methuselah	s
methy	l
methyl	em
methyle	n
methylen	e
methylm	e
methylme	r
methylmer	c
methylmerc	u
methylmercu	r
methylmercur	y
meti	cn
metic	u
meticu	l
meticul	o
meticulo	su
meticulos	i
meticulosi	t
meticulosit	iy
meticulositi	e
meticulositie	s
meticulou	s
meticulous	ln
meticulousl	y
meticulousn	e
meticulousne	s
meticulousnes	s
meticulousness	e
meticulousnesse	s
metin	g
meto	ln
meton	y
metony	m
metonym	iy
metonymi	e
metonymie	s
metr	aeio
metra	z
metraz	o
metrazo	l
metre	acdls
metrea	g
metreag	e
metrec	a
metreca	l
metrel	e
metrele	s
metreles	s
metri	cn
metric	as
metrica	lt
metrical	l
metricall	y
metricat	e
metrin	g
metro	lnp
metrol	o
metrolo	g
metrolog	y
metron	o
metrono	m
metronom	ei
metronomi	c
metrop	lo
metropl	i
metropli	s
metropo	l
metropol	ei
metropole	s
metropoli	st
metropolis	e
metropolise	s
metropolit	a
metropolita	n
mett	l
mettl	e
mettle	s
mettles	o
mettleso	m
mettlesom	e
metz	l
metzl	e
metzle	r
mew	elrsv
mewe	d
mex	i
mexi	c
mexic	ao
mexica	n
mexican	is
mexicani	z
mexicaniz	e
mexicanize	s
mey	e
meye	r
meyer	s
mez	vz
mezz	a
mezza	n
mezzan	i
mezzani	n
mezzanin	e
mezzanine	s
mf	abcdefghijklmnopqrsuvwxyz
mfa	bcdefhjklmprstvwx
mfak	rv
mfar	rv
mfb	bdefghkmorsuv
mfbh	v
mfbk	rv
mfbr	v
mfc	gjnorsvwz
mfd	abglopqrsvxz
mfdb	v
mfdg	v
mfdo	v
mfe	dfhkoquw
mfed	rv
mfek	v
mfeo	rv
mff	bcefglmorstvwxy
mffo	v
mfg	orsuv
mfh	pv
mfi	kq
mfj	bdknrsuv
mfju	v
mfk	befrsv
mfl	befhjkmnprsvx
mflb	v
mfm	bcfostv
mfmf	v
mfn	abdefhorsuv
mfnd	v
mfne	v
mfno	rsv
mfo	dfjopqrsuvx
mfoq	v
mfou	v
mfox	p
mfoxp	l
mfoxpl	u
mfoxplu	s
mfp	afghjkorsuvw
mfpk	v
mfpo	rsv
mfpu	v
mfpw	v
mfq	hkoqrst
mfr	bcfjkmnqrsv
mfrb	v
mfrc	v
mfrq	v
mfs	bjrs
mfsr	v
mfu	cdmopqrv
mfum	v
mfv	arsv
mfw	v
mfx	pqrvx
mfy	dfgqrstvy
mfyq	v
mfz	cef
mg	eijlmnopqruwx
mge	v
mgi	u
mgj	rvy
mgl	v
mgn	frv
mgp	v
mgq	f
mgr	y
mgw	v
mgx	rv
mh	aeflmnopruvxz
mha	rv
mhf	h
mhm	b
mhn	l
mho	v
mhu	rv
mhx	v
mi	abcdefghijklmnopqrstuvwxyz
mia	dikmoprstv
miai	rv
miam	i
miao	w
miaow	eis
miaowe	d
miaowi	n
miaowin	g
mias	m
miasm	ai
miasmi	c
miat	frsv
mib	fhirtuz
mibh	rv
mibz	v
mic	adehkrst
mica	h
mich	aei
micha	e
michae	l
michael	s
miche	l
michel	aeils
michela	n
michelan	g
michelang	e
michelange	l
michelangel	o
micheli	n
michell	e
michels	o
michelso	n
michi	g
michig	a
michiga	n
mick	eiy
micke	y
micki	e
micr	o
micro	abcdefghijlmnoprstvwz
microa	emnrt
microae	r
microaer	o
microaero	p
microaerop	h
microaeroph	i
microaerophi	l
microaerophil	i
microaerophili	c
microam	p
microan	ae
microana	t
microanat	o
microanato	m
microanatom	i
microanatomi	s
microanatomis	t
microane	u
microaneu	r
microaneur	y
microaneury	s
microaneurys	m
microar	c
microarc	h
microarch	i
microarchi	t
microarchit	e
microarchite	c
microarchitec	t
microarchitect	su
microarchitectu	r
microarchitectur	e
microarchitecture	s
microat	o
microato	l
microatol	l
microb	aeiou
microba	lr
microbal	l
microball	o
microballo	o
microballoo	n
microbar	o
microbaro	m
microbe	lns
microbel	e
microbele	s
microbeles	s
microben	t
microbent	h
microbenth	io
microbenthi	c
microbentho	s
microbi	acot
microbia	l
microbial	l
microbiall	y
microbic	i
microbici	d
microbicid	ae
microbicida	l
microbio	l
microbiol	o
microbiolo	g
microbiolog	iy
microbiologi	ces
microbiologic	a
microbiologica	l
microbiological	l
microbiologicall	y
microbiologie	s
microbiologis	t
microbiologist	s
microbo	r
microbor	e
microbu	rs
microbur	i
microburi	n
microc	aehilory
microca	lr
microcal	o
microcalo	r
microcalor	i
microcalori	m
microcalorim	e
microcalorime	t
microcalorimet	er
microcalorimete	r
microcalorimetr	iy
microcalorimetri	c
microcar	d
microce	lp
microcel	l
microcell	u
microcellu	l
microcellul	a
microcellula	r
microcep	h
microceph	a
microcepha	l
microcephal	oy
microcephalo	u
microcephalou	s
microch	ei
microche	m
microchem	i
microchemi	cs
microchemic	a
microchemica	l
microchemis	t
microchemist	r
microchemistr	y
microchi	p
microchip	ps
microchipp	ei
microchippe	d
microchippi	n
microchippin	g
microci	nr
microcin	e
microcine	m
microcinem	a
microcinema	t
microcinemat	o
microcinemato	g
microcinematog	r
microcinematogr	a
microcinematogra	p
microcinematograp	h
microcinematograph	iy
microcinematographi	c
microcir	cu
microcirc	u
microcircu	i
microcircui	t
microcircuit	r
microcircuitr	y
microciru	i
microcirui	t
microciruit	r
microciruitr	y
microcl	ai
microcla	s
microclas	t
microclast	i
microclasti	c
microcli	m
microclim	a
microclima	t
microclimat	eo
microclimato	l
microclimatol	o
microclimatolo	g
microclimatolog	y
microco	dlmnops
microcod	ei
microcode	ds
microcodi	n
microcodin	g
microcol	o
microcolo	n
microcolon	y
microcom	p
microcomp	u
microcompu	t
microcomput	ei
microcompute	r
microcomputer	s
microcomputi	n
microcomputin	g
microcon	t
microcont	i
microconti	n
microcontin	e
microcontine	n
microcontinen	t
microcontinent	a
microcontinenta	l
microcoo	k
microcop	y
microcos	m
microcosm	is
microcosmi	c
microcosmic	a
microcosmica	l
microcosmical	l
microcosmicall	y
microcr	ay
microcra	c
microcrac	k
microcrack	i
microcracki	n
microcrackin	g
microcry	s
microcrys	t
microcryst	a
microcrysta	l
microcrystal	l
microcrystall	i
microcrystalli	n
microcrystallin	e
microcy	cs
microcyc	l
microcycl	e
microcycle	s
microcys	t
microd	eio
microde	gn
microdeg	r
microdegr	e
microdegre	e
microden	s
microdens	i
microdensi	t
microdensit	o
microdensito	m
microdensitom	e
microdensitome	t
microdensitomet	r
microdensitometr	iy
microdensitometri	c
microdi	o
microdio	r
microdior	i
microdiori	t
microdiorit	e
microdo	n
microdon	t
microe	cl
microec	o
microeco	n
microecon	o
microecono	m
microeconom	i
microeconomi	c
microeconomic	s
microel	e
microele	c
microelec	t
microelect	r
microelectr	o
microelectro	n
microelectron	i
microelectroni	c
microelectronic	s
microf	aeior
microfa	r
microfar	a
microfara	d
microfarad	m
microfaradm	e
microfaradme	t
microfaradmet	e
microfaradmete	r
microfe	l
microfel	s
microfels	i
microfelsi	t
microfelsit	i
microfelsiti	c
microfi	bcl
microfib	r
microfibr	i
microfibri	l
microfibril	l
microfibrill	a
microfibrilla	r
microfic	h
microfich	ei
microfiche	ds
microfichi	n
microfichin	g
microfil	am
microfila	m
microfilam	e
microfilame	n
microfilamen	t
microfilament	o
microfilamento	u
microfilamentou	s
microfilm	s
microfo	rs
microfor	m
microfos	s
microfoss	i
microfossi	l
microfr	a
microfra	c
microfrac	t
microfract	u
microfractu	r
microfractur	ei
microfracturi	n
microfracturin	g
microg	ary
microga	m
microgam	e
microgame	t
microgamet	o
microgameto	p
microgametop	h
microgametoph	y
microgametophy	t
microgametophyt	e
microgr	ao
microgra	mnp
microgram	ms
microgramm	ei
microgramme	s
microgrammi	n
microgrammin	g
microgran	i
micrograni	t
microgranit	i
micrograniti	c
micrograp	h
micrograph	y
microgro	o
microgroo	v
microgroov	e
microgy	r
microgyr	i
microgyri	a
microh	m
microi	n
microin	s
microins	t
microinst	r
microinstr	u
microinstru	c
microinstruc	t
microinstruct	i
microinstructi	o
microinstructio	n
microinstruction	s
microj	u
microju	m
microjum	p
microjump	s
microl	eio
microle	v
microlev	e
microleve	l
microli	nt
microlin	g
microling	u
microlingu	i
microlingui	s
microlinguis	t
microlinguist	i
microlinguisti	c
microlit	h
microlith	i
microlithi	c
microlo	g
microlog	iy
micrologi	c
microm	aeio
microma	nsxz
microman	i
micromani	ap
micromania	c
micromanip	u
micromanipu	l
micromanipul	a
micromanipula	t
micromanipulat	e
micromas	t
micromast	i
micromasti	a
micromaz	i
micromazi	a
microme	ct
micromec	h
micromech	a
micromecha	n
micromechan	i
micromechani	s
micromechanis	m
micromet	er
micromete	r
micrometer	s
micrometr	e
micrometre	s
micromi	ln
micromil	l
micromill	i
micromilli	m
micromillim	e
micromillime	t
micromillimet	r
micromillimetr	e
micromin	i
micromo	dl
micromod	u
micromodu	l
micromodul	e
micromol	a
micromola	r
micron	eosu
microne	s
micrones	i
micronesi	a
micronesia	n
microno	d
micronod	u
micronodu	l
micronodul	a
micronodula	r
micronu	ct
micronuc	l
micronucl	e
micronucle	a
micronuclea	r
micronut	r
micronutr	i
micronutri	e
micronutrie	n
micronutrien	t
microo	pr
microop	e
microope	r
microoper	a
microopera	t
microoperat	i
microoperati	o
microoperatio	n
microoperation	s
microor	g
microorg	a
microorga	n
microorgan	i
microorgani	s
microorganis	m
microp	ehoru
micrope	r
microper	t
micropert	h
microperth	i
microperthi	t
microperthit	ei
microperthiti	c
microph	oy
micropho	nt
microphon	eio
microphone	s
microphoni	cn
microphonin	g
microphono	s
microphonos	c
microphonosc	o
microphonosco	p
microphonoscop	e
microphot	o
microphoto	gm
microphotog	r
microphotogr	a
microphotogra	p
microphotograp	h
microphotom	e
microphotome	t
microphotomet	r
microphotometr	iy
microphotometri	c
microphy	l
microphyl	l
microphyll	o
microphyllo	u
microphyllou	s
micropo	rw
micropor	ot
microporo	u
microporou	s
micropow	e
micropowe	r
micropr	io
micropri	n
microprin	t
micropro	cg
microproc	e
microproce	ds
microproced	u
microprocedu	r
microprocedur	e
microprocedure	s
microproces	s
microprocess	io
microprocessi	n
microprocessin	g
microprocessing	s
microprocesso	r
microprocessor	s
microprog	r
microprogr	a
microprogra	m
microprogram	ms
microprogramm	aei
microprogramma	b
microprogrammab	l
microprogrammabl	e
microprogramme	dr
microprogrammi	n
microprogrammin	g
micropu	b
micropub	il
micropubi	s
micropubis	h
micropubish	i
micropubishi	n
micropubishin	g
micropubl	i
micropubli	s
micropublis	h
micror	e
microre	c
microrec	o
microreco	r
microrecor	d
micros	ceoptwy
microsc	o
microsco	p
microscop	eiy
microscope	s
microscopi	cs
microscopic	a
microscopica	l
microscopical	l
microscopicall	y
microscopis	t
microse	c
microsec	o
microseco	n
microsecon	d
microsecond	s
microso	fm
microsof	t
microsoft	acenopstw
microsofta	cz
microsoftac	c
microsoftacc	e
microsoftacce	s
microsoftacces	s
microsoftaz	u
microsoftazu	r
microsoftazur	e
microsoftc	o
microsoftco	r
microsoftcor	p
microsoftcorp	o
microsoftcorpo	r
microsoftcorpor	a
microsoftcorpora	t
microsoftcorporat	i
microsoftcorporati	o
microsoftcorporatio	n
microsofte	dx
microsofted	g
microsoftedg	e
microsoftex	c
microsoftexc	e
microsoftexce	l
microsoftn	t
microsoftnt	f
microsoftntf	s
microsofto	fnu
microsoftof	f
microsoftoff	i
microsoftoffi	c
microsoftoffic	e
microsofton	e
microsoftone	n
microsoftonen	o
microsoftoneno	t
microsoftonenot	e
microsoftou	t
microsoftout	l
microsoftoutl	o
microsoftoutlo	o
microsoftoutloo	k
microsoftp	o
microsoftpo	w
microsoftpow	e
microsoftpowe	r
microsoftpower	p
microsoftpowerp	o
microsoftpowerpo	i
microsoftpowerpoi	n
microsoftpowerpoin	t
microsofts	q
microsoftsq	l
microsoftsql	s
microsoftsqls	e
microsoftsqlse	r
microsoftsqlser	v
microsoftsqlserv	e
microsoftsqlserve	r
microsoftt	o
microsoftto	d
microsofttod	o
microsoftw	io
microsoftwi	n
microsoftwin	d
microsoftwind	o
microsoftwindo	w
microsoftwindow	s
microsoftwo	r
microsoftwor	d
microsom	e
microsp	ho
microsph	e
microsphe	r
microspher	i
microspheri	c
microspo	r
microspor	e
microst	ory
microsto	r
microstor	e
microstr	iu
microstri	p
microstru	c
microstruc	t
microstruct	u
microstructu	r
microstructur	ae
microstructura	l
microsty	l
microstyl	o
microstylo	u
microstylou	s
microsw	i
microswi	t
microswit	c
microswitc	h
microsy	ns
microsys	t
microsyst	e
microsyste	m
microsystem	s
microt	oru
microto	m
microtom	e
microtr	a
microtra	b
microtrab	e
microtrabe	c
microtrabec	u
microtrabecu	l
microtrabecul	a
microtrabecula	r
microtu	b
microtub	u
microtubu	l
microtubul	a
microtubula	r
microv	aio
microva	x
microvax	e
microvaxe	s
microvi	l
microvil	l
microvill	ao
microvilla	r
microvillo	u
microvillou	s
microvo	l
microvol	t
microw	ao
microwa	v
microwav	ei
microwave	ads
microwavea	b
microwaveab	l
microwaveabl	e
microwavi	n
microwavin	g
microwo	r
microwor	d
microword	s
microz	y
microzy	m
microzym	e
mics	rv
mict	u
mictu	r
mictur	a
mictura	t
micturat	e
mid	abcdfgijklmnoprstwz
mida	is
midai	r
midb	r
midbr	a
midbra	i
midbrai	n
midc	o
midco	n
midcon	t
midcont	i
midconti	n
midcontin	e
midcontine	n
midcontinen	t
midd	aeloy
midda	y
midday	s
midde	nrs
middes	t
middl	ei
middle	abdemnstw
middlea	g
middleag	e
middleage	d
middleb	u
middlebu	r
middlebur	y
middlee	a
middleea	s
middleeas	t
middleeast	e
middleeaste	r
middleeaster	n
middlem	ae
middlema	n
middleman	s
middlemans	h
middlemansh	i
middlemanshi	p
middleme	n
middlen	e
middlene	s
middlenes	s
middles	e
middlese	x
middlet	o
middleto	nw
middletow	n
middlew	a
middlewa	r
middlewar	e
middli	n
middlin	g
middo	rt
middor	s
middors	a
middorsa	l
midf	i
midfi	e
midfie	l
midfiel	d
midg	e
midge	st
midget	is
midgeti	s
midgetis	m
midgetism	s
midi	r
midir	o
midiro	n
midj	o
midjo	u
midjou	r
midjour	n
midjourn	e
midjourne	y
midl	aei
midla	nt
midlan	d
midland	is
midlandi	z
midlandiz	e
midlandize	s
midlat	i
midlati	t
midlatit	u
midlatitu	d
midlatitud	e
midle	g
midli	n
midlin	e
midm	o
midmo	rs
midmor	n
midmorn	i
midmorni	n
midmornin	g
midmos	t
midn	i
midni	g
midnig	h
midnigh	t
midnight	s
mido	c
midoc	e
midoce	a
midocea	n
midp	o
midpo	i
midpoi	n
midpoin	t
midpoint	s
midr	ai
midra	n
midran	g
midrang	e
midri	bf
midrif	f
midriff	s
mids	cehtu
midsc	a
midsca	l
midscal	e
midse	c
midsec	t
midsect	i
midsecti	o
midsectio	n
midsh	i
midshi	p
midship	ms
midshipm	ae
midshipma	n
midshipme	n
midst	rs
midstr	e
midstre	a
midstrea	m
midsu	m
midsum	m
midsumm	e
midsumme	r
midsummer	sy
midt	eo
midte	r
midter	m
midto	w
midtow	n
midw	aei
midwa	y
midway	s
midwe	es
midwee	k
midweek	ls
midweekl	y
midwes	t
midwest	e
midweste	r
midwester	n
midwestern	e
midwesterne	r
midwesterner	s
midwi	fnv
midwif	ei
midwife	dlrs
midwifel	y
midwifer	iy
midwiferi	e
midwiferie	s
midwifi	n
midwifin	g
midwin	t
midwint	er
midwinte	r
midwinter	ls
midwinterl	y
midwintr	y
midwiv	ei
midwive	ds
midwivi	n
midwivin	g
mie	dehinpsuwz
mieh	v
miep	cflrsvw
miez	v
mif	fimt
miff	l
miffl	i
miffli	n
mifm	v
mig	hinrtu
migh	t
might	filsy
mightf	u
mightfu	l
mighti	eln
mightie	rs
mighties	t
mightil	y
mightin	e
mightine	s
mightines	s
mightl	ey
mightle	s
mightles	s
migi	v
mign	o
migno	n
mignon	e
mignone	t
mignonet	t
mignonett	e
migr	a
migra	int
migrai	n
migrain	eo
migraine	s
migraino	iu
migrainoi	d
migrainou	s
migran	t
migrant	s
migrat	eio
migrate	ds
migrati	nov
migratin	g
migratio	n
migration	as
migrationa	l
migrativ	e
migrato	r
migrator	isy
migratori	ae
migratoria	l
migratorie	s
migt	v
migu	e
migue	l
mih	iot
miho	m
mihom	o
mii	pv
mij	ehilmrstvz
mijh	rv
miji	v
mijt	v
mik	ehimop
mike	ds
mikh	a
mikha	i
mikhai	l
miki	n
mikin	g
miko	y
mikoy	a
mikoya	n
mikp	v
mil	acdefiklnoqstvw
mila	gn
milag	e
milage	s
milan	eo
milane	s
milanes	e
milc	h
mild	eilnrs
milde	nrsw
mildes	t
mildew	eisy
mildewe	d
mildewi	n
mildewin	g
mildi	s
mildis	h
mildl	y
mildn	e
mildne	s
mildnes	s
mildness	e
mildnesse	s
mildr	e
mildre	d
mile	aoprs
milea	g
mileag	e
mileage	s
mileo	m
mileom	e
mileome	t
mileomet	e
mileomete	r
milep	o
milepo	s
milepos	t
miles	t
milest	o
milesto	n
mileston	e
milestone	s
milf	os
milfo	ir
milfoi	l
milfor	d
milfs	e
milfse	e
milfsee	k
milfseek	e
milfseeke	r
mili	aet
milia	r
miliar	y
milie	u
milit	ai
milita	nrt
militan	ct
militanc	y
militant	lns
militantl	y
militantn	e
militantne	s
militantnes	s
militantness	e
militantnesse	s
militar	iy
militari	elnsz
militarie	s
militaril	y
militarin	e
militarine	s
militarines	s
militariness	e
militarinesse	s
militaris	emt
militarist	i
militaristi	c
militariz	ae
militariza	t
militarizat	i
militarizati	o
militarizatio	n
military	i
militaryi	s
militaryis	m
militat	e
militi	a
militia	msw
militiam	a
militiama	n
militiaw	o
militiawo	m
militiawom	a
militiawoma	n
milk	efilmnswy
milke	dnr
milker	s
milkf	u
milkfu	l
milki	eln
milkie	rs
milkies	t
milkil	y
milkin	eg
milkine	s
milkines	s
milkiness	e
milkinesse	s
milkl	e
milkle	s
milkles	s
milkm	ae
milkma	in
milkmai	d
milkmaid	s
milkme	n
milkn	e
milkne	s
milknes	s
milks	ho
milksh	a
milksha	k
milkshak	e
milkso	p
milkw	e
milkwe	e
milkwee	d
mill	abdeiprsw
milla	br
millab	l
millabl	e
millar	d
millb	o
millbo	a
millboa	r
millboar	d
milld	a
millda	m
mille	dnrt
millen	ain
millena	r
millenar	i
millenari	a
millenaria	n
milleni	u
milleniu	m
millenn	i
millenni	au
millenniu	m
millennium	s
millet	s
milli	abegjklmnopsvw
millia	mnr
milliam	mp
milliamm	e
milliamme	t
milliammet	e
milliammete	r
milliamp	e
milliampe	r
milliamper	e
milliar	d
millib	a
milliba	r
millibar	s
millig	r
milligr	a
milligra	m
milligram	ms
milligramm	e
milligramme	s
millij	o
millijo	u
millijou	l
millijoul	e
millik	a
millika	n
millil	i
millili	t
millilit	er
millilite	r
millilitr	e
millilitre	s
millim	ei
millime	t
millimet	er
millimete	r
millimeter	s
millimetr	ei
millimetre	s
millimetri	c
millimi	c
millimic	r
millimicr	o
millimicro	n
millin	eg
milline	r
milliner	iy
millineri	e
millinerie	s
milling	t
millingt	o
millingto	n
millio	hns
millioh	m
million	ainst
milliona	i
millionai	r
millionair	ei
millionaire	ds
millionaired	o
millionairedo	m
millionairedom	s
millionaires	h
millionairesh	i
millionaireshi	p
millionairi	s
millionairis	h
millioni	s
millionis	mt
millionn	a
millionna	i
millionnai	r
millionnair	e
millionnaire	s
milliont	h
millionth	s
millios	m
milliosm	o
milliosmo	l
milliosmol	e
millip	e
millipe	d
milliped	e
millipede	s
millis	ce
millisc	o
millisco	n
milliscon	d
millise	c
millisec	o
milliseco	n
millisecon	d
millisecond	s
milliv	o
millivo	l
millivol	t
millivolt	m
millivoltm	e
millivoltme	t
millivoltmet	e
millivoltmete	r
milliw	a
milliwa	t
milliwat	t
millp	o
millpo	n
millpon	d
millr	a
millra	c
millrac	e
mills	t
millst	or
millsto	n
millston	e
millstone	s
millstr	e
millstre	a
millstrea	m
millw	r
millwr	i
millwri	g
millwrig	h
millwrigh	t
miln	e
milo	mr
milom	e
milome	t
milomet	e
milomete	r
milometer	s
milor	d
milq	u
milqu	e
milque	t
milquet	o
milqueto	a
milquetoa	s
milquetoas	t
milquetoast	s
milt	o
milto	n
milton	i
miltoni	acsz
miltonia	n
miltonis	mt
miltoniz	ei
miltonize	ds
miltonizi	n
miltonizin	g
milw	a
milwa	u
milwau	k
milwauk	e
milwauke	e
mim	eiotv
mime	dorst
mimeo	g
mimeog	r
mimeogr	a
mimeogra	p
mimeograp	h
mimer	s
mimes	it
mimesi	s
mimest	r
mimestr	e
mimestre	a
mimestrea	m
mimet	i
mimeti	c
mimi	cn
mimic	krs
mimick	ei
mimicke	dr
mimicker	s
mimicki	n
mimickin	g
mimicr	y
mimin	g
mimo	s
mimos	a
min	acdegiknopstux
mina	rt
minar	e
minare	t
minaret	s
minat	o
minato	r
minator	y
minc	ei
mince	dmrs
mincem	e
minceme	a
mincemea	t
mincemeat	s
mincer	s
minci	n
mincin	g
mincing	ns
mincingn	e
mincingne	s
mincingnes	s
mind	aefilmns
minda	n
mindan	a
mindana	o
minde	dr
minder	s
mindf	u
mindfu	l
mindful	ln
mindfull	y
mindfuln	e
mindfulne	s
mindfulnes	s
mindfulness	e
mindfulnesse	s
mindi	n
mindin	g
mindl	e
mindle	s
mindles	s
mindless	ln
mindlessl	y
mindlessn	e
mindlessne	s
mindlessnes	s
mindlessness	e
mindlessnesse	s
mindm	i
mindmi	n
mindmin	d
mindmind	e
mindminde	d
mindn	o
mindno	d
mindnod	e
mine	cdflrs
minec	r
minecr	a
minecra	f
minecraf	t
minef	i
minefi	e
minefie	l
minefiel	d
minefield	s
minel	a
minela	y
minelay	e
minelaye	r
miner	asv
minera	l
mineral	ios
minerali	sz
mineralis	e
mineraliz	ae
mineraliza	t
mineralizat	i
mineralizati	o
mineralizatio	n
mineralo	g
mineralog	iy
mineralogi	cs
mineralogic	a
mineralogica	l
mineralogis	t
minerv	a
mines	w
minesw	e
mineswe	e
mineswee	p
minesweep	e
minesweepe	r
ming	l
mingl	ei
mingle	dmrs
minglem	e
mingleme	n
minglemen	t
minglement	s
mingler	s
mingli	n
minglin	g
mingling	l
minglingl	y
mini	abcdfhkmnostvw
minia	t
miniat	eu
miniatu	r
miniatur	ei
miniature	ds
miniaturi	nsz
miniaturin	g
miniaturis	et
miniaturist	is
miniaturisti	c
miniaturiz	aei
miniaturiza	t
miniaturizat	i
miniaturizati	o
miniaturizatio	n
miniaturize	ds
miniaturizi	n
miniaturizin	g
minib	iu
minibi	bk
minibib	l
minibibl	i
minibibli	o
minibiblio	g
minibibliog	r
minibibliogr	a
minibibliogra	p
minibibliograp	h
minibibliograph	iy
minibibliographi	e
minibibliographie	s
minibik	e
minibu	s
minibus	es
minibuse	s
minibuss	e
minibusse	s
minic	aioy
minica	blr
minical	c
minicalc	u
minicalcu	l
minicalcul	a
minicalcula	t
minicalculat	o
minicalculato	r
minicalculator	s
minicar	t
minicart	r
minicartr	i
minicartri	d
minicartrid	g
minicartridg	e
minici	rt
minicir	c
minicirc	u
minicircu	i
minicircui	t
minicircuit	s
minicit	iy
miniciti	e
minicitie	s
minico	mn
minicom	p
minicomp	u
minicompu	t
minicomput	e
minicompute	r
minicomputer	s
minicon	g
minicong	l
minicongl	o
miniconglo	m
miniconglom	e
miniconglome	r
miniconglomer	a
miniconglomera	t
miniconglomerat	e
miniconglomerate	s
minicy	c
minicyc	l
minicycl	o
minicyclo	n
minicyclon	e
minicyclone	s
minid	eir
minide	p
minidep	r
minidepr	e
minidepre	s
minidepres	s
minidepress	i
minidepressi	o
minidepressio	n
minidepression	s
minidi	s
minidis	c
minidisc	s
minidr	a
minidra	m
minidram	a
minidrama	s
minif	aly
minifa	r
minifar	m
minifarm	s
minifl	o
miniflo	p
miniflop	p
miniflopp	y
minih	o
miniho	ms
minihom	e
minihome	s
minihos	p
minihosp	i
minihospi	t
minihospit	a
minihospita	l
minihospital	s
minik	iu
miniki	n
miniku	b
minikub	e
minim	aeisu
minima	lx
minimal	il
minimali	stz
minimalis	t
minimalit	y
minimaliz	e
minimall	y
minime	l
minimel	o
minimelo	d
minimelod	r
minimelodr	a
minimelodra	m
minimelodram	a
minimelodrama	s
minimi	sz
minimis	ei
minimise	ds
minimisi	n
minimisin	g
minimiz	aei
minimiza	t
minimizat	i
minimizati	o
minimizatio	n
minimization	s
minimize	drs
minimizer	s
minimizi	n
minimizin	g
minimu	m
minimum	s
minin	ag
minina	t
mininat	i
mininati	o
mininatio	n
minination	s
mining	s
minio	n
minion	s
minis	cehktu
minisc	a
minisca	n
miniscan	d
miniscand	a
miniscanda	l
miniscandal	s
minise	r
miniser	i
miniseri	e
miniserie	s
minisk	i
miniski	r
miniskir	t
minist	er
ministe	r
minister	eis
ministere	d
ministeri	an
ministeria	l
ministerial	il
ministeriali	s
ministerialis	mt
ministeriall	y
ministerin	g
ministers	h
ministersh	i
ministershi	p
ministr	aiy
ministra	lnt
ministran	t
ministrat	i
ministrati	o
ministratio	n
ministri	e
ministrie	s
minisu	m
minisum	m
minisumm	i
minisummi	t
minisummit	s
minit	aor
minita	b
minito	u
minitou	r
minitour	s
minitr	a
minitra	i
minitrai	n
minitrain	s
miniv	a
miniva	cn
minivac	a
minivaca	t
minivacat	i
minivacati	o
minivacatio	n
minivacation	s
minivan	s
miniw	a
miniwa	r
miniwar	e
miniware	h
miniwareh	o
miniwareho	u
miniwarehou	s
miniwarehous	e
miniwarehouse	s
mink	s
minn	eio
minne	as
minnea	p
minneap	o
minneapo	l
minneapol	i
minneapoli	s
minnes	io
minnesi	n
minnesin	g
minnesing	e
minnesinge	r
minneso	t
minnesot	a
minnesota	n
minni	e
minno	w
minnow	s
mino	alrst
minoa	n
minol	t
minolt	a
minor	ceis
minorc	a
minore	d
minori	nt
minorin	g
minorit	iy
minoriti	e
minoritie	s
minot	a
minota	u
minotau	r
mins	kt
minsk	y
minst	er
minste	r
minstr	e
minstre	l
minstrel	s
mint	aeims
minta	g
mintag	e
minte	drs
minter	s
mintes	t
minti	en
mintie	rs
minties	t
mintin	g
mintm	a
mintma	rs
mintmar	k
mintmas	t
mintmast	e
mintmaste	r
minu	est
minue	nt
minuen	d
minuet	eis
minuete	d
minueti	n
minuetin	g
minus	ces
minusc	u
minuscu	l
minuscul	e
minuscule	s
minuse	s
minuss	e
minusse	s
minut	ei
minute	dlmnrs
minutel	y
minutem	ae
minutema	n
minuteme	n
minuten	e
minutene	s
minutenes	s
minuteness	e
minutenesse	s
minutes	t
minuti	an
minutin	g
mio	ckotuv
mioc	e
mioce	n
miocen	e
miot	i
mioti	c
mip	kpsu
miq	ipruv
miqu	e
mique	l
miquel	o
miquelo	n
mir	adefinprstuyz
mira	cgn
mirac	lu
miracl	e
miracle	s
miracu	l
miracul	aio
miracula	r
miraculi	s
miraculis	t
miraculo	u
miraculou	s
miraculous	ln
miraculousl	y
miraculousn	e
miraculousne	s
miraculousnes	s
miraculousness	e
miraculousnesse	s
mirag	eiy
mirage	ds
miragi	n
miragin	g
miran	d
mirand	a
mire	ds
mirf	a
mirfa	k
miri	anrv
miria	m
mirin	e
mirine	s
mirines	s
mirp	rv
mirr	o
mirro	r
mirror	eilsy
mirrore	d
mirrori	nz
mirrorin	g
mirroriz	e
mirrorl	i
mirrorli	k
mirrorlik	e
mirt	hlv
mirth	fls
mirthf	u
mirthfu	l
mirthful	ln
mirthfull	y
mirthfuln	e
mirthfulne	s
mirthfulnes	s
mirthfulness	e
mirthfulnesse	s
mirthl	e
mirthle	s
mirthles	s
mirthless	l
mirthlessl	y
mirths	o
mirthso	m
mirthsom	e
mirtl	e
mis	abcdefghijklmnopqrstuvwz
misa	cdfgilnprstuw
misac	t
misact	eis
misacte	d
misacti	n
misactin	g
misad	adjmv
misada	p
misadap	t
misadapt	aeis
misadapta	t
misadaptat	i
misadaptati	o
misadaptatio	n
misadaptation	s
misadapte	d
misadapti	n
misadaptin	g
misadd	eirs
misadde	d
misaddi	n
misaddin	g
misaddr	e
misaddre	s
misaddres	s
misaddress	ei
misaddresse	ds
misaddressi	n
misaddressin	g
misadj	u
misadju	ds
misadjud	i
misadjudi	c
misadjudic	a
misadjudica	t
misadjudicat	e
misadjudicate	d
misadjus	t
misadjust	eims
misadjuste	d
misadjusti	n
misadjustin	g
misadjustm	e
misadjustme	n
misadjustmen	t
misadm	i
misadmi	n
misadmin	i
misadmini	s
misadminis	t
misadminist	r
misadministr	a
misadministra	t
misadministrat	i
misadministrati	o
misadministratio	n
misadministration	s
misadv	ei
misadve	n
misadven	t
misadvent	u
misadventu	r
misadventur	e
misadvi	s
misadvis	ei
misadvise	ds
misadvisi	n
misadvisin	g
misaf	f
misaff	e
misaffe	c
misaffec	t
misaffect	i
misaffecti	o
misaffectio	n
misag	r
misagr	e
misagre	e
misai	m
misaim	eis
misaime	d
misaimi	n
misaimin	g
misal	il
misali	g
misalig	n
misalign	ims
misaligni	n
misalignin	g
misalignm	e
misalignme	n
misalignmen	t
misalignment	s
misall	eioy
misalle	g
misalleg	ei
misallege	ds
misallegi	n
misallegin	g
misalli	a
misallia	n
misallian	c
misallianc	e
misallo	ct
misalloc	a
misalloca	t
misallocat	ei
misallocate	ds
misallocati	no
misallocatin	g
misallocatio	n
misallocation	s
misallot	eimst
misallote	d
misalloti	n
misallotin	g
misallotm	e
misallotme	n
misallotmen	t
misallotment	s
misallott	ei
misallotte	d
misallotti	n
misallottin	g
misan	at
misana	l
misanal	y
misanaly	s
misanalys	ei
misanalyse	s
misanalysi	s
misant	h
misanth	r
misanthr	o
misanthro	p
misanthrop	eiy
misanthropi	c
misap	p
misapp	elor
misappe	l
misappel	l
misappell	a
misappella	t
misappellat	i
misappellati	o
misappellatio	n
misappl	iy
misappli	ce
misapplic	a
misapplica	t
misapplicat	i
misapplicati	o
misapplicatio	n
misapplication	s
misapplie	ds
misapply	i
misapplyi	n
misapplyin	g
misappo	i
misappoi	n
misappoin	t
misappoint	eis
misappointe	d
misappointi	n
misappointin	g
misappr	aeo
misappra	i
misapprai	s
misapprais	aei
misappraisa	l
misappraisal	s
misappraise	ds
misappraisi	n
misappraisin	g
misappre	ch
misapprec	i
misappreci	a
misapprecia	t
misappreciat	ei
misappreciati	o
misappreciatio	n
misappreh	e
misapprehe	n
misapprehen	ds
misapprehens	i
misapprehensi	ov
misapprehensio	n
misapprehension	s
misapprehensiv	e
misapprehensive	ln
misapprehensivel	y
misapprehensiven	e
misapprehensivene	s
misapprehensivenes	s
misapprehensiveness	e
misapprehensivenesse	s
misappro	p
misapprop	r
misappropr	i
misappropri	a
misappropria	t
misappropriat	e
misar	rt
misarr	a
misarra	n
misarran	g
misarrang	e
misarrange	d
misart	i
misarti	c
misartic	u
misarticu	l
misarticul	a
misarticula	t
misarticulat	ei
misarticulate	ds
misarticulati	n
misarticulatin	g
misas	s
misass	eiu
misasse	mr
misassem	b
misassemb	l
misassembl	ei
misassemble	ds
misassembli	n
misassemblin	g
misasser	t
misassert	eis
misasserte	d
misasserti	no
misassertin	g
misassertio	n
misassertion	s
misassi	g
misassig	n
misassign	eims
misassigne	d
misassigni	n
misassignin	g
misassignm	e
misassignme	n
misassignmen	t
misassignment	s
misassu	m
misassum	p
misassump	t
misassumpt	i
misassumpti	o
misassumptio	n
misassumption	s
misat	t
misatt	r
misattr	i
misattri	b
misattrib	u
misattribu	t
misattribut	ei
misattribute	ds
misattributi	no
misattributin	g
misattributio	n
misattribution	s
misau	t
misaut	h
misauth	o
misautho	r
misauthor	i
misauthori	z
misauthoriz	ei
misauthorize	ds
misauthorizi	n
misauthorizin	g
misaw	a
misawa	r
misawar	d
misaward	eis
misawarde	d
misawardi	n
misawardin	g
misb	aeioru
misba	l
misbal	a
misbala	n
misbalan	c
misbalanc	ei
misbalance	s
misbalanci	n
misbalancin	g
misbe	cghls
misbec	o
misbeco	m
misbecom	e
misbeg	io
misbegi	n
misbego	t
misbegot	t
misbegott	e
misbegotte	n
misbeh	a
misbeha	v
misbehav	ei
misbehave	drs
misbehaver	s
misbehavi	no
misbehavin	g
misbehavio	ru
misbehavior	s
misbehaviou	r
misbel	i
misbeli	e
misbelie	f
misbes	t
misbest	o
misbesto	w
misbestow	eis
misbestowe	d
misbestowi	n
misbestowin	g
misbi	n
misbin	d
misbind	is
misbindi	n
misbindin	g
misbo	du
misbod	e
misbou	n
misboun	d
misbound	eis
misbounde	d
misboundi	n
misboundin	g
misbr	ae
misbra	n
misbran	d
misbre	w
misbrew	eis
misbrewe	d
misbrewi	n
misbrewin	g
misbu	it
misbui	l
misbuil	dt
misbuild	is
misbuildi	n
misbuildin	g
misbut	t
misbutt	o
misbutto	n
misbutton	eis
misbuttone	d
misbuttoni	n
misbuttonin	g
misc	aehiloru
misca	lprst
miscal	cl
miscalc	u
miscalcu	l
miscalcul	a
miscalcula	t
miscalculat	eio
miscalculate	ds
miscalculati	no
miscalculatin	g
miscalculatio	n
miscalculation	s
miscalculato	r
miscalculator	s
miscap	t
miscapt	i
miscapti	o
miscaptio	n
miscaption	eis
miscaptione	d
miscaptioni	n
miscaptionin	g
miscar	r
miscarr	iy
miscarri	ae
miscarria	g
miscarriag	e
miscarriage	s
miscarrie	ds
miscarry	i
miscarryi	n
miscarryin	g
miscas	tu
miscasu	a
miscasua	l
miscasual	t
miscasualt	y
miscat	ae
miscata	l
miscatal	o
miscatalo	g
miscatalog	eisu
miscataloge	d
miscatalogi	n
miscatalogin	g
miscatalogu	ei
miscatalogue	s
miscatalogui	n
miscataloguin	g
miscate	g
miscateg	o
miscatego	r
miscategor	i
miscategori	z
miscategoriz	ei
miscategorize	ds
miscategorizi	n
miscategorizin	g
misce	gln
misceg	e
miscege	n
miscegen	a
miscegena	t
miscegenat	i
miscegenati	o
miscegenatio	n
miscel	l
miscell	a
miscella	n
miscellan	ey
miscellane	o
miscellaneo	u
miscellaneou	s
miscellaneous	ln
miscellaneousl	y
miscellaneousn	e
miscellaneousne	s
miscellaneousnes	s
miscellaneousness	e
miscellaneousnesse	s
miscen	s
miscens	u
miscensu	r
miscensur	ei
miscensure	ds
miscensuri	n
miscensurin	g
misch	aior
mischa	nr
mischan	cn
mischanc	e
mischann	e
mischanne	l
mischannel	eils
mischannele	d
mischanneli	n
mischannelin	g
mischannell	ei
mischannelle	d
mischannelli	n
mischannellin	g
mischar	ag
mischara	c
mischarac	t
mischaract	e
mischaracte	r
mischaracter	i
mischaracteri	z
mischaracteriz	aei
mischaracteriza	t
mischaracterizat	i
mischaracterizati	o
mischaracterizatio	n
mischaracterization	s
mischaracterize	ds
mischaracterizi	n
mischaracterizin	g
mischarg	ei
mischarge	ds
mischargi	n
mischargin	g
mischi	e
mischie	fv
mischief	fs
mischieff	u
mischieffu	l
mischiev	o
mischievo	u
mischievou	s
mischievous	ln
mischievousl	y
mischievousn	e
mischievousne	s
mischievousnes	s
mischievousness	e
mischievousnesse	s
mischo	i
mischoi	c
mischoic	e
mischoice	s
mischr	i
mischri	s
mischris	t
mischrist	e
mischriste	n
misci	bt
miscib	il
miscibi	l
miscibil	i
miscibili	t
miscibilit	iy
miscibiliti	e
miscibilitie	s
miscibl	e
miscit	a
miscita	t
miscitat	i
miscitati	o
miscitatio	n
miscitation	s
miscl	ao
miscla	is
misclai	m
misclaim	eis
misclaime	d
misclaimi	n
misclaimin	g
misclas	s
misclass	ei
misclasse	ds
misclassi	fn
misclassif	iy
misclassifi	ce
misclassific	a
misclassifica	t
misclassificat	i
misclassificati	o
misclassificatio	n
misclassification	s
misclassifie	ds
misclassify	i
misclassifyi	n
misclassifyin	g
misclassin	g
misclo	s
misclos	u
misclosu	r
misclosur	e
misco	dimnopru
miscod	ei
miscode	ds
miscodi	n
miscodin	g
miscoi	n
miscoin	aeis
miscoina	g
miscoinag	e
miscoinage	s
miscoine	d
miscoini	n
miscoinin	g
miscom	mp
miscomm	u
miscommu	n
miscommun	i
miscommuni	c
miscommunic	a
miscommunica	t
miscommunicat	e
miscomp	ru
miscompr	e
miscompre	h
miscompreh	e
miscomprehe	n
miscomprehen	ds
miscomprehens	i
miscomprehensi	o
miscomprehensio	n
miscomprehension	s
miscompu	t
miscomput	aei
miscomputa	t
miscomputat	i
miscomputati	o
miscomputatio	n
miscomputation	s
miscompute	ds
miscomputi	n
miscomputin	g
miscon	cdjnsv
misconc	e
misconce	ip
misconcei	v
misconceiv	ei
misconceive	rs
misconceiver	s
misconceivi	n
misconceivin	g
misconcep	t
misconcept	i
misconcepti	o
misconceptio	n
misconception	s
miscond	u
miscondu	c
misconduc	t
misconduct	eis
misconducte	d
misconducti	n
misconductin	g
misconj	eu
misconje	c
misconjec	t
misconject	u
misconjectu	r
misconjectur	ei
misconjecture	ds
misconjecturi	n
misconjecturin	g
misconju	gn
misconjug	a
misconjuga	t
misconjugat	ei
misconjugate	ds
misconjugati	n
misconjugatin	g
misconjun	c
misconjunc	t
misconjunct	i
misconjuncti	o
misconjunctio	n
misconn	e
misconne	c
misconnec	t
misconnect	eis
misconnecte	d
misconnecti	no
misconnectin	g
misconnectio	n
misconnection	s
miscons	et
misconse	c
misconsec	r
misconsecr	a
misconsecra	t
misconsecrat	e
misconsecrate	d
misconst	r
misconstr	u
misconstru	cei
misconstruc	t
misconstruct	i
misconstructi	o
misconstructio	n
misconstruction	s
misconstrue	ds
misconstrui	n
misconstruin	g
misconv	e
misconve	y
miscoo	kr
miscoor	d
miscoord	i
miscoordi	n
miscoordin	a
miscoordina	t
miscoordinat	ei
miscoordinate	ds
miscoordinati	n
miscoordinatin	g
miscop	iy
miscopi	e
miscopie	ds
miscopy	i
miscopyi	n
miscopyin	g
miscor	r
miscorr	e
miscorre	l
miscorrel	a
miscorrela	t
miscorrelat	i
miscorrelati	o
miscorrelatio	n
miscorrelation	s
miscou	n
miscoun	t
miscount	eis
miscounte	d
miscounti	n
miscountin	g
miscr	e
miscre	ae
miscrea	nt
miscrean	t
miscreat	ei
miscreate	ds
miscreati	no
miscreatin	g
miscreatio	n
miscreation	s
miscree	d
miscu	lt
miscul	t
miscult	i
misculti	v
miscultiv	a
miscultiva	t
miscultivat	e
miscultivate	d
miscut	st
miscutt	i
miscutti	n
miscuttin	g
misd	aeior
misda	t
misdat	ei
misdate	ds
misdati	n
misdatin	g
misde	aceflmrsv
misdea	l
misdec	il
misdeci	ds
misdecid	e
misdecis	i
misdecisi	o
misdecisio	n
misdecl	a
misdecla	r
misdeclar	ei
misdeclare	ds
misdeclari	n
misdeclarin	g
misdee	dm
misdeem	eis
misdeeme	d
misdeemi	n
misdeemin	g
misdef	i
misdefi	n
misdefin	ei
misdefine	ds
misdefini	n
misdefinin	g
misdel	i
misdeli	v
misdeliv	e
misdelive	r
misdeliver	eisy
misdelivere	d
misdeliveri	en
misdeliverie	s
misdeliverin	g
misdem	e
misdeme	a
misdemea	n
misdemean	ao
misdemeana	n
misdemeanan	t
misdemeano	ru
misdemeanor	s
misdemeanou	r
misdemeanour	s
misder	i
misderi	v
misderiv	e
misdes	ce
misdesc	r
misdescr	i
misdescri	bp
misdescrib	ei
misdescribe	ds
misdescribi	n
misdescribin	g
misdescrip	t
misdescript	i
misdescripti	o
misdescriptio	n
misdescription	s
misdese	r
misdeser	tv
misdeserv	e
misdev	eo
misdeve	l
misdevel	o
misdevelo	p
misdevelop	eis
misdevelope	d
misdevelopi	n
misdevelopin	g
misdevo	t
misdevot	e
misdevote	d
misdi	acegrsv
misdia	gl
misdiag	nr
misdiagn	o
misdiagno	s
misdiagnos	ei
misdiagnose	ds
misdiagnosi	n
misdiagnosin	g
misdiagr	a
misdiagra	m
misdiagram	m
misdiagramm	e
misdiagramme	d
misdial	eils
misdiale	d
misdiali	n
misdialin	g
misdiall	ei
misdialle	d
misdialli	n
misdiallin	g
misdic	t
misdict	a
misdicta	t
misdictat	e
misdictate	d
misdie	t
misdig	h
misdigh	t
misdir	e
misdire	c
misdirec	t
misdirect	i
misdirecti	o
misdirectio	n
misdis	t
misdist	r
misdistr	i
misdistri	b
misdistrib	u
misdistribu	t
misdistribut	i
misdistributi	o
misdistributio	n
misdistribution	s
misdiv	i
misdivi	ds
misdivid	ei
misdivide	ds
misdividi	n
misdividin	g
misdivis	i
misdivisi	o
misdivisio	n
misdivision	s
misdo	iu
misdoi	n
misdoin	g
misdou	b
misdoub	t
misdr	aei
misdra	w
misdraw	ins
misdrawi	n
misdrawin	g
misdre	aw
misdrea	d
misdri	v
misdriv	e
mise	dmnrsvx
mised	iu
misedi	t
misedit	eis
misedite	d
misediti	n
miseditin	g
misedu	c
miseduc	a
miseduca	t
miseducat	ei
miseducate	s
miseducati	no
miseducatin	g
miseducatio	n
miseducation	s
misem	p
misemp	hl
misemph	a
misempha	s
misemphas	ei
misemphase	s
misemphasi	z
misemphasiz	ei
misemphasize	ds
misemphasizi	n
misemphasizin	g
misempl	o
misemplo	y
misemploy	eims
misemploye	d
misemployi	n
misemployin	g
misemploym	e
misemployme	n
misemploymen	t
misemployment	s
misen	ct
misenc	o
misenco	d
misencod	ei
misencode	ds
misencodi	n
misencodin	g
misent	r
misentr	y
miser	ahilsy
misera	b
miserab	il
miserabi	l
miserabil	i
miserabili	t
miserabilit	y
miserabl	ey
miserable	ns
miserablen	e
miserablene	s
miserablenes	s
miserableness	e
miserablenesse	s
miserh	o
miserho	o
miserhoo	d
miseri	e
miserie	s
miserl	iy
miserli	n
miserlin	e
miserline	s
miserlines	s
mises	t
misest	i
misesti	m
misestim	a
misestima	t
misestimat	ei
misestimate	ds
misestimati	no
misestimatin	g
misestimatio	n
misestimation	s
misev	a
miseva	l
miseval	u
misevalu	a
misevalua	t
misevaluat	ei
misevaluate	ds
misevaluati	no
misevaluatin	g
misevaluatio	n
misevaluation	s
misex	ep
misexe	c
misexec	u
misexecu	t
misexecut	ei
misexecuti	o
misexecutio	n
misexp	l
misexpl	a
misexpla	i
misexplai	n
misexplain	e
misexplaine	d
misf	aeioru
misfa	ims
misfai	t
misfait	h
misfam	e
misfas	h
misfash	i
misfashi	o
misfashio	n
misfashion	es
misfashione	d
misfe	ade
misfea	st
misfeas	a
misfeasa	n
misfeasan	c
misfeasanc	e
misfeat	u
misfeatu	r
misfeatur	e
misfee	d
misfeed	is
misfeedi	n
misfeedin	g
misfi	elrt
misfie	l
misfiel	d
misfield	eis
misfielde	d
misfieldi	n
misfieldin	g
misfil	ei
misfile	ds
misfili	n
misfilin	g
misfir	ei
misfire	ds
misfiri	n
misfirin	g
misfit	st
misfitt	ei
misfitte	d
misfitti	n
misfittin	g
misfo	cr
misfoc	u
misfocu	s
misfocus	eis
misfocuse	ds
misfocusi	n
misfocusin	g
misfocuss	ei
misfocusse	ds
misfocussi	n
misfocussin	g
misfor	mt
misform	aeis
misforma	t
misformat	i
misformati	o
misformatio	n
misformation	s
misforme	d
misformi	n
misformin	g
misfort	u
misfortu	n
misfortun	e
misfortune	drs
misfr	a
misfra	m
misfram	ei
misframe	ds
misframi	n
misframin	g
misfu	n
misfun	c
misfunc	t
misfunct	i
misfuncti	o
misfunctio	n
misfunction	eis
misfunctione	d
misfunctioni	n
misfunctionin	g
misg	aioru
misga	u
misgau	g
misgaug	ei
misgauge	ds
misgaugi	n
misgaugin	g
misgi	v
misgiv	ei
misgivi	n
misgivin	g
misgiving	ls
misgivingl	y
misgo	tv
misgot	t
misgott	e
misgotte	n
misgov	e
misgove	r
misgover	n
misgovern	eims
misgoverne	d
misgoverni	n
misgovernin	g
misgovernm	e
misgovernme	n
misgovernmen	t
misgovernment	s
misgr	ao
misgra	df
misgrad	ei
misgrade	ds
misgradi	n
misgradin	g
misgraf	f
misgraff	e
misgraffe	d
misgro	uw
misgrou	n
misgroun	d
misground	e
misgrounde	d
misgrow	nt
misgrowt	h
misgu	i
misgui	d
misguid	e
misguide	d
misguided	ln
misguidedl	y
misguidedn	e
misguidedne	s
misguidednes	s
misguidedness	e
misguidednesse	s
mish	aeim
misha	np
mishan	d
mishand	l
mishandl	e
mishandle	d
mishap	s
mishe	a
mishea	r
mishi	e
mishie	f
mishm	a
mishma	s
mishmas	h
misi	dntv
misid	e
miside	n
misiden	t
misident	i
misidenti	f
misidentif	iy
misidentifi	ce
misidentific	a
misidentifica	t
misidentificat	i
misidentificati	o
misidentificatio	n
misidentification	s
misidentifie	ds
misidentify	i
misidentifyi	n
misidentifyin	g
misin	fst
misinf	eo
misinfe	r
misinfer	eirs
misinfere	d
misinferi	n
misinferin	g
misinferr	ei
misinferre	d
misinferri	n
misinferrin	g
misinfo	r
misinfor	m
misinform	aeis
misinforma	nt
misinforman	t
misinformant	s
misinformat	i
misinformati	ov
misinformatio	n
misinformation	s
misinformativ	e
misinforme	dr
misinformer	s
misinformi	n
misinformin	g
misins	t
misinst	r
misinstr	u
misinstru	c
misinstruc	t
misinstruct	eis
misinstructe	d
misinstructi	no
misinstructin	g
misinstructio	n
misinstruction	s
misint	e
misinte	nr
misinten	dt
misintend	eis
misintende	d
misintendi	n
misintendin	g
misintent	i
misintenti	o
misintentio	n
misintention	s
misinter	p
misinterp	r
misinterpr	e
misinterpre	t
misinterpret	aeis
misinterpreta	bt
misinterpretab	l
misinterpretabl	e
misinterpretat	i
misinterpretati	o
misinterpretatio	n
misinterpretation	s
misinterprete	dr
misinterpreter	s
misinterpreti	n
misinterpretin	g
misit	e
misite	m
misitem	i
misitemi	z
misitemiz	e
misitemize	d
misj	ou
misjo	i
misjoi	n
misjoin	eis
misjoine	d
misjoini	n
misjoinin	g
misju	d
misjud	g
misjudg	eim
misjudge	dmrs
misjudgem	e
misjudgeme	n
misjudgemen	t
misjudgement	s
misjudger	s
misjudgi	n
misjudgin	g
misjudgm	e
misjudgme	n
misjudgmen	t
misjudgment	s
misk	i
miski	c
miskic	k
miskick	eis
miskicke	d
miskicki	n
miskickin	g
misl	aeiou
misla	biy
mislab	e
mislabe	l
mislabel	eils
mislabele	d
mislabeli	n
mislabelin	g
mislabell	ei
mislabelle	d
mislabelli	n
mislabellin	g
mislai	d
mislay	eis
mislaye	r
mislayer	s
mislayi	n
mislayin	g
misle	ad
mislea	dr
mislead	eis
misleade	r
misleader	s
misleadi	n
misleadin	g
misleading	ls
misleadingl	y
mislear	n
mislearn	eist
mislearne	d
mislearni	n
mislearnin	g
misli	kv
mislik	e
misliv	ei
mislive	r
mislivi	n
mislivin	g
mislo	cd
misloc	a
misloca	t
mislocat	ei
mislocate	ds
mislocati	no
mislocatin	g
mislocatio	n
mislocation	s
mislod	g
mislodg	e
mislu	c
misluc	k
mism	ae
misma	dknrt
mismad	e
mismak	e
misman	a
mismana	g
mismanag	ei
mismanage	dmrs
mismanagem	e
mismanageme	n
mismanagemen	t
mismanagement	s
mismanager	s
mismanagi	n
mismanagin	g
mismar	kr
mismark	eis
mismarke	d
mismarki	n
mismarkin	g
mismarr	i
mismarri	a
mismarria	g
mismarriag	e
mismarriage	s
mismat	ce
mismatc	h
mismatch	ei
mismatche	ds
mismatchi	n
mismatchin	g
mismate	ds
misme	at
mismea	s
mismeas	u
mismeasu	r
mismeasur	ei
mismeasure	dms
mismeasurem	e
mismeasureme	n
mismeasuremen	t
mismeasurement	s
mismeasuri	n
mismeasurin	g
mismet	r
mismetr	e
misn	aou
misna	mrv
misnam	e
misnar	r
misnarr	a
misnarra	t
misnarrat	ei
misnarrate	ds
misnarrati	n
misnarratin	g
misnav	i
misnavi	g
misnavig	a
misnaviga	t
misnavigat	ei
misnavigate	ds
misnavigati	n
misnavigatin	g
misno	m
misnom	e
misnome	r
misnu	m
misnum	b
misnumb	e
misnumbe	r
misnumber	eis
misnumbere	d
misnumberi	n
misnumberin	g
miso	bcgr
misob	s
misobs	e
misobse	r
misobser	v
misobserv	a
misobserva	n
misobservan	c
misobservanc	e
misoc	c
misocc	u
misoccu	p
misoccup	iy
misoccupi	e
misoccupie	ds
misoccupy	i
misoccupyi	n
misoccupyin	g
misog	ay
misoga	m
misogam	iy
misogami	s
misogamis	t
misogy	n
misogyn	ioy
misogyni	s
misogynis	t
misogynist	is
misogynisti	c
misogyno	u
misogynou	s
misor	dgi
misord	e
misorde	r
misorder	eis
misordere	d
misorderi	n
misorderin	g
misorg	a
misorga	n
misorgan	i
misorgani	z
misorganiz	aei
misorganiza	t
misorganizat	i
misorganizati	o
misorganizatio	n
misorganization	s
misorganize	ds
misorganizi	n
misorganizin	g
misori	e
misorie	n
misorien	t
misorient	aeis
misorienta	t
misorientat	i
misorientati	o
misorientatio	n
misorientation	s
misoriente	d
misorienti	n
misorientin	g
misp	aehiloruv
mispa	cr
mispac	k
mispack	a
mispacka	g
mispackag	ei
mispackage	ds
mispackagi	n
mispackagin	g
mispar	a
mispara	p
misparap	h
misparaph	r
misparaphr	a
misparaphra	s
misparaphras	ei
misparaphrase	ds
misparaphrasi	n
misparaphrasin	g
mispe	r
misper	cfs
misperc	e
misperce	ip
mispercei	v
misperceiv	ei
misperceive	ds
misperceivi	n
misperceivin	g
mispercep	t
mispercept	i
mispercepti	o
misperceptio	n
misperception	s
misperf	o
misperfo	r
misperfor	m
misperform	aeis
misperforma	n
misperforman	c
misperformanc	e
misperformance	s
misperforme	d
misperformi	n
misperformin	g
mispers	u
mispersu	a
mispersua	ds
mispersuad	e
mispersuas	i
mispersuasi	o
mispersuasio	n
misph	r
misphr	a
misphra	s
misphras	ei
misphrase	ds
misphrasi	n
misphrasin	g
mispi	c
mispic	t
mispict	u
mispictu	r
mispictur	ei
mispicture	ds
mispicturi	n
mispicturin	g
mispl	a
mispla	cny
misplac	ei
misplace	ds
misplaci	n
misplacin	g
misplan	enst
misplane	d
misplann	ei
misplanne	d
misplanni	n
misplannin	g
misplant	eis
misplante	d
misplanti	n
misplantin	g
mispo	is
mispoi	n
mispoin	t
mispoint	i
mispointi	n
mispointin	g
mispos	i
misposi	t
misposit	i
mispositi	o
mispositio	n
misposition	eis
mispositione	d
mispositioni	n
mispositionin	g
mispr	aeio
mispra	ci
misprac	t
mispract	i
mispracti	cs
mispractic	ei
mispractice	ds
mispractici	n
mispracticin	g
mispractis	ei
mispractise	ds
mispractisi	n
mispractisin	g
misprai	s
misprais	e
mispre	ds
mispred	i
mispredi	c
mispredic	t
mispredict	eis
mispredicte	d
mispredicti	n
mispredictin	g
mispres	c
mispresc	r
misprescr	i
misprescri	b
misprescrib	ei
misprescribe	ds
misprescribi	n
misprescribin	g
mispri	nsz
misprin	t
misprint	eis
misprinte	d
misprinti	n
misprintin	g
mispris	aei
misprisa	l
misprisi	o
misprisio	n
mispriz	e
mispro	dgnpuv
misprod	u
misprodu	c
misproduc	ei
misproduce	ds
misproduci	n
misproducin	g
misprog	r
misprogr	a
misprogra	m
misprogram	eims
misprograme	d
misprogrami	n
misprogramin	g
misprogramm	ei
misprogramme	d
misprogrammi	n
misprogrammin	g
mispron	ou
misprono	u
mispronou	n
mispronoun	c
mispronounc	ei
mispronounce	drs
mispronouncer	s
mispronounci	n
mispronouncin	g
mispronu	n
mispronun	c
mispronunc	i
mispronunci	a
mispronuncia	t
mispronunciat	i
mispronunciati	o
mispronunciatio	n
misprop	o
mispropo	rs
mispropor	t
misproport	i
misproporti	o
misproportio	n
misproportion	s
mispropos	aei
misproposa	l
misproposal	s
mispropose	ds
misproposi	n
misproposin	g
misprou	d
misprov	o
misprovo	k
misprovok	ei
misprovoke	ds
misprovoki	n
misprovokin	g
mispu	br
mispub	l
mispubl	i
mispubli	cs
mispublic	i
mispublici	z
mispubliciz	e
mispublicize	d
mispublis	h
mispublish	e
mispublishe	d
mispur	c
mispurc	h
mispurch	a
mispurcha	s
mispurchas	ei
mispurchase	ds
mispurchasi	n
mispurchasin	g
misq	u
misqu	ao
misqua	l
misqual	i
misquali	f
misqualif	iy
misqualifi	e
misqualifie	ds
misqualify	i
misqualifyi	n
misqualifyin	g
misquo	t
misquot	aei
misquota	t
misquotat	i
misquotati	o
misquotatio	n
misquotation	s
misquote	ds
misquoti	n
misquotin	g
misr	aehou
misra	t
misrat	e
misre	acfglmnpsw
misrea	d
misread	eis
misreade	r
misreader	s
misreadi	n
misreadin	g
misreading	s
misrec	ko
misreck	o
misrecko	n
misreckon	eis
misreckone	d
misreckoni	n
misreckonin	g
misreco	lr
misrecol	l
misrecoll	e
misrecolle	c
misrecollec	t
misrecollect	is
misrecollecti	no
misrecollectin	g
misrecollectio	n
misrecollection	s
misrecor	d
misrecord	eis
misrecorde	d
misrecordi	n
misrecordin	g
misref	elo
misrefe	r
misrefer	eirs
misrefere	dn
misreferen	c
misreferenc	ei
misreference	ds
misreferenci	n
misreferencin	g
misreferi	n
misreferin	g
misreferr	ei
misreferre	d
misreferri	n
misreferrin	g
misrefl	e
misrefle	c
misreflec	t
misreflect	eis
misreflecte	d
misreflecti	n
misreflectin	g
misrefo	r
misrefor	m
misreform	eis
misreforme	d
misreformi	n
misreformin	g
misreg	aiu
misrega	r
misregar	d
misregi	s
misregis	t
misregist	er
misregiste	r
misregister	eis
misregistere	d
misregisteri	n
misregisterin	g
misregistr	a
misregistra	t
misregistrat	i
misregistrati	o
misregistratio	n
misregistration	s
misregu	l
misregul	a
misregula	t
misregulat	ei
misregulate	ds
misregulati	n
misregulatin	g
misrel	aiy
misrela	t
misrelat	ei
misrelate	ds
misrelati	n
misrelatin	g
misreli	ae
misrelia	n
misrelian	c
misrelianc	e
misreliance	s
misrelie	ds
misrely	i
misrelyi	n
misrelyin	g
misrem	e
misreme	m
misremem	b
misrememb	e
misremembe	r
misremember	eis
misremembere	d
misrememberi	n
misrememberin	g
misren	d
misrend	e
misrende	r
misrender	eis
misrendere	d
misrenderi	n
misrenderin	g
misrep	eor
misrepe	a
misrepea	t
misrepo	r
misrepor	t
misreport	eis
misreporte	d
misreporti	n
misreportin	g
misrepr	e
misrepre	s
misrepres	e
misreprese	n
misrepresen	t
misrepresent	aeis
misrepresenta	t
misrepresentat	i
misrepresentati	o
misrepresentatio	n
misrepresentation	s
misrepresente	dr
misrepresenter	s
misrepresenti	n
misrepresentin	g
misres	e
misrese	m
misresem	b
misresemb	l
misresembl	a
misresembla	n
misresemblan	c
misresemblanc	e
misrew	a
misrewa	r
misrewar	d
misreward	eis
misrewarde	d
misrewardi	n
misrewardin	g
misrh	y
misrhy	m
misrhym	e
misrhyme	d
misro	u
misrou	t
misrout	ei
misroute	ds
misrouti	n
misroutin	g
misru	l
misrul	e
miss	acehioptuwy
missa	lmn
missam	p
missamp	l
missampl	ei
missample	ds
missampli	n
missamplin	g
missan	g
missc	r
misscr	i
misscri	p
misscrip	t
misse	adelrst
missea	t
misseat	eis
misseate	d
misseati	n
misseatin	g
missel	l
misser	v
misserv	e
misset	st
missett	i
missetti	n
missettin	g
missh	ai
missha	p
misshap	ei
misshape	dns
misshapen	l
misshapenl	y
misshapi	n
misshapin	g
misshi	p
misship	imps
misshipi	n
misshipin	g
misshipm	e
misshipme	n
misshipmen	t
misshipment	s
misshipp	ei
misshippe	d
misshippi	n
misshippin	g
missi	lnosv
missil	e
missile	rs
missiler	y
missin	g
missing	ils
missingi	n
missingin	g
missingl	y
missio	n
mission	aeis
missiona	lrt
missionar	iy
missionari	ez
missionarie	s
missionariz	e
missionary	s
missionarys	h
missionarysh	i
missionaryshi	p
missionat	e
missione	dr
missioni	ns
missionin	g
missionis	t
missis	s
mississ	ai
mississa	u
mississau	g
mississaug	a
mississi	p
mississip	p
mississipp	i
mississippi	a
mississippia	n
mississippian	s
missiv	e
misso	ru
missor	t
missort	eis
missorte	d
missorti	n
missortin	g
missou	lr
missoul	a
missour	i
missouri	a
missouria	n
missp	ae
misspa	c
misspac	ei
misspace	ds
misspaci	n
misspacin	g
misspe	cln
misspec	i
misspeci	f
misspecif	i
misspecifi	e
misspecifie	d
misspel	lt
misspell	eis
misspelle	d
misspelli	n
misspellin	g
misspelling	s
misspen	d
misst	aery
missta	mrt
misstam	p
misstamp	eis
misstampe	d
misstampi	n
misstampin	g
misstar	t
misstart	eis
misstarte	d
misstarti	n
misstartin	g
misstat	e
misstate	m
misstatem	e
misstateme	n
misstatemen	t
misste	p
misstr	iu
misstri	k
misstrik	ei
misstrike	s
misstriki	n
misstrikin	g
misstru	c
misstruc	k
missty	l
misstyl	ei
misstyle	ds
misstyli	n
misstylin	g
missu	inp
missui	t
missun	g
missup	p
missupp	o
missuppo	s
missuppos	ei
missuppose	ds
missupposi	n
missupposin	g
missw	ao
misswa	r
misswar	m
misswarm	j
misswo	r
misswor	n
mist	aehilorsuy
mista	k
mistak	aei
mistaka	b
mistakab	l
mistakabl	e
mistake	anrs
mistakea	b
mistakeab	l
mistakeabl	y
mistaken	ln
mistakenl	y
mistakenn	e
mistakenne	s
mistakennes	s
mistakenness	e
mistakennesse	s
mistaker	s
mistaki	n
mistakin	g
miste	dr
mister	eims
mistere	d
misteri	n
misterin	g
misterm	eis
misterme	d
mistermi	n
mistermin	g
misth	r
misthr	eo
misthre	aw
misthrea	d
misthread	eis
misthreade	d
misthreadi	n
misthreadin	g
misthro	w
misthrow	ins
misthrowi	n
misthrowin	g
misti	elmnt
mistie	rs
misties	t
mistil	ly
mistill	e
mistille	d
mistim	ei
mistime	s
mistimi	n
mistimin	g
mistin	eg
mistine	s
mistines	s
mistiness	e
mistinesse	s
mistit	l
mistitl	ei
mistitle	ds
mistitli	n
mistitlin	g
mistl	ei
mistle	st
mistles	s
mistlet	o
mistleto	e
mistletoe	s
mistli	k
mistlik	e
misto	or
mistoo	k
mistr	aeiu
mistra	iln
mistrai	n
mistrain	eis
mistraine	d
mistraini	n
mistrainin	g
mistran	s
mistrans	cl
mistransc	r
mistranscr	i
mistranscri	bp
mistranscrib	ei
mistranscribe	ds
mistranscribi	n
mistranscribin	g
mistranscrip	t
mistranscript	i
mistranscripti	o
mistranscriptio	n
mistranscription	s
mistransl	a
mistransla	t
mistranslat	ei
mistranslate	ds
mistranslati	no
mistranslatin	g
mistranslatio	n
mistranslation	s
mistre	as
mistrea	t
mistreat	eimns
mistreate	d
mistreati	n
mistreatin	g
mistreatm	e
mistreatme	n
mistreatmen	t
mistreatment	s
mistreatn	e
mistreatne	s
mistreatnes	s
mistres	s
mistress	ehil
mistresse	ds
mistressh	o
mistressho	o
mistresshoo	d
mistressi	n
mistressin	g
mistressl	ey
mistressle	s
mistressles	s
mistri	a
mistria	l
mistru	st
mistrus	t
mistrust	efils
mistruste	dr
mistruster	s
mistrustf	u
mistrustfu	l
mistrustful	ln
mistrustfull	y
mistrustfuln	e
mistrustfulne	s
mistrustfulnes	s
mistrustfulness	e
mistrustfulnesse	s
mistrusti	n
mistrustin	g
mistrusting	l
mistrustingl	y
mistrustl	e
mistrustle	s
mistrustles	s
mistrut	h
mistruth	s
mistu	nt
mistun	ei
mistune	ds
mistuni	n
mistunin	g
mistut	o
mistuto	r
mistutor	eis
mistutore	d
mistutori	n
mistutorin	g
misty	p
mistyp	ei
mistype	ds
mistypi	n
mistypin	g
misu	nst
misun	di
misund	e
misunde	r
misunder	s
misunders	t
misunderst	ao
misundersta	n
misunderstan	d
misunderstand	aeis
misunderstanda	b
misunderstandab	l
misunderstandabl	e
misunderstande	r
misunderstander	s
misunderstandi	n
misunderstandin	g
misunderstanding	ls
misunderstandingl	y
misundersto	o
misunderstoo	d
misuni	o
misunio	n
misunion	s
misus	aei
misusa	g
misusag	e
misuse	drs
misuser	s
misusi	n
misusin	g
misut	i
misuti	l
misutil	i
misutili	z
misutiliz	a
misutiliza	t
misutilizat	i
misutilizati	o
misutilizatio	n
misutilization	s
misv	ao
misva	l
misval	u
misvalu	ei
misvalue	ds
misvalui	n
misvaluin	g
misvo	c
misvoc	a
misvoca	l
misvocal	i
misvocali	z
misvocaliz	a
misvocaliza	t
misvocalizat	i
misvocalizati	o
misvocalizatio	n
misvocalization	s
misw	ior
miswi	r
miswir	ei
miswire	ds
miswiri	n
miswirin	g
miswo	r
miswor	s
miswors	h
misworsh	i
misworshi	p
misworship	eips
misworshipe	d
misworshipi	n
misworshipin	g
misworshipp	ei
misworshippe	d
misworshippi	n
misworshippin	g
miswr	io
miswri	t
miswrit	et
miswrite	s
miswritt	e
miswritte	n
miswro	t
miswrot	e
misz	o
miszo	n
miszon	ei
miszone	ds
miszoni	n
miszonin	g
mit	cdehilmoprstyz
mitc	h
mitch	e
mitche	l
mitchel	l
mite	rs
mith	r
mithr	ai
mithra	s
mithri	d
mithrid	a
mithrida	t
mithridat	i
mithridati	s
mithridatis	m
miti	g
mitig	a
mitiga	bt
mitigab	l
mitigabl	e
mitigat	eio
mitigate	ds
mitigated	l
mitigatedl	y
mitigati	nov
mitigatin	g
mitigatio	n
mitigation	s
mitigativ	e
mitigato	r
mitigator	sy
mitl	i
mitli	c
mitlic	e
mitlice	n
mitlicen	s
mitlicens	e
mito	cst
mitoc	h
mitoch	o
mitocho	n
mitochon	d
mitochond	r
mitochondr	i
mitochondri	a
mitochondria	l
mitos	ei
mitose	s
mitosi	s
mitot	i
mitoti	c
mitotic	a
mitotica	l
mitotical	l
mitoticall	y
mitr	ae
mitra	l
mitre	s
mits	u
mitsu	bo
mitsub	i
mitsubi	s
mitsubis	h
mitsubish	i
mitsuo	k
mitsuok	a
mitt	e
mitte	n
mitten	els
mittene	d
mittenl	i
mittenli	k
mittenlik	e
mitz	v
mitzv	a
mitzva	h
miu	eiptuy
miui	rv
miut	v
miuy	v
miv	prsv
miw	hipstz
miwi	flrsvw
miwp	v
miws	v
miwt	frsv
miwz	v
mix	aeimtu
mixa	b
mixab	il
mixabi	l
mixabil	i
mixabili	t
mixabilit	iy
mixabiliti	e
mixabilitie	s
mixabl	e
mixable	n
mixablen	e
mixablene	s
mixablenes	s
mixableness	e
mixablenesse	s
mixe	drs
mixed	ln
mixedl	y
mixedn	e
mixedne	s
mixednes	s
mixedness	e
mixednesse	s
mixer	s
mixi	bn
mixib	l
mixibl	e
mixin	g
mixt	u
mixtu	r
mixtur	e
mixture	s
mixu	p
miy	airtyz
miz	asz
miza	r
mizz	el
mizze	n
mizzl	e
mj	abdegjmnoqvz
mja	o
mjb	v
mje	dz
mjed	v
mjg	n
mjgn	v
mjj	rv
mjm	b
mjmb	v
mjn	v
mjo	u
mjq	abs
mk	abdeijklmnrvw
mkb	l
mkd	i
mkdi	r
mkj	v
mkk	d
mkl	brv
mkn	v
mkr	l
ml	abdehklnoqrstuwxy
mla	rv
mld	jr
mle	ovw
mleo	v
mlk	rsv
mll	b
mln	v
mlo	em
mlq	v
mlr	buv
mlru	v
mls	bhs
mlu	lv
mlx	u
mly	y
mm	abcdefghijklmnprtuvwy
mma	d
mmad	v
mmb	p
mmc	s
mmf	v
mmi	pz
mmip	v
mml	rv
mmm	uv
mmn	fiorv
mmp	v
mmr	rv
mmt	p
mmv	fmqu
mmw	v
mn	abcdefghlmnorstvy
mna	v
mnb	fimorw
mnc	pr
mnd	lv
mne	bemoqv
mnem	o
mnemo	n
mnemon	i
mnemoni	cs
mnemonic	as
mnemonica	l
mnemonical	l
mnemonicall	y
mnemonis	t
mneo	v
mnf	oprv
mnh	ot
mnl	i
mnm	rv
mnn	ep
mno	v
mnr	fmorsvw
mnrr	v
mns	b
mny	o
mo	abcdefghijklmnopqrstuvwxyz
moa	nt
moan	efis
moane	dr
moaner	s
moanf	u
moanfu	l
moanful	l
moanfull	y
moani	n
moanin	g
moat	eils
moate	d
moati	n
moatin	g
moatl	i
moatli	k
moatlik	e
mob	bcilosy
mobb	ei
mobbe	dr
mobber	s
mobbi	ns
mobbin	g
mobbis	hmt
mobbish	n
mobbishn	e
mobbishne	s
mobbishnes	s
mobbishness	e
mobbishnesse	s
mobbism	s
mobbist	s
mobc	a
mobca	p
mobi	al
mobil	ei
mobile	hs
mobileh	o
mobileho	m
mobilehom	e
mobilehome	s
mobili	stz
mobilis	ei
mobilise	ds
mobilisi	n
mobilisin	g
mobilit	iy
mobiliti	e
mobilitie	s
mobiliz	aei
mobiliza	t
mobilizat	i
mobilizati	o
mobilizatio	n
mobilize	drs
mobilizer	s
mobilizi	n
mobilizin	g
mobl	i
mobli	k
moblik	e
mobo	cd
moboc	r
mobocr	a
mobocra	c
mobocrac	y
mobod	a
mobs	t
mobst	e
mobste	r
moc	achk
mocc	a
mocca	s
moccas	i
moccasi	n
moccasin	s
moch	a
mock	aeisu
mocka	bg
mockab	l
mockabl	e
mockag	e
mocke	drs
mocker	iy
mockeri	e
mockerie	s
mockes	t
mocki	n
mockin	g
mocking	bl
mockingb	i
mockingbi	r
mockingbir	d
mockingl	y
mocku	p
mod	abeisu
moda	l
modal	ils
modali	t
modalit	iy
modaliti	e
modalitie	s
modall	y
modb	u
modbu	s
mode	lmnrs
model	eils
modele	drs
modeler	s
modeles	s
modeli	nz
modelin	g
modeling	s
modeliz	e
modell	ei
modelle	dr
modeller	s
modelli	n
modellin	g
modem	eis
modeme	d
modemi	n
modemin	g
moden	a
moder	an
modera	t
moderat	eio
moderate	dlns
moderatel	y
moderaten	e
moderatene	s
moderatenes	s
moderateness	e
moderatenesse	s
moderati	no
moderatin	g
moderatio	n
moderation	is
moderationi	s
moderationis	t
moderato	r
moderator	s
modern	eilns
moderne	rs
modernes	t
moderni	stz
modernis	eimt
modernise	ds
modernisi	n
modernisin	g
modernist	i
modernisti	c
modernit	iy
moderniti	e
modernitie	s
moderniz	aei
moderniza	bt
modernizab	l
modernizabl	e
modernizat	i
modernizati	o
modernizatio	n
modernize	drs
modernizer	s
modernizi	n
modernizin	g
modernl	y
modernn	e
modernne	s
modernnes	s
modernness	e
modernnesse	s
modes	t
modest	elnoy
modeste	rs
modestes	t
modestl	y
modestn	e
modestne	s
modestnes	s
modi	cfs
modic	u
modicu	m
modif	iy
modifi	ace
modifia	b
modifiab	il
modifiabi	l
modifiabil	i
modifiabili	t
modifiabilit	iy
modifiabiliti	e
modifiabilitie	s
modifiabl	e
modifiable	n
modifiablen	e
modifiablene	s
modifiablenes	s
modifiableness	e
modifiablenesse	s
modific	a
modifica	t
modificat	i
modificati	o
modificatio	n
modification	s
modifie	drs
modifier	s
modify	i
modifyi	n
modifyin	g
modis	ht
modist	e
modu	ls
modul	aeiou
modula	rt
modular	ils
modulari	tz
modularit	iy
modulariti	e
modularitie	s
modulariz	aei
modulariza	t
modularizat	i
modularizati	o
modularizatio	n
modularize	ds
modularizi	n
modularizin	g
modularl	y
modulat	eio
modulate	ds
modulati	no
modulatin	g
modulatio	n
modulation	s
modulato	r
modulator	sy
module	s
modulu	s
moe	n
mof	u
mog	agh
moga	d
mogad	i
mogadi	s
mogadis	ch
mogadisc	i
mogadisci	o
mogadish	u
mogg	y
mogh	u
moghu	l
moh	aor
moha	imw
mohai	r
mohair	s
moham	m
mohamm	e
mohamme	d
mohammed	a
mohammeda	n
mohammedan	i
mohammedani	sz
mohammedanis	m
mohammedaniz	ae
mohammedaniza	t
mohammedanizat	i
mohammedanizati	o
mohammedanizatio	n
mohammedanization	s
mohammedanize	s
mohaw	k
moho	g
mohog	a
mohoga	n
mohogan	y
moi	elnrs
moie	t
moiet	y
moin	e
moine	s
moir	e
mois	et
moise	y
moisey	e
moiseye	v
moist	eflnu
moiste	nrs
moistes	t
moistf	u
moistfu	l
moistl	ey
moistle	s
moistles	s
moistn	e
moistne	s
moistnes	s
moistness	e
moistnesse	s
moistu	r
moistur	ei
moisture	ps
moisturep	r
moisturepr	o
moisturepro	o
moistureproo	f
moisturi	sz
moisturis	ei
moisturise	drs
moisturisi	n
moisturisin	g
moisturiz	ei
moisturize	drs
moisturizer	s
moisturizi	n
moisturizin	g
moj	aio
moja	v
mojav	e
moji	t
mojit	o
mok	e
mol	adeilotuy
mola	rs
molar	isy
molari	t
molarit	i
molariti	e
molaritie	s
molas	s
molass	e
molasse	s
molasses	e
molassese	s
mold	abeiosy
molda	bv
moldab	il
moldabi	l
moldabil	i
moldabili	t
moldabilit	iy
moldabiliti	e
moldabilitie	s
moldabl	e
moldav	i
moldavi	a
moldb	o
moldbo	a
moldboa	r
moldboar	d
molde	dr
molder	s
moldi	en
moldie	rs
moldies	t
moldin	eg
moldine	s
moldines	s
moldiness	e
moldinesse	s
moldo	v
moldov	a
mole	chs
molec	u
molecu	l
molecul	ae
molecula	r
molecule	s
moleh	i
molehi	l
molehil	l
moles	kt
molesk	i
moleski	n
molest	aefis
molesta	t
molestat	i
molestati	o
molestatio	n
molestation	s
moleste	dr
molester	s
molestf	u
molestfu	l
molesti	nv
molestin	g
molestiv	e
moli	en
molie	r
molier	e
molin	eg
moll	iuy
molli	ef
mollif	iy
mollifi	ace
mollifia	b
mollifiab	l
mollifiabl	e
mollific	a
mollifica	t
mollificat	i
mollificati	o
mollificatio	n
mollification	s
mollifie	drs
mollifier	s
mollify	i
mollifyi	n
mollifyin	g
mollifying	l
mollifyingl	y
mollu	s
mollus	ck
mollusc	os
mollusco	i
molluscoi	d
molly	c
mollyc	o
mollyco	d
mollycod	d
mollycodd	l
mollycoddl	e
molo	ct
moloc	h
moloch	i
molochi	z
molochiz	e
molochize	s
molot	o
moloto	v
molt	eis
molte	dnr
molten	l
moltenl	y
molter	s
molti	n
moltin	g
molu	c
moluc	c
molucc	a
molucca	s
moly	b
molyb	d
molybd	e
molybde	n
molybden	iu
molybdeni	t
molybdenit	e
molybdenu	m
mom	eimos
mome	n
momen	t
moment	alosu
momenta	r
momentar	iy
momentari	ln
momentaril	y
momentarin	e
momentarine	s
momentarines	s
momentariness	e
momentarinesse	s
momentl	y
momento	u
momentou	s
momentous	ln
momentousl	y
momentousn	e
momentousne	s
momentousnes	s
momentousness	e
momentousnesse	s
momentu	m
momentum	s
momi	s
momis	m
momm	aiy
mommi	e
mommie	s
mon	acdefgikmorstuv
mona	cdrstu
monac	o
monad	ei
monade	l
monadel	p
monadelp	h
monadelph	o
monadelpho	u
monadelphou	s
monadi	cs
monadis	m
monar	c
monarc	h
monarch	aisy
monarcha	l
monarchal	l
monarchall	y
monarchi	es
monarchie	s
monarchis	mt
monas	ht
monast	ei
monaste	r
monaster	iy
monasteri	ae
monasteria	l
monasterie	s
monasti	c
monastic	i
monastici	s
monasticis	m
monat	o
monato	m
monatom	i
monatomi	c
monau	r
monaur	a
monaura	l
monc	o
monco	m
moncom	b
moncomb	u
moncombu	s
moncombus	t
moncombust	i
moncombusti	b
moncombustib	l
moncombustibl	e
mond	aeio
monda	y
monday	is
mondayi	s
mondayis	h
mondayish	n
mondayishn	e
mondayishne	s
mondayishnes	s
mondi	a
mondia	l
mone	lrty
moner	o
monet	ai
moneta	r
monetar	iy
monetari	as
monetaria	n
monetaris	m
moneti	sz
monetis	e
monetiz	ae
monetiza	t
monetizat	i
monetizati	o
monetizatio	n
money	beglmsw
moneyb	a
moneyba	g
moneybag	s
moneye	ds
moneyes	t
moneyg	r
moneygr	u
moneygru	b
moneygrub	b
moneygrubb	e
moneygrubbe	r
moneyl	e
moneyle	n
moneylen	d
moneylend	e
moneylende	r
moneym	a
moneyma	n
moneyw	i
moneywi	z
monf	o
monfo	r
monfor	t
mong	eor
monge	r
mongo	dlo
mongod	b
mongol	ios
mongoli	as
mongolia	n
mongolian	i
mongoliani	s
mongolianis	m
mongolis	m
mongolo	i
mongoloi	d
mongoo	s
mongoos	e
mongoose	s
mongr	e
mongre	l
mongrel	dilns
mongreld	o
mongreldo	m
mongreli	sz
mongrelis	m
mongrelism	s
mongreliz	aei
mongreliza	t
mongrelizat	i
mongrelizati	o
mongrelizatio	n
mongrelization	s
mongrelize	ds
mongrelizi	n
mongrelizin	g
mongrell	y
mongreln	e
mongrelne	s
mongrelnes	s
mongrelness	e
mongrelnesse	s
moni	cest
monic	ak
monick	e
monicke	r
monie	s
monis	mt
monit	ior
moniti	o
monitio	n
monito	r
monitor	eisy
monitore	d
monitori	n
monitorin	g
monitors	h
monitorsh	i
monitorshi	p
monitorship	s
monitr	i
monitri	x
monk	dehis
monkd	o
monkdo	m
monke	ry
monker	y
monkey	eis
monkeye	d
monkeyi	ns
monkeyin	g
monkeyis	h
monkeyish	ln
monkeyishl	y
monkeyishn	e
monkeyishne	s
monkeyishnes	s
monkeyishness	e
monkeyishnesse	s
monkeys	h
monkeysh	i
monkeyshi	n
monkeyshin	e
monkh	o
monkho	o
monkhoo	d
monki	s
monkis	hm
monm	o
monmo	u
monmou	t
monmout	h
mono	abcdefgilmnprstuvxz
monoa	l
monoal	p
monoalp	h
monoalph	a
monoalpha	b
monoalphab	e
monoalphabe	t
monoalphabet	i
monoalphabeti	c
monob	a
monoba	s
monobas	i
monobasi	c
monoc	aehiloruy
monoca	r
monocar	b
monocarb	o
monocarbo	n
monocarbon	a
monocarbona	t
monocarbonat	e
monoce	lnr
monocel	l
monocell	u
monocellu	l
monocellul	a
monocellula	r
monocen	t
monocent	r
monocentr	i
monocentri	c
monocer	o
monocero	s
monoch	or
monocho	r
monochor	d
monochr	o
monochro	m
monochrom	aeioy
monochroma	t
monochromat	io
monochromati	c
monochromato	r
monochrome	s
monochromi	ces
monochromic	a
monochromica	l
monochromical	l
monochromicall	y
monochromie	s
monochromis	t
monochromist	s
monochromo	u
monochromou	s
monoci	s
monocis	t
monocist	r
monocistr	o
monocistro	n
monocistron	i
monocistroni	c
monocl	eo
monoclo	n
monoclon	a
monoclona	l
monoco	nqrt
monocon	ds
monocond	y
monocondy	l
monocondyl	i
monocondyli	ac
monocondylia	n
monocons	o
monoconso	n
monoconson	a
monoconsona	n
monoconsonan	t
monoconsonant	a
monoconsonanta	l
monocoq	u
monocoqu	e
monocor	m
monocorm	i
monocormi	c
monocot	y
monocoty	l
monocotyl	e
monocotyle	d
monocotyled	o
monocotyledo	n
monocr	aoy
monocra	ct
monocrac	y
monocro	pt
monocrop	p
monocropp	i
monocroppi	n
monocroppin	g
monocropping	s
monocrot	i
monocroti	c
monocry	s
monocrys	t
monocryst	a
monocrysta	l
monocrystal	l
monocrystall	i
monocrystalli	n
monocrystallin	e
monocu	l
monocul	at
monocula	r
monocult	u
monocultu	r
monocultur	aei
monocultura	l
monocultural	l
monoculturall	y
monoculture	s
monoculturi	s
monoculturis	t
monocy	t
monocyt	e
monod	eiy
monode	n
monoden	t
monodent	a
monodenta	t
monodentat	e
monodi	ams
monodia	l
monodial	e
monodiale	c
monodialec	t
monodialect	a
monodialecta	l
monodim	e
monodime	n
monodimen	s
monodimens	i
monodimensi	o
monodimensio	n
monodimension	a
monodimensiona	l
monodis	t
monoe	nt
monoen	e
monoene	r
monoener	g
monoenerg	e
monoenerge	t
monoenerget	i
monoenergeti	c
monoet	h
monoeth	a
monoetha	n
monoethan	o
monoethano	l
monoethanol	a
monoethanola	m
monoethanolam	i
monoethanolami	n
monoethanolamin	e
monof	i
monofi	e
monofie	r
monog	alry
monoga	m
monogam	ioy
monogami	ces
monogamic	a
monogamica	l
monogamical	l
monogamicall	y
monogamie	s
monogamis	t
monogamo	u
monogamou	s
monogamous	l
monogamousl	y
monogl	ay
monogla	c
monoglac	i
monoglaci	a
monoglacia	l
monoglacial	i
monoglaciali	s
monoglacialis	mt
monogly	c
monoglyc	e
monoglyce	r
monoglycer	i
monoglyceri	d
monoglycerid	e
monogr	a
monogra	mp
monogram	s
monograp	h
monograph	eis
monographe	rs
monographi	c
monogy	n
monogyn	y
monoi	d
monol	io
monoli	nt
monolin	g
monoling	u
monolingu	a
monolingua	l
monolingual	ils
monolinguali	s
monolingualis	m
monolingualism	s
monolinguall	y
monolit	h
monolith	ais
monolitha	l
monolithi	cs
monolithis	m
monolithism	s
monolo	bg
monolob	u
monolobu	l
monolobul	a
monolobula	r
monolog	isu
monologi	asz
monologia	n
monologis	et
monologist	s
monologiz	e
monologu	ei
monologue	ds
monologui	ns
monologuin	g
monologuis	t
monologuist	s
monom	aeio
monoma	n
monoman	i
monomani	a
monomania	c
monomaniac	a
monomaniaca	l
monome	nr
monomen	i
monomeni	s
monomenis	c
monomenisc	o
monomenisco	u
monomeniscou	s
monomi	acn
monomia	l
monomic	t
monomict	i
monomicti	c
monomin	e
monomine	r
monominer	a
monominera	l
monomineral	i
monominerali	c
monomo	l
monomol	e
monomole	c
monomolec	u
monomolecu	l
monomolecul	a
monomolecula	r
monon	gu
monong	a
mononga	h
monongah	e
monongahe	l
monongahel	a
mononu	c
mononuc	l
mononucl	e
mononucle	o
mononucleo	s
mononucleos	i
mononucleosi	s
monop	hlort
monoph	ot
monopho	bn
monophob	i
monophobi	a
monophon	ei
monophoni	c
monopht	h
monophth	a
monophtha	l
monophthal	m
monophthalm	i
monophthalmi	c
monopl	ao
monopla	n
monoplan	e
monoplo	i
monoploi	d
monopo	l
monopol	eioy
monopoli	esz
monopolie	s
monopolis	eit
monopolise	drs
monopolisi	n
monopolisin	g
monopolist	i
monopolisti	c
monopoliz	aei
monopoliza	bt
monopolizab	l
monopolizabl	e
monopolizat	i
monopolizati	o
monopolizatio	n
monopolization	s
monopolize	drs
monopolizer	s
monopolizi	n
monopolizin	g
monopolo	i
monopoloi	d
monopr	o
monopro	g
monoprog	r
monoprogr	a
monoprogra	m
monoprogram	m
monoprogramm	ei
monoprogramme	d
monoprogrammi	n
monoprogrammin	g
monopt	e
monopte	r
monopter	o
monoptero	u
monopterou	s
monor	ac
monora	i
monorai	l
monorail	s
monorc	h
monorch	i
monorchi	s
monos	pty
monosp	ao
monospa	c
monospac	e
monospace	d
monospo	r
monospor	eo
monosporo	u
monosporou	s
monost	a
monosta	bt
monostab	l
monostabl	e
monostat	i
monostati	c
monosy	ls
monosyl	l
monosyll	a
monosylla	b
monosyllab	il
monosyllabi	c
monosyllabic	ai
monosyllabica	l
monosyllabical	l
monosyllabicall	y
monosyllabici	t
monosyllabicit	iy
monosyllabiciti	e
monosyllabicitie	s
monosyllabl	e
monosyllable	s
monosys	t
monosyst	e
monosyste	m
monosystem	i
monosystemi	c
monot	hor
monoth	e
monothe	irt
monothei	s
monotheis	mt
monotheist	i
monotheisti	c
monother	a
monothera	p
monotherap	y
monothet	i
monotheti	c
monothetic	a
monothetica	l
monothetical	l
monotheticall	y
monoto	nw
monoton	eioy
monotoni	ces
monotonic	ai
monotonica	l
monotonical	l
monotonicall	y
monotonici	t
monotonicit	y
monotonie	s
monotonis	t
monotono	u
monotonou	s
monotonous	ln
monotonousl	y
monotonousn	e
monotonousne	s
monotonousnes	s
monotonousness	e
monotonousnesse	s
monotow	e
monotowe	r
monotr	eo
monotre	m
monotrem	e
monotro	cp
monotroc	h
monotroch	a
monotrocha	l
monotrop	h
monotroph	i
monotrophi	c
monou	r
monour	a
monoura	i
monourai	l
monov	u
monovu	l
monovul	a
monovula	r
monox	ei
monoxe	n
monoxen	o
monoxeno	u
monoxenou	s
monoxi	d
monoxid	e
monoz	y
monozy	g
monozyg	o
monozygo	st
monozygos	i
monozygosi	t
monozygosit	y
monozygot	i
monozygoti	c
monr	o
monro	ev
monroe	i
monroei	s
monroeis	m
monrov	i
monrovi	a
mons	aotv
monsa	n
monsan	t
monsant	o
monso	o
monsoo	n
monsoon	ais
monsoona	l
monsooni	s
monsoonis	h
monst	er
monste	r
monster	ls
monsterl	i
monsterli	k
monsterlik	e
monstr	o
monstro	su
monstros	i
monstrosi	t
monstrosit	iy
monstrositi	e
monstrositie	s
monstrou	s
monstrous	ln
monstrousl	y
monstrousn	e
monstrousne	s
monstrousnes	s
monstrousness	e
monstrousnesse	s
monsv	e
monsve	n
monsven	e
monsvene	r
monsvener	i
monsveneri	s
mont	abceghimprsy
monta	gin
montag	eu
montagu	e
montai	g
montaig	n
montaign	e
montan	ae
montana	n
montb	l
montbl	a
montbla	n
montblan	c
montc	l
montcl	a
montcla	i
montclai	r
monte	nrv
monten	e
montene	g
monteneg	r
montenegr	io
montenegri	n
monter	e
montere	y
montev	ei
monteve	r
montever	d
monteverd	i
montevi	d
montevid	e
montevide	o
montg	o
montgo	m
montgom	e
montgome	r
montgomer	y
month	els
monthe	r
monthl	iy
monthli	e
monthlie	rs
monthlies	t
monti	c
montic	e
montice	l
monticel	l
monticell	o
montm	a
montma	r
montmar	t
montmart	r
montmartr	e
montp	e
montpe	l
montpel	i
montpeli	e
montpelie	r
montr	ae
montra	c
montrac	h
montrach	e
montrache	t
montre	a
montrea	l
monts	e
montse	r
montser	r
montserr	a
montserra	t
monu	m
monum	e
monume	n
monumen	t
monument	aeils
monumenta	l
monumental	il
monumentali	st
monumentalis	m
monumentalism	s
monumentalit	iy
monumentaliti	e
monumentalitie	s
monumentall	y
monumente	d
monumenti	n
monumentin	g
monumentl	e
monumentle	s
monumentles	s
moo	cdeijlmnorst
mooc	h
mooch	e
mooche	r
mood	isy
moodi	eln
moodie	rs
moodies	t
moodil	y
moodin	e
moodine	s
moodines	s
moodiness	e
moodinesse	s
mooe	d
mooi	n
mooin	g
mool	a
moon	bcefilrsy
moonb	e
moonbe	a
moonbea	m
moonc	a
moonca	l
mooncal	f
moone	dry
mooner	s
moonf	i
moonfi	s
moonfis	h
mooni	ns
moonin	g
mooning	l
mooningl	y
moonis	h
moonl	ei
moonle	st
moonles	s
moonli	gkt
moonlig	h
moonligh	t
moonlight	eis
moonlighte	dr
moonlighter	s
moonlighti	n
moonlightin	g
moonlik	e
moonr	i
moonri	s
moonris	e
moons	cht
moonsc	a
moonsca	p
moonscap	e
moonsh	i
moonshi	np
moonshin	e
moonshine	r
moonst	or
moonsto	n
moonston	e
moonstr	u
moonstru	c
moonstruc	k
moor	aehils
moora	g
moorag	e
moore	ds
moores	s
moorh	e
moorhe	n
moori	ens
moorie	rs
moories	t
moorin	g
mooring	s
mooris	h
moorl	a
moorla	n
moorlan	d
moos	e
mop	ehiops
mope	drs
moped	s
moper	s
moph	e
mophe	a
mophea	d
mopi	eln
mopie	rs
mopies	t
mopil	y
mopin	g
moping	l
mopingl	y
mopo	k
mopok	e
mopp	ei
moppe	drt
mopper	s
moppi	n
moppin	g
moq	u
moqu	e
moque	t
moquet	t
moquett	e
mor	abdegilmnoprst
mora	ilnstvy
morai	n
morain	e
moraine	s
moral	eils
morale	s
morali	stz
moralis	eimt
moralise	ds
moralisi	n
moralisin	g
moralising	l
moralisingl	y
moralist	i
moralisti	c
moralistic	a
moralistica	l
moralistical	l
moralisticall	y
moralit	iy
moraliti	e
moralitie	s
moraliz	aei
moraliza	t
moralizat	i
moralizati	o
moralizatio	n
moralization	s
moralize	drs
moralizer	s
moralizi	n
moralizin	g
moralizing	l
moralizingl	y
morall	ey
moralle	r
moras	s
morat	o
morato	r
morator	i
moratori	au
moratoriu	m
moratorium	s
morav	i
moravi	a
moravia	n
moravian	i
moraviani	z
moravianiz	e
moravianize	d
moravianized	s
morb	i
morbi	df
morbid	iln
morbidi	t
morbidit	y
morbidl	y
morbidn	e
morbidne	s
morbidnes	s
morbidness	e
morbidnesse	s
morbif	i
morbifi	c
mord	ae
morda	cn
mordac	i
mordaci	o
mordacio	u
mordaciou	s
mordan	ct
mordanc	y
morde	n
morden	t
more	dhlnos
moreh	o
moreho	u
morehou	s
morehous	e
morel	a
morela	n
morelan	d
moren	e
morene	s
morenes	s
moreness	e
morenesse	s
moreo	v
moreov	e
moreove	r
mores	b
moresb	y
morg	au
morga	n
morgan	a
morgana	t
morganat	i
morganati	c
morgu	e
morgue	ls
morguel	i
morgueli	k
morguelik	e
mori	abo
moria	r
moriar	t
moriart	y
morib	u
moribu	n
moribun	d
morio	n
morl	e
morle	y
morm	o
mormo	n
morn	i
morni	n
mornin	g
morning	ls
morningl	ey
morningle	s
morningles	s
moro	cns
moroc	c
morocc	ao
morocca	n
moron	is
moroni	cst
moronic	a
moronica	l
moronical	l
moronicall	y
moronis	m
moronism	s
moronit	iy
moroniti	e
moronitie	s
moros	ei
morose	ln
morosel	y
morosen	e
morosene	s
morosenes	s
moroseness	e
morosenesse	s
morosi	t
morosit	iy
morositi	e
morositie	s
morp	h
morph	eio
morphe	mu
morphem	e
morpheu	s
morphi	ans
morphin	aei
morphina	t
morphinat	e
morphinate	d
morphine	ds
morphini	cs
morphinis	t
morphis	m
morphism	s
morpho	l
morphol	o
morpholo	g
morpholog	iy
morphologi	cesz
morphologic	a
morphologica	l
morphological	l
morphologicall	y
morphologie	s
morphologis	t
morphologist	s
morphologiz	ae
morphologiza	t
morphologizat	i
morphologizati	o
morphologizatio	n
morr	io
morri	ls
morril	l
morris	ost
morriso	n
morriss	e
morrisse	y
morrist	o
morristo	w
morristow	n
morro	w
mors	e
morse	cl
morsec	o
morseco	d
morsecod	e
morsel	eils
morsele	d
morseli	nz
morselin	g
morseliz	ae
morseliza	t
morselizat	i
morselizati	o
morselizatio	n
morsell	ei
morselle	d
morselli	n
morsellin	g
mort	aegiouy
morta	lr
mortal	ils
mortali	stz
mortalis	mt
mortalit	iy
mortaliti	e
mortalitie	s
mortaliz	e
mortall	y
mortar	beilsy
mortarb	o
mortarbo	a
mortarboa	r
mortarboar	d
mortare	d
mortari	n
mortarin	g
mortarl	e
mortarle	s
mortarles	s
morte	m
mortg	a
mortga	g
mortgag	ei
mortgage	ades
mortgagea	b
mortgageab	l
mortgageabl	e
mortgagi	n
mortgagin	g
morti	cfms
mortic	ei
mortice	ds
mortici	an
morticia	n
mortician	s
morticin	g
mortif	iy
mortifi	ce
mortific	a
mortifica	t
mortificat	i
mortificati	o
mortificatio	n
mortifie	drs
mortifier	s
mortify	i
mortifyi	n
mortifyin	g
mortifying	l
mortifyingl	y
mortim	e
mortime	r
mortis	ei
mortise	drs
mortiser	s
mortisi	n
mortisin	g
morto	n
mortu	a
mortua	r
mortuar	iy
mortuari	e
mortuarie	s
mos	acelqst
mosa	i
mosai	c
mosaic	aeikls
mosaica	l
mosaical	l
mosaicall	y
mosaice	d
mosaici	n
mosaicin	g
mosaick	ei
mosaicke	d
mosaicki	n
mosaickin	g
mosaicl	i
mosaicli	k
mosaiclik	e
mosc	ho
mosch	i
moschi	n
moschin	o
mosco	nw
moscon	e
mose	rsy
mosl	e
mosle	m
moslem	is
moslemi	z
moslemiz	e
moslemize	s
mosq	u
mosqu	ei
mosque	s
mosqui	t
mosquit	ao
mosquita	l
mosquito	es
mosquitoe	s
moss	beiy
mossb	ae
mossba	c
mossbac	k
mossbe	r
mossber	g
mosse	ds
mossi	n
mossin	eg
mossine	s
mossines	s
most	ls
mostl	y
mot	ehilorstv
mote	lt
motel	is
moteli	e
motelie	r
moth	beilsy
mothb	a
mothba	l
mothbal	l
mothball	eis
mothballe	d
mothballi	n
mothballin	g
mothe	r
mother	befhils
motherb	o
motherbo	a
motherboa	r
motherboar	d
motherboard	s
mothere	dr
motherer	s
motherf	u
motherfu	c
motherfuc	k
motherfuck	ei
motherfucke	r
motherfucker	s
motherfucki	n
motherfuckin	g
motherh	o
motherho	o
motherhoo	d
motherhood	s
motheri	n
motherin	g
motherl	aeiy
motherla	n
motherlan	d
motherland	s
motherle	s
motherles	s
motherless	n
motherlessn	e
motherlessne	s
motherlessnes	s
motherlessness	e
motherlessnesse	s
motherli	n
motherlin	eg
motherline	s
motherlines	s
motherliness	e
motherlinesse	s
mothers	h
mothersh	i
mothershi	p
mothi	e
mothie	rs
mothies	t
mothl	i
mothli	k
mothlik	e
moti	flov
motif	is
motifi	c
motil	ei
motili	t
motilit	y
motio	n
motion	aeils
motiona	b
motionab	l
motionabl	e
motione	dr
motioner	s
motioni	n
motionin	g
motionl	e
motionle	s
motionles	s
motionless	ln
motionlessl	y
motionlessn	e
motionlessne	s
motionlessnes	s
motionlessness	e
motionlessnesse	s
motiv	aei
motiva	t
motivat	eio
motivate	ds
motivati	no
motivatin	g
motivatio	n
motivation	as
motivationa	l
motivato	r
motivator	s
motive	dls
motivel	e
motivele	s
motiveles	s
motiveless	ln
motivelessl	y
motivelessn	e
motivelessne	s
motivelessnes	s
motivelessness	e
motivelessnesse	s
motivi	nt
motivin	g
motivit	y
motl	e
motle	y
moto	rt
motor	bcdeiosw
motorb	io
motorbi	ck
motorbic	y
motorbicy	c
motorbicyc	l
motorbicycl	ei
motorbicycle	ds
motorbicycli	n
motorbicyclin	g
motorbik	ei
motorbike	drs
motorbiker	s
motorbiki	n
motorbikin	g
motorbo	a
motorboa	t
motorboat	i
motorboati	no
motorboatin	g
motorboatio	n
motorc	ay
motorca	dr
motorcad	e
motorcar	s
motorcy	c
motorcyc	l
motorcycl	ei
motorcycle	ds
motorcycli	s
motorcyclis	t
motorcyclist	s
motord	or
motordo	m
motordom	s
motordr	o
motordro	m
motordrom	e
motore	d
motori	nsz
motorin	g
motoring	s
motoris	et
motorise	d
motorist	s
motoriz	aei
motoriza	t
motorizat	i
motorizati	o
motorizatio	n
motorize	ds
motorizi	n
motorizin	g
motoro	l
motorol	a
motors	p
motorsp	o
motorspo	r
motorspor	t
motorsport	s
motorw	a
motorwa	y
motorway	s
motot	r
mototr	b
mototrb	o
motr	i
motri	x
mott	elo
motte	s
mottes	t
mottl	e
mottle	d
motto	es
mottoe	ds
mou	elnrstv
moul	dt
mould	aeisy
moulda	b
mouldab	il
mouldabi	l
mouldabil	i
mouldabili	t
mouldabilit	y
mouldabl	e
mouldable	n
mouldablen	e
mouldablene	s
mouldablenes	s
moulde	dr
mouldi	n
mouldin	g
moult	eios
moulte	dnr
moulti	n
moultin	g
moulto	n
moun	dt
mound	eisy
mounde	d
moundi	n
moundin	g
mount	aeils
mounta	bi
mountab	l
mountabl	e
mountai	n
mountain	elost
mountaine	e
mountainee	r
mountaineer	is
mountaineeri	n
mountaineerin	g
mountaineering	s
mountainl	e
mountainle	s
mountainles	s
mountaino	u
mountainou	s
mountainous	ln
mountainousl	y
mountainousn	e
mountainousne	s
mountainousnes	s
mountainousness	e
mountainousnesse	s
mountains	i
mountainsi	d
mountainsid	e
mountainside	s
mountaint	o
mountainto	p
mounte	bdr
mounteb	a
mounteba	n
mounteban	k
mounter	s
mounti	n
mountin	g
mounting	s
mountl	e
mountle	s
mountles	s
mour	n
mourn	efis
mourne	dr
mourner	s
mournf	u
mournfu	l
mournful	ln
mournfull	ey
mournfulle	rs
mournfulles	t
mournfuln	e
mournfulne	s
mournfulnes	s
mournfulness	e
mournfulnesse	s
mourni	n
mournin	g
mourning	l
mourningl	y
mous	eisty
mouse	dklorst
mousek	i
mouseki	n
mousel	ei
mousele	t
mouseli	kn
mouselik	e
mouselin	g
mouseo	v
mouseov	e
mouseove	r
mouses	h
mousesh	i
mouseshi	p
mouset	r
mousetr	a
mousetra	p
mousi	n
mousin	eg
mousine	s
mousines	s
mouss	ei
mousse	ds
moussi	n
moussin	g
moust	a
mousta	c
moustac	h
moustach	e
moustache	ls
moustachel	e
moustachele	s
moustacheles	s
mout	ho
mouth	aefilpsy
moutha	b
mouthab	l
mouthabl	e
mouthe	drs
mouther	s
mouthf	u
mouthfu	l
mouthful	s
mouthi	n
mouthin	eg
mouthine	s
mouthines	s
mouthing	l
mouthingl	y
mouthl	i
mouthli	k
mouthlik	e
mouthp	i
mouthpi	e
mouthpie	c
mouthpiec	e
mouthpiece	s
mouto	n
mov	aeiv
mova	b
movab	il
movabi	l
movabil	i
movabili	t
movabilit	iy
movabiliti	e
movabilitie	s
movabl	ey
movable	ns
movablen	e
movablene	s
movablenes	s
movableness	e
movablenesse	s
move	admrs
movea	b
moveab	l
moveabl	ey
moveable	s
movem	e
moveme	n
movemen	t
movement	s
mover	s
movi	en
movie	bdps
movieb	o
moviebo	t
movied	o
moviedo	m
moviep	i
moviepi	l
moviepil	o
moviepilo	t
movin	g
moving	lns
movingl	y
movingn	e
movingne	s
movingnes	s
mow	aeins
mowa	b
mowab	l
mowabl	e
mowe	dr
mower	s
mowi	n
mowin	g
mox	airv
moxi	be
moxib	u
moxibu	s
moxibus	t
moxibust	i
moxibusti	o
moxibustio	n
moy	e
moye	r
moz	aiz
moza	mr
mozam	b
mozamb	i
mozambi	q
mozambiq	u
mozambiqu	e
mozar	t
mozi	l
mozil	l
mozill	a
mozilla	f
mozillaf	i
mozillafi	r
mozillafir	e
mozillafire	f
mozillafiref	o
mozillafirefo	x
mozz	a
mozza	r
mozzar	e
mozzare	l
mozzarel	l
mozzarell	a
mp	abcdefghjlmnopqrstuvxyz
mpa	qz
mpb	d
mpd	dfrvw
mpdf	v
mpe	gv
mpf	d
mpfd	v
mpg	rv
mpj	v
mpl	asv
mpla	y
mplay	e
mplaye	r
mplayer	x
mpm	dft
mpmf	rv
mpn	f
mpp	d
mpq	g
mpqg	v
mpr	c
mpv	s
mpx	v
mq	abdefhilmnortuvx
mqa	rv
mqar	v
mqb	brsv
mqe	er
mqi	v
mql	v
mqm	m
mqn	fr
mqnr	v
mqo	cv
mqr	b
mqu	c
mr	abcdefgijlmnopqrsuvwxz
mrb	blprv
mrd	d
mrdd	rv
mrf	dm
mrg	y
mri	rv
mrj	qv
mrl	qv
mrm	prs
mrn	abq
mro	bdrv
mrod	v
mrp	fq
mrr	jqv
mrs	st
mru	p
mrv	fu
mrw	w
mrx	ox
mrz	v
ms	acdegknopqrstuv
msa	tv
msat	a
msc	s
msd	n
mse	s
msg	s
msk	u
msn	bfqy
msnb	c
msny	rv
mso	w
msp	hnrsv
msq	j
mst	b
msu	v
msv	c
mt	adfgilmnopqrsuvwxz
mta	rv
mti	v
mtl	y
mtm	bfgw
mtmb	v
mtmf	v
mtn	bfrv
mtnf	v
mto	h
mtq	x
mtr	p
mtrp	v
mtu	p
mtx	v
mtz	f
mu	abcdefghijklmnopqrstuvxz
mua	c
mub	cp
muc	hikou
much	et
muche	s
mucht	e
muchte	l
muci	l
mucil	a
mucila	g
mucilag	ei
mucilagi	n
mucilagin	o
mucilagino	u
mucilaginou	s
muck	eirswy
mucke	dr
mucker	s
mucki	eln
muckie	rs
muckies	t
muckil	y
muckin	g
muckr	a
muckra	k
muckrak	e
muckrake	r
muckw	o
muckwo	r
muckwor	m
muco	su
mucos	i
mucosi	t
mucosit	y
mucou	s
mucu	s
mucus	e
mucuse	s
mud	dfglmsv
mudd	eily
mudde	d
muddi	elns
muddie	drs
muddies	t
muddil	y
muddin	eg
muddine	s
muddines	s
muddiness	e
muddinesse	s
muddis	h
muddl	eiy
muddle	dhmrs
muddled	ln
muddledl	y
muddledn	e
muddledne	s
muddlednes	s
muddledness	e
muddlednesse	s
muddleh	e
muddlehe	a
muddlehea	d
muddlehead	e
muddleheade	d
muddlem	e
muddleme	n
muddlemen	t
muddlement	s
muddler	s
muddli	n
muddlin	g
muddling	l
muddlingl	y
muddy	i
muddyi	n
muddyin	g
mudf	il
mudfi	s
mudfis	h
mudfl	a
mudfla	t
mudflat	s
mudg	u
mudgu	a
mudgua	r
mudguar	d
mudguard	s
mudl	e
mudle	s
mudles	s
mudm	v
muds	ilt
mudsi	l
mudsil	l
mudsl	i
mudsli	n
mudslin	g
mudsling	ei
mudslinge	r
mudslingi	n
mudslingin	g
mudst	o
mudsto	n
mudston	e
mudv	a
mudva	y
mudvay	n
mudvayn	e
mue	lnsvz
muel	l
muell	e
muelle	r
muen	s
muens	t
muenst	e
muenste	r
mues	l
muesl	i
muesli	s
muez	z
muezz	i
muezzi	n
muezzin	s
muf	dft
muff	ils
muffi	n
muffin	s
muffl	ei
muffle	drs
muffled	l
muffledl	y
muffler	es
mufflere	d
muffli	n
mufflin	g
muft	i
mug	fgsw
mugf	u
mugfu	l
mugful	s
mugg	eiy
mugge	de
muggee	s
muggi	eln
muggie	rs
muggies	t
muggil	y
muggin	egs
muggine	s
muggines	s
mugginess	e
mugginesse	s
mugs	f
mugsf	u
mugsfu	l
mugw	o
mugwo	r
mugwor	t
muh	a
muha	m
muham	m
muhamm	a
muhamma	d
muhammad	is
muhammadi	s
muhammadis	m
mui	r
muk	dl
mukd	e
mukde	n
mukl	u
muklu	k
mul	abceilt
mula	t
mulat	t
mulatt	o
mulb	e
mulbe	r
mulber	r
mulberr	iy
mulberri	e
mulberrie	s
mulc	ht
mulch	ei
mulche	ds
mulchi	n
mulchin	g
mule	dsy
muli	ns
mulin	g
mulis	h
mull	aeis
mulla	h
mulle	nrt
mulli	gno
mullig	a
mulliga	n
mullin	g
mullio	n
mullion	e
mullione	d
mult	ai
multa	n
multan	g
multang	u
multangu	l
multangul	a
multangula	r
multi	abcdefghjlmnoprstuvwy
multia	grtu
multiag	e
multiage	n
multiagen	c
multiagenc	y
multiar	mt
multiarm	e
multiarme	d
multiart	i
multiarti	c
multiartic	u
multiarticu	l
multiarticul	a
multiarticula	t
multiarticulat	e
multiarticulate	d
multiat	o
multiato	m
multiau	t
multiaut	h
multiauth	o
multiautho	r
multiauthor	e
multiauthore	d
multib	ailruy
multiba	nr
multiban	k
multibar	r
multibarr	e
multibarre	l
multibarrel	e
multibarrele	d
multibi	lrt
multibil	l
multibill	i
multibilli	o
multibillio	n
multibillion	as
multibilliona	i
multibillionai	r
multibillionair	e
multibillionaire	s
multibir	t
multibirt	h
multibirth	s
multibl	a
multibla	d
multiblad	e
multiblade	s
multibr	a
multibra	n
multibran	c
multibranc	h
multibranch	e
multibranche	d
multibu	ist
multibui	l
multibuil	d
multibuild	i
multibuildi	n
multibuildin	g
multibus	i
multibusi	n
multibusin	e
multibusine	s
multibusines	s
multibut	t
multibutt	o
multibutto	n
multiby	t
multibyt	e
multic	aehilorsuy
multica	mnrsu
multicam	p
multicamp	u
multicampu	s
multican	d
multicand	i
multicandi	d
multicandid	a
multicandida	t
multicandidat	e
multicar	b
multicarb	o
multicarbo	n
multicas	t
multicast	is
multicasti	n
multicastin	g
multicau	s
multicaus	a
multicausa	l
multice	ln
multicel	l
multicell	eu
multicelle	d
multicellu	l
multicellul	a
multicellula	r
multicellular	i
multicellulari	t
multicellularit	iy
multicellulariti	e
multicellularitie	s
multicen	t
multicent	r
multicentr	a
multicentra	l
multich	ar
multicha	mnr
multicham	b
multichamb	e
multichambe	r
multichamber	e
multichambere	d
multichan	n
multichann	e
multichanne	l
multichannel	el
multichannele	d
multichannell	e
multichannelle	d
multichar	a
multichara	c
multicharac	t
multicharact	e
multicharacte	r
multichr	o
multichro	m
multichrom	e
multichrome	s
multici	rt
multicir	c
multicirc	u
multicircu	i
multicircui	t
multicircuit	es
multicircuite	d
multicit	y
multicl	i
multicli	e
multiclie	n
multiclien	t
multico	almnrsu
multicoa	t
multicoat	e
multicoate	d
multicol	ou
multicolo	r
multicolor	s
multicolu	m
multicolum	n
multicom	p
multicomp	ou
multicompo	n
multicompon	e
multicompone	n
multicomponen	t
multicompu	t
multicomput	e
multicompute	r
multicon	di
multicond	u
multicondu	c
multiconduc	t
multiconduct	o
multiconducto	r
multiconi	c
multicor	enp
multicorn	e
multicorne	a
multicornea	l
multicorp	o
multicorpo	r
multicorpor	a
multicorpora	t
multicorporat	i
multicorporati	o
multicorporatio	n
multicorporation	s
multicos	t
multicost	a
multicosta	t
multicostat	e
multicou	nr
multicoun	t
multicount	y
multicour	s
multicours	e
multicourse	s
multicr	y
multicry	s
multicrys	t
multicryst	a
multicrysta	l
multicrystal	l
multicrystall	i
multicrystalli	n
multicrystallin	e
multicu	lrs
multicul	t
multicult	u
multicultu	r
multicultur	ae
multicultura	l
multicultural	il
multiculturali	s
multiculturalis	mt
multiculturalism	s
multiculturalist	s
multiculturall	y
multiculture	s
multicur	r
multicurr	e
multicurre	n
multicurren	c
multicurrenc	iy
multicurrenci	e
multicurrencie	s
multicus	p
multicusp	i
multicuspi	d
multicuspid	a
multicuspida	t
multicuspidat	e
multicy	c
multicyc	l
multicycl	i
multicycli	c
multid	aeirw
multida	y
multide	ns
multiden	o
multideno	m
multidenom	i
multidenomi	n
multidenomin	a
multidenomina	t
multidenominat	i
multidenominati	o
multidenominatio	n
multidenomination	a
multidenominationa	l
multides	t
multidest	i
multidesti	n
multidestin	a
multidestina	t
multidestinat	i
multidestinati	o
multidestinatio	n
multidi	amrsv
multidia	l
multidial	e
multidiale	c
multidialec	t
multidialect	a
multidialecta	l
multidialectal	i
multidialectali	s
multidialectalis	m
multidim	e
multidime	n
multidimen	s
multidimens	i
multidimensi	o
multidimensio	n
multidimension	a
multidimensiona	l
multidimensional	i
multidimensionali	t
multidimensionalit	iy
multidimensionaliti	e
multidimensionalitie	s
multidir	e
multidire	c
multidirec	t
multidirect	i
multidirecti	o
multidirectio	n
multidirection	a
multidirectiona	l
multidis	c
multidisc	i
multidisci	p
multidiscip	l
multidiscipl	i
multidiscipli	n
multidisciplin	ae
multidisciplina	r
multidisciplinar	y
multidiscipline	ds
multidiv	i
multidivi	s
multidivis	i
multidivisi	o
multidivisio	n
multidivision	a
multidivisiona	l
multidr	u
multidru	g
multidw	e
multidwe	l
multidwel	l
multidwell	i
multidwelli	n
multidwellin	g
multidwelling	s
multie	lmnx
multiel	e
multiele	cm
multielec	t
multielect	r
multielectr	o
multielectro	d
multielectrod	e
multielem	e
multieleme	n
multielemen	t
multielement	s
multiem	p
multiemp	l
multiempl	o
multiemplo	y
multiemploy	e
multiemploye	r
multiemployer	s
multien	g
multieng	i
multiengi	n
multiengin	e
multiengine	s
multiex	h
multiexh	a
multiexha	u
multiexhau	s
multiexhaus	t
multiexhaust	s
multif	aeoru
multifa	cr
multifac	e
multiface	t
multifacet	e
multifacete	d
multifar	i
multifari	o
multifario	u
multifariou	s
multife	at
multifea	t
multifeat	u
multifeatu	r
multifeatur	e
multifeature	d
multifet	a
multifeta	t
multifetat	i
multifetati	o
multifetatio	n
multifo	r
multifor	m
multiform	i
multiformi	t
multiformit	y
multifr	eo
multifre	q
multifreq	u
multifrequ	e
multifreque	n
multifrequen	c
multifrequenc	y
multifro	n
multifron	t
multifu	n
multifun	c
multifunc	t
multifunct	i
multifuncti	o
multifunctio	n
multifunction	a
multifunctiona	l
multifunctional	i
multifunctionali	t
multifunctionalit	y
multig	aelr
multiga	u
multigau	g
multigaug	e
multige	n
multigen	ei
multigene	r
multigener	ai
multigenera	t
multigenerat	i
multigenerati	o
multigeneratio	n
multigeneration	a
multigenerationa	l
multigeneri	c
multigeni	c
multigl	a
multigla	z
multiglaz	e
multiglaze	d
multigr	aio
multigra	in
multigrai	n
multigrain	s
multigran	u
multigranu	l
multigranul	a
multigranula	r
multigri	d
multigro	u
multigrou	p
multih	aeou
multiha	n
multihan	d
multihand	i
multihandi	c
multihandic	a
multihandica	p
multihandicap	p
multihandicapp	e
multihandicappe	d
multihe	a
multihea	dr
multihead	es
multiheade	d
multihear	t
multiheart	h
multihearth	s
multiho	ms
multihom	e
multihome	r
multihos	p
multihosp	i
multihospi	t
multihospit	a
multihospita	l
multihu	e
multihue	d
multij	u
multiju	g
multijug	a
multijuga	t
multijugat	e
multil	aeio
multila	mnty
multilam	ei
multilame	l
multilamel	l
multilamell	ao
multilamella	rt
multilamellat	e
multilamello	u
multilamellou	s
multilami	n
multilamin	a
multilamina	rt
multilaminat	e
multilaminate	d
multilan	e
multilat	e
multilate	r
multilater	a
multilatera	l
multilateral	iln
multilaterali	sz
multilateralis	mt
multilateralism	s
multilateralist	s
multilateraliz	ae
multilateraliza	t
multilateralizat	i
multilateralizati	o
multilateralizatio	n
multilaterall	y
multilateraln	e
multilateralne	s
multilateralnes	s
multilay	e
multilaye	r
multilayer	e
multilayere	d
multile	v
multilev	e
multileve	l
multilevel	els
multilevele	d
multilevell	e
multilevelle	d
multili	n
multilin	eg
multiline	as
multilinea	r
multiling	u
multilingu	a
multilingua	l
multilingual	i
multilinguali	z
multilingualiz	a
multilingualiza	t
multilingualizat	i
multilingualizati	o
multilingualizatio	n
multilo	bc
multilob	eu
multilobe	ds
multilobu	l
multilobul	a
multilobula	r
multiloc	a
multiloca	t
multilocat	i
multilocati	o
multilocatio	n
multim	aeio
multima	m
multimam	m
multimamm	a
multimamma	t
multimammat	e
multime	dgmt
multimed	i
multimedi	a
multimedia	ls
multimeg	a
multimega	w
multimegaw	a
multimegawa	t
multimegawat	t
multimem	b
multimemb	e
multimembe	r
multimet	a
multimeta	l
multimetal	l
multimetall	i
multimetalli	c
multimi	l
multimil	l
multimill	ei
multimille	n
multimillen	n
multimillenn	i
multimillenni	a
multimillennia	l
multimilli	o
multimillio	n
multimillion	as
multimilliona	i
multimillionai	r
multimillionair	e
multimillionaire	s
multimillionaires	s
multimillionairess	e
multimillionairesse	s
multimo	dlt
multimod	ei
multimodi	n
multimodin	g
multimol	e
multimole	c
multimolec	u
multimolecu	l
multimolecul	a
multimolecula	r
multimot	o
multimoto	r
multimotor	s
multin	au
multina	t
multinat	i
multinati	o
multinatio	n
multination	a
multinationa	l
multinational	ils
multinationali	s
multinationalis	m
multinationalism	s
multinationall	y
multinu	c
multinuc	l
multinucl	e
multinucle	a
multinuclea	t
multinucleat	e
multinucleate	d
multio	rv
multior	g
multiorg	a
multiorga	ns
multiorgas	m
multiorgasm	i
multiorgasmi	c
multiov	u
multiovu	l
multiovul	a
multiovula	t
multiovulat	e
multiovulate	d
multip	aehiloru
multipa	gnrt
multipag	e
multipan	e
multipane	d
multipar	aot
multipara	m
multiparam	e
multiparame	t
multiparamet	e
multiparamete	r
multiparo	u
multiparou	s
multipart	i
multiparti	c
multipartic	l
multiparticl	e
multipat	h
multipath	s
multipe	drx
multiper	fis
multiperf	o
multiperfo	r
multiperfor	a
multiperfora	t
multiperforat	e
multiperi	l
multiperil	s
multipers	o
multiperso	n
multiperson	a
multipersona	l
multipex	e
multipexe	r
multiph	ao
multipha	s
multiphas	e
multiphase	d
multipho	t
multiphot	o
multiphoto	gn
multiphotog	r
multiphotogr	a
multiphotogra	p
multiphotograp	h
multiphotograph	iy
multiphotographi	e
multiphotographie	s
multiphoton	s
multipi	cen
multipic	t
multipict	u
multipictu	r
multipictur	e
multipie	c
multipiec	e
multipin	n
multipinn	a
multipinna	t
multipinnat	e
multipl	aeiy
multipla	ny
multiplan	aet
multiplana	r
multiplane	d
multiplay	e
multiplaye	r
multiple	sx
multiplex	eio
multiplexe	drs
multiplexer	s
multiplexi	nt
multiplexin	g
multiplexit	y
multiplexo	r
multiplexor	s
multipli	ce
multiplic	ai
multiplica	nt
multiplican	d
multiplicand	s
multiplicat	io
multiplicati	ov
multiplicatio	n
multiplication	s
multiplicativ	e
multiplicative	s
multiplicato	r
multiplici	t
multiplicit	y
multiplie	drs
multiplier	s
multiply	i
multiplyi	n
multiplyin	g
multipo	ilw
multipoi	n
multipoin	t
multipoint	e
multipointe	d
multipol	ae
multipola	r
multipole	s
multipow	e
multipowe	r
multipr	o
multipro	bcdg
multiprob	l
multiprobl	e
multiproble	m
multiproc	e
multiproce	s
multiproces	s
multiprocess	io
multiprocessi	n
multiprocessin	g
multiprocesso	r
multiprocessor	s
multiprod	u
multiprodu	c
multiproduc	t
multiprog	r
multiprogr	a
multiprogra	m
multiprogram	m
multiprogramm	ei
multiprogramme	d
multiprogrammi	n
multiprogrammin	g
multipu	r
multipur	p
multipurp	o
multipurpo	s
multipurpos	e
multir	aeo
multira	cdn
multirac	i
multiraci	a
multiracia	l
multirad	i
multiradi	ac
multiradia	t
multiradiat	e
multiradiate	d
multiradic	a
multiradica	l
multiran	g
multirang	e
multire	fgl
multiref	l
multirefl	e
multirefle	x
multireflex	e
multireflexe	s
multireg	i
multiregi	o
multiregio	n
multiregion	a
multiregiona	l
multirel	i
multireli	g
multirelig	i
multireligi	o
multireligio	u
multireligiou	s
multiro	o
multiroo	m
multis	eikopty
multise	acgpr
multisea	s
multiseas	o
multiseaso	n
multiseason	a
multiseasona	l
multisec	t
multisect	i
multisecti	o
multisectio	n
multisection	a
multisectiona	l
multiseg	m
multisegm	e
multisegme	n
multisegmen	t
multisegment	e
multisegmente	d
multisep	t
multisept	a
multisepta	t
multiseptat	e
multiser	iv
multiseri	ae
multiseria	l
multiserial	l
multiseriall	y
multiserie	s
multiseries	e
multiseriese	s
multiserv	i
multiservi	c
multiservic	e
multisi	dtz
multisid	e
multiside	d
multisit	e
multisiz	e
multisk	i
multiski	l
multiskil	l
multiskill	e
multiskille	d
multiso	nu
multison	aio
multisona	n
multisonan	t
multisoni	c
multisono	u
multisonou	s
multisou	r
multisour	c
multisourc	ei
multisource	ds
multisourci	n
multisourcin	g
multisp	eio
multispe	ce
multispec	i
multispeci	e
multispecie	s
multispee	d
multispi	r
multispir	a
multispira	l
multispo	r
multispor	t
multist	aeor
multista	bg
multistab	i
multistabi	l
multistabil	i
multistabili	t
multistabilit	y
multistag	e
multiste	mp
multistem	m
multistemm	e
multistemme	d
multisto	pr
multistor	iy
multistori	e
multistorie	d
multistr	a
multistra	n
multistran	d
multistrand	e
multistrande	d
multisy	ns
multisyn	c
multisys	t
multisyst	e
multisyste	m
multit	aehioru
multita	ls
multital	e
multitale	n
multitalen	t
multitalent	e
multitalente	d
multitas	k
multitask	eis
multitaske	dr
multitasker	s
multitaski	n
multitaskin	g
multitasking	s
multite	r
multiter	m
multiterm	i
multitermi	n
multitermin	a
multitermina	l
multith	r
multithr	e
multithre	a
multithrea	d
multiti	e
multitie	r
multitier	e
multitiere	d
multito	now
multiton	e
multitone	ds
multitoo	l
multitool	s
multitow	e
multitowe	r
multitower	e
multitowere	d
multitr	ai
multitra	c
multitrac	k
multitrack	eis
multitracke	d
multitracki	n
multitrackin	g
multitri	l
multitril	l
multitrill	i
multitrilli	o
multitrillio	n
multitrillion	s
multitu	bd
multitub	e
multitud	ei
multitude	s
multitudi	n
multitudin	o
multitudino	u
multitudinou	s
multiu	ns
multiun	i
multiuni	ot
multiunio	n
multius	e
multiuse	r
multiv	aeio
multiva	lrt
multival	ev
multivale	n
multivalen	ct
multivalenc	e
multivalv	e
multivar	i
multivari	ao
multivaria	nt
multivarian	t
multivariat	e
multivario	u
multivariou	s
multivat	o
multivato	r
multive	r
multiver	s
multivers	i
multiversi	t
multiversit	y
multivi	et
multivie	w
multivit	a
multivita	m
multivitam	i
multivitami	n
multivo	cil
multivoc	a
multivoca	l
multivoi	c
multivoic	e
multivoice	d
multivol	u
multivolu	m
multivolum	e
multiw	ao
multiwa	rv
multiwar	h
multiwarh	e
multiwarhe	a
multiwarhea	d
multiwav	e
multiwave	l
multiwavel	e
multiwavele	n
multiwavelen	g
multiwaveleng	t
multiwavelengt	h
multiwo	r
multiwor	d
multiy	e
multiye	a
multiyea	r
mum	befmprsv
mumb	al
mumba	i
mumbl	eiy
mumble	dmrst
mumblem	e
mumbleme	n
mumblemen	t
mumbler	s
mumblet	y
mumblety	p
mumbletyp	e
mumbletype	g
mumbli	n
mumblin	g
mumbling	ls
mumblingl	y
mume	t
mumet	a
mumeta	l
mumf	o
mumfo	r
mumfor	d
mumm	eiy
mumme	dr
mummer	y
mummi	efn
mummie	ds
mummif	iy
mummifi	c
mummific	a
mummifica	t
mummificat	i
mummificati	o
mummificatio	n
mummin	g
mummy	i
mummyi	n
mummyin	g
mump	is
mumpi	s
mumpis	h
mumps	e
mumpse	s
mun	cdfgirs
munc	hi
munch	aei
muncha	u
munchau	s
munchaus	e
munchause	n
munche	drs
muncher	s
munchi	en
munchie	s
munchin	g
munci	e
mund	at
munda	n
mundan	ei
mundane	ln
mundanel	y
mundanen	e
mundanene	s
mundanenes	s
mundaneness	e
mundanenesse	s
mundani	t
mundanit	iy
mundaniti	e
mundanitie	s
mung	o
muni	cfmt
munic	hi
munici	p
municip	a
municipa	l
municipal	ils
municipali	tz
municipalit	iy
municipaliti	e
municipalitie	s
municipaliz	ae
municipaliza	t
municipalizat	i
municipalizati	o
municipalizatio	n
municipalize	r
municipall	y
munif	i
munifi	c
munific	e
munifice	n
munificen	ct
munificenc	e
munim	e
munime	n
munimen	t
munit	i
muniti	o
munitio	n
munition	s
munr	o
munro	e
muns	eo
munse	y
munso	n
muo	n
muon	g
mur	adeikmprv
mura	kl
murak	a
muraka	m
murakam	i
mural	ils
murali	s
muralis	t
muralist	s
murall	y
murd	e
murde	r
murder	aeios
murdera	b
murderab	l
murderabl	e
murdere	drs
murderer	s
murderes	s
murderi	ns
murderin	g
murderis	h
murdero	u
murderou	s
murderous	ln
murderousl	y
murderousn	e
murderousne	s
murderousnes	s
murderousness	e
murderousnesse	s
mure	x
muri	en
murie	l
murin	e
murk	iy
murki	eln
murkie	rs
murkies	t
murkil	y
murkin	e
murkine	s
murkines	s
murkiness	e
murkinesse	s
murm	u
murmu	r
murmur	eilos
murmure	dr
murmurer	s
murmuri	ns
murmurin	g
murmuring	ls
murmuringl	y
murmuris	h
murmurl	e
murmurle	s
murmurles	s
murmurless	l
murmurlessl	y
murmuro	u
murmurou	s
murmurous	n
murmurousn	e
murmurousne	s
murmurousnes	s
murp	h
murph	y
murr	ao
murra	iy
murrai	n
murro	w
mus	cehiklqstv
musc	alou
musca	dt
muscad	i
muscadi	n
muscadin	e
muscl	ei
muscle	dls
musclel	e
musclele	s
muscleles	s
muscli	en
musclie	rs
musclies	t
musclin	g
musco	v
muscov	aiy
muscova	d
muscovad	o
muscovi	t
muscovit	e
muscu	l
muscul	a
muscula	rt
muscular	cil
muscularc	h
muscularch	r
muscularchr	i
muscularchri	s
muscularchris	t
muscularchrist	i
muscularchristi	a
muscularchristia	n
musculari	tz
muscularit	iy
musculariti	e
muscularitie	s
musculariz	e
muscularl	y
musculat	u
musculatu	r
musculatur	e
muse	dfrstu
musef	u
musefu	l
muser	s
muset	t
musett	e
museu	m
museum	is
museumi	s
museumis	h
mush	iry
mushi	l
mushil	y
mushr	o
mushro	o
mushroo	m
mushroom	eils
mushroome	dr
mushroomi	n
mushroomin	g
mushrooml	i
mushroomli	k
mushroomlik	e
musi	cnx
music	afiost
musica	l
musical	eilns
musicali	z
musicaliz	a
musicaliza	t
musicalizat	i
musicalizati	o
musicalizatio	n
musicall	y
musicaln	e
musicalne	s
musicalnes	s
musicalness	e
musicalnesse	s
musicf	r
musicfr	e
musicfre	e
musici	a
musicia	n
musician	els
musiciane	r
musicianl	y
musicians	h
musiciansh	i
musicianshi	p
musicianship	s
musico	lt
musicol	o
musicolo	g
musicolog	iy
musicologi	s
musicologis	t
musicot	h
musicoth	e
musicothe	r
musicother	a
musicothera	p
musicotherap	y
musict	e
musicte	l
musictel	e
musictele	v
musictelev	i
musictelevi	s
musictelevis	i
musictelevisi	o
musictelevisio	n
musin	g
musing	s
musix	m
musixm	a
musixma	t
musixmat	c
musixmatc	h
musk	eimorsy
muske	glt
muskeg	o
muskego	n
muskel	l
muskell	u
muskellu	n
muskellun	g
muskellung	e
musket	aers
musketa	d
musketad	e
muskete	e
musketee	r
musketr	y
muski	n
muskin	e
muskine	s
muskines	s
muskm	e
muskme	l
muskmel	o
muskmelo	n
musko	x
muskox	e
muskoxe	n
muskr	a
muskra	t
muskrat	s
musl	i
musli	mn
muslim	s
muslin	es
musline	dt
musq	u
musqu	a
musqua	s
musquas	h
muss	eioy
musse	l
mussel	ls
mussell	e
musselle	d
mussi	l
mussil	y
musso	lr
mussol	i
mussoli	n
mussolin	i
mussolini	s
mussor	g
mussorg	s
mussorgs	k
mussorgsk	y
must	aehisy
musta	cnr
mustac	h
mustach	e
mustache	ds
mustan	g
mustar	d
mustard	es
mustarde	r
muste	drs
muster	eis
mustere	d
musteri	n
musterin	g
mustes	t
musth	s
musti	eln
mustie	rs
musties	t
mustil	y
mustin	eg
mustine	s
mustines	s
mustiness	e
mustinesse	s
mut	aceiortu
muta	bgnt
mutab	il
mutabi	l
mutabil	i
mutabili	t
mutabilit	y
mutabl	e
mutable	n
mutablen	e
mutablene	s
mutablenes	s
mutag	e
mutage	n
mutagen	i
mutageni	c
mutan	dt
mutand	i
mutandi	s
mutant	s
mutat	ei
mutate	ds
mutati	nosv
mutatin	g
mutatio	n
mutation	ais
mutationa	l
mutational	l
mutationall	y
mutationi	s
mutationis	t
mutativ	e
mutc	h
mute	dlnrsx
muted	l
mutedl	y
mutel	y
muten	e
mutene	s
mutenes	s
muteness	e
mutenesse	s
mutes	t
muti	lns
mutil	a
mutila	t
mutilat	eio
mutilate	ds
mutilati	nov
mutilatin	g
mutilatio	n
mutilation	s
mutilativ	e
mutilato	r
mutilator	sy
mutin	egioy
mutine	e
mutinee	r
mutini	e
mutinie	ds
mutino	u
mutinou	s
mutiny	i
mutinyi	n
mutinyin	g
mutis	m
muto	s
mutos	c
mutosc	o
mutosco	p
mutoscop	e
mutt	eo
mutte	r
mutter	eis
muttere	dr
mutterer	s
mutteri	n
mutterin	g
muttering	l
mutteringl	y
mutto	n
mutton	esy
muttone	d
mutu	a
mutua	l
mutual	ilns
mutuali	st
mutualis	m
mutualit	y
mutuall	y
mutualn	e
mutualne	s
mutualnes	s
muu	m
muum	u
muumu	u
muv	v
muz	aeoz
muza	k
muzz	ly
muzzl	ei
muzzle	drs
muzzler	s
muzzli	n
muzzlin	g
mv	acefnopvxz
mve	rv
mvf	f
mvn	d
mvv	m
mvz	v
mw	dgjnosuwx
mwg	o
mwn	v
mwo	s
mwu	u
mww	f
mwwf	v
mwx	v
mx	adefjlmpuvx
mxd	v
mxf	p
mxp	l
mxpl	a
mxpla	y
mxplay	e
mxplaye	r
mxu	p
mxx	n
my	abcdegiknoprstuwxyz
mya	n
myan	m
myanm	a
myanma	r
myb	apwy
myba	t
mybat	i
mybati	s
myc	eo
myce	lnt
mycel	i
myceli	au
mycelia	l
myceliu	m
mycen	a
mycena	e
mycenae	a
mycenaea	n
mycet	o
myceto	z
mycetoz	o
mycetozo	a
mycetozoa	n
myco	ls
mycol	o
mycolo	g
mycolog	iy
mycologi	s
mycologis	t
mycos	i
mycosi	s
myd	ov
mydo	v
mye	lr
myel	i
myeli	nt
myelin	eis
myeline	s
myelini	c
myelit	i
myeliti	s
myer	s
myg	o
myi	s
myis	a
myisa	m
myk	r
mykr	o
mykro	n
mykron	o
mykrono	z
myn	ah
mynh	e
mynhe	e
mynhee	r
myo	ckopw
myoc	a
myoca	r
myocar	d
myocard	i
myocardi	a
myocardia	l
myok	i
myoki	n
myokin	e
myokine	s
myokines	i
myokinesi	m
myokinesim	e
myokinesime	t
myokinesimet	e
myokinesimete	r
myoo	v
myop	ei
myopi	acs
myopia	s
myopic	a
myopica	l
myopical	l
myopicall	y
myopis	m
myp	df
mypd	v
myr	aimoprty
myri	a
myria	dp
myriap	o
myriapo	d
myrm	i
myrmi	d
myrmid	o
myrmido	n
myro	n
myrr	h
myrt	l
myrtl	e
mys	eiopqrtv
myse	l
mysel	f
mysi	m
mysim	o
mysimo	n
myso	r
mysor	e
mysp	a
myspa	c
myspac	e
mysq	l
myst	ei
myste	r
myster	iy
mysteri	eo
mysterie	ds
mysterio	u
mysteriou	s
mysterious	ln
mysteriousl	y
mysteriousn	e
mysteriousne	s
mysteriousnes	s
mysteriousness	e
mysteriousnesse	s
mysti	cfq
mystic	ails
mystica	l
mystical	iln
mysticali	t
mysticalit	iy
mysticaliti	e
mysticalitie	s
mysticall	y
mysticaln	e
mysticalne	s
mysticalnes	s
mysticalness	e
mysticalnesse	s
mystici	st
mysticis	m
mysticism	s
mysticit	iy
mysticiti	e
mysticitie	s
mysticl	y
mystif	iy
mystifi	ce
mystific	a
mystifica	t
mystificat	i
mystificati	o
mystificatio	n
mystifie	drs
mystified	l
mystifiedl	y
mystifier	s
mystify	i
mystifyi	n
mystifyin	g
mystifying	l
mystifyingl	y
mystiq	u
mystiqu	e
mystique	s
myt	h
myth	eilos
mythe	ms
mythem	e
mythi	c
mythic	ai
mythica	l
mythical	ln
mythicall	y
mythicaln	e
mythicalne	s
mythicalnes	s
mythicalness	e
mythicalnesse	s
mythici	s
mythicis	m
mythl	e
mythle	s
mythles	s
mytho	ls
mythol	o
mytholo	g
mytholog	eiy
mythologe	r
mythologer	s
mythologi	ces
mythologic	a
mythologica	l
mythologie	s
mythologis	t
mythologist	s
myu	f
myuf	v
myx	o
myxo	m
myxom	a
myy	v
myz	u
mz	efjnoqvx
mze	z
mzf	bt
mzj	v
mzo	rv
mzq	f
