n	abcdefghijklmnopqrstuvwxyz
na	adejkloqvxy
naa	rv
nad	v
nae	fmru
naj	qw
nak	p
nao	v
naq	nq
nax	x
nb	abcdefghijklmnopqrstuvwxyz
nba	defnrsvy
nbaf	v
nbb	efmosuwz
nbbf	v
nbc	cdeu
nbcd	v
nbd	bgprsv
nbe	bdefhorsuv
nbee	rv
nber	v
nbeu	v
nbf	dils
nbg	gnosv
nbgg	v
nbh	cdrsv
nbi	fklv
nbj	bdj
nbk	rsv
nbl	dlvx
nbm	dghmu
nbn	fglrsvw
nbnf	rv
nbo	brv
nbp	bcdhopqrstvz
nbq	ortv
nbr	bgp
nbs	oqt
nbso	v
nbt	fuv
nbu	ehtu
nbue	v
nbuh	v
nbuu	rv
nbv	f
nbw	dfuy
nbwu	rv
nby	bilmxyz
nbz	j
nc	abejlmnpqrtuw
nca	rv
ncb	gk
nce	w
ncl	v
ncm	b
ncmb	v
ncn	f
ncp	fghkrv
ncq	d
ncr	adfsw
nct	b
ncu	h
nd	abcdefgijlmnoqstvwxy
ndb	s
ndc	a
ndca	v
ndd	n
nde	z
ndf	u
ndi	l
ndl	brsvx
ndn	l
ndq	l
nds	crw
ndt	o
ndto	v
ndx	v
ndy	v
ne	abdeghijkmnopqtvwz
nea	v
neb	v
ned	e
nede	v
nee	emrsv
nei	v
nej	v
nek	v
nen	befpv
neo	qvw
neoq	frsv
nep	f
neq	abqv
net	v
nev	mou
new	f
nez	bt
nf	abcdefghjklmnoprstuvwz
nfa	v
nfb	fhirsv
nfc	w
nfd	rvwx
nfe	dkw
nff	dh
nfg	r
nfk	bv
nfl	prv
nfm	fp
nfn	bcfrsv
nfo	forw
nfp	bnox
nfr	u
nfs	u
nft	o
nfu	p
nfv	z
ng	aefgilnpqrtwxy
nge	buv
ngf	f
ngi	rv
ngl	v
ngn	f
ngnf	rv
ngp	t
ngq	b
ngr	cv
ngt	bv
ngw	o
ngy	s
nh	afjmnopu
nhf	fhit
nhft	v
nhm	b
nhn	q
nho	forvw
nhp	ceqy
ni	ijmoqrvw
nii	v
nim	b
nio	v
niq	i
nj	abcehijlmnopqrtyz
nja	v
njb	hqv
njc	s
nje	z
njl	k
njm	bf
njmb	v
njn	fv
njo	z
njq	h
njr	bs
nk	abelnvwxz
nka	rsv
nke	bv
nkl	rv
nkn	b
nknb	v
nkv	b
nkvb	v
nkw	bu
nkx	rv
nkz	v
nl	abdegjklmnopqrtuvy
nla	dv
nlb	iw
nld	aj
nle	v
nlj	rv
nlk	v
nln	f
nlp	btv
nlr	biuw
nlt	r
nlu	l
nlv	d
nly	a
nm	bcdefghjlnpqrvx
nmc	s
nmd	v
nme	v
nmj	s
nmn	fqrsv
nmp	v
nmq	rv
nn	abcdefhlmnoprvx
nnb	dfp
nnbp	v
nnc	ap
nnca	v
nnd	l
nne	qrv
nner	v
nnf	hpv
nnh	h
nnl	ip
nnn	dp
nno	bp
nnr	df
nnx	p
no	abcdehijklmnoprtvwx
noa	e
nob	abprv
nobb	v
nobp	v
noc	c
nocc	v
noe	s
noj	v
nok	a
nol	frv
nom	b
non	f
noo	jrstv
nooj	v
nop	o
nor	b
nov	rv
nox	bp
np	adefghjlortuvx
npd	cftuv
npe	u
npf	d
npg	g
npo	bhtv
npob	v
npoh	v
npt	bd
npv	f
npx	rv
nq	bhijklnoquvxy
nqh	v
nqi	l
nql	v
nqn	u
nqq	l
nr	abcdefghijklmnopqrstuvwxyz
nra	defnorsvy
nraf	v
nrb	bfswz
nrbf	v
nrc	cdeu
nrcd	v
nrd	bdgnps
nrdd	v
nre	bdefhlorsuvw
nreb	v
nree	v
nreu	v
nrf	abdefiv
nrfb	v
nrg	gnosv
nrh	d
nri	fkv
nrj	bjv
nrl	dlrsvx
nrm	adghmru
nrmr	v
nrn	fglqrsv
nrnf	rv
nro	bfv
nrp	cdhopqrstvz
nrq	forstv
nrr	abfgpruv
nrrg	v
nrru	v
nrs	befoqtv
nrso	v
nrt	bv
nru	ehtuv
nrue	v
nruh	v
nruu	rv
nrv	fv
nrw	duy
nrwu	rv
nry	bilmxyz
nrz	jrv
ns	aejkmnopqrtuw
nsa	rv
nse	r
nsk	a
nsm	brt
nsmb	rsv
nsn	h
nso	o
nsu	v
nsw	v
nt	abdfimnqt
ntd	d
ntf	t
nti	rv
ntm	bd
ntn	frv
ntq	b
nu	abdejmuv
nua	v
nub	e
nud	m
nuu	m
nv	defmnosuv
nvd	mv
nve	rsv
nvf	f
nvm	v
nvn	f
nvnf	v
nvo	rv
nvu	v
nw	aejmnopru
nwe	u
nwn	rv
nwo	s
nwp	t
nx	elrux
nxe	v
nxl	rv
nxu	eruv
nxx	fqrsv
ny	ejoprsvwy
nyo	befmvw
nyp	dz
nypd	v
nyw	f
nyy	a
nz	degjmopt
nzd	p
nze	z
nzm	b
nzmb	v
nzt	b
