o	abcdefghijklmnopqrstuvwxyz
oa	abdefhijklmnopqrstuvxy
oaa	rsv
oad	bkopv
oadk	v
oae	v
oaf	i
oafi	s
oafis	h
oah	u
oai	v
oaj	aq
oajq	v
oak	elmpsuw
oake	n
oakl	ae
oakla	n
oaklan	d
oakle	ty
oakm	o
oakmo	n
oakmon	t
oaku	m
oakw	o
oakwo	o
oakwoo	d
oal	v
oan	v
oao	behr
oap	sv
oaq	degos
oaqe	v
oar	ails
oara	g
oarag	e
oari	n
oarin	g
oarl	i
oarli	k
oarlik	e
oars	m
oarsm	a
oarsma	n
oas	aeit
oasa	l
oase	as
oasea	n
oasi	st
oasit	i
oasiti	c
oat	cehmrsv
oatc	a
oatca	k
oatcak	e
oate	n
oath	s
oatm	e
oatme	a
oatmea	l
oatmeal	s
oau	r
oaur	v
oax	i
oaxi	s
oay	bho
ob	abcdefghijklmnopqrstuvwxy
oba	prtv
obb	loy
obbl	i
obbli	g
obblig	a
obbliga	t
obbligat	o
obc	g
obd	u
obdu	r
obdur	a
obdura	bct
obdurab	i
obdurabi	l
obdurabil	i
obdurabili	t
obdurabilit	y
obdurac	y
obdurat	e
obe	adfilrsuwy
obea	h
obed	i
obedi	e
obedie	n
obedien	ct
obedienc	e
obedience	s
obedient	ln
obedientl	y
obedientn	e
obedientne	s
obedientnes	s
obei	s
obeis	a
obeisa	n
obeisan	c
obeisanc	e
obel	i
obeli	s
obelis	k
ober	lo
oberl	i
oberli	n
obero	n
obes	ei
obese	ln
obesel	y
obesen	e
obesene	s
obesenes	s
obeseness	e
obesenesse	s
obesi	t
obesit	y
obey	aeis
obeya	bn
obeyab	l
obeyabl	e
obeyan	c
obeyanc	e
obeye	dr
obeyer	s
obeyi	en
obeyie	n
obeyien	t
obeyin	g
obeying	l
obeyingl	y
obf	uv
obfu	s
obfus	c
obfusc	a
obfusca	t
obfuscat	eio
obfuscati	o
obfuscatio	n
obfuscato	r
obfuscator	y
obg	no
obh	iuv
obi	rtv
obit	u
obitu	a
obitua	r
obituar	eiy
obituare	s
obituares	e
obituari	aelsz
obituaria	ln
obituarie	s
obituaril	y
obituaris	t
obituarist	s
obituariz	e
obj	eu
obje	c
objec	t
object	aeilos
objecta	bn
objectab	l
objectabl	e
objectan	t
objecte	de
objecti	fnov
objectif	y
objectin	g
objectio	n
objection	ais
objectiona	bl
objectionab	il
objectionabi	l
objectionabil	i
objectionabili	t
objectionabilit	i
objectionabiliti	e
objectionabilitie	s
objectionabl	ey
objectionable	n
objectionablen	e
objectionablene	s
objectionablenes	s
objectionableness	e
objectionablenesse	s
objectioni	s
objectionis	t
objectiv	aei
objectiva	l
objective	lns
objectivel	y
objectiven	e
objectivene	s
objectivenes	s
objectiveness	e
objectivenesse	s
objectivi	t
objectivit	iy
objectiviti	e
objectivitie	s
objectl	e
objectle	s
objectles	s
objectless	n
objectlessn	e
objectlessne	s
objectlessnes	s
objectlessness	e
objectlessnesse	s
objecto	r
objector	s
obju	r
objur	g
objurg	a
objurga	t
objurgat	ei
objurgati	o
objurgatio	n
obk	iru
obl	aiouv
obla	t
oblat	eio
oblati	o
oblatio	n
oblato	r
oblator	y
obli	gqtv
oblig	aeio
obliga	t
obligat	eio
obligate	d
obligati	o
obligatio	n
obligation	as
obligationa	l
obligato	r
obligator	iy
obligatori	ln
obligatoril	y
obligatorin	e
obligatorine	s
obligatorines	s
obligatoriness	e
obligatorinesse	s
oblige	ders
obliged	ln
obligedl	y
obligedn	e
obligedne	s
obligednes	s
obligedness	e
obligednesse	s
obliger	s
obligi	n
obligin	g
obliging	l
obligingl	y
obligo	r
obliq	u
obliqu	eio
oblique	dlns
obliquel	y
obliquen	e
obliquene	s
obliquenes	s
obliqueness	e
obliquenesse	s
obliqui	nt
obliquin	g
obliquit	oy
obliquito	u
obliquitou	s
obliquo	u
obliquou	s
oblit	e
oblite	r
obliter	a
oblitera	bt
obliterab	l
obliterabl	e
obliterat	eio
obliterate	ds
obliterati	no
obliteratin	g
obliterating	l
obliteratingl	y
obliteratio	n
obliteration	s
obliterato	r
obliterator	s
obliv	i
oblivi	o
oblivio	nu
oblivion	is
oblivioni	z
oblivioniz	e
obliviou	s
oblivious	ln
obliviousl	y
obliviousn	e
obliviousne	s
obliviousnes	s
obliviousness	e
obliviousnesse	s
oblo	nq
oblon	g
oblong	ilns
oblongi	s
oblongis	h
oblongl	y
oblongn	e
oblongne	s
oblongnes	s
oblongness	e
oblongnesse	s
obloq	u
obloqu	y
obm	u
obmu	t
obmut	e
obmute	s
obmutes	c
obmutesc	e
obmutesce	n
obmutescen	c
obmutescenc	e
obn	loprv
obnl	v
obno	x
obnox	i
obnoxi	eot
obnoxie	t
obnoxiet	y
obnoxio	u
obnoxiou	s
obnoxious	ln
obnoxiousl	y
obnoxiousn	e
obnoxiousne	s
obnoxiousnes	s
obnoxiousness	e
obnoxiousnesse	s
obnoxit	y
obnp	v
obo	eilrv
oboe	s
oboi	s
obois	t
oboist	s
obp	d
obq	d
obs	ceiot
obsc	eu
obsce	n
obscen	ei
obscene	lnrs
obscenel	y
obscenen	e
obscenene	s
obscenenes	s
obsceneness	e
obscenenesse	s
obscenes	t
obsceni	t
obscenit	iy
obsceniti	e
obscenitie	s
obscu	r
obscur	aei
obscura	nt
obscuran	t
obscurant	i
obscuranti	s
obscurantis	m
obscurat	i
obscurati	o
obscuratio	n
obscuration	s
obscure	dlmnrs
obscured	l
obscuredl	y
obscurel	y
obscurem	e
obscureme	n
obscuremen	t
obscuren	e
obscurene	s
obscurenes	s
obscureness	e
obscurenesse	s
obscures	t
obscuri	fnt
obscurif	y
obscurin	g
obscurit	iy
obscuriti	e
obscuritie	s
obse	cqrs
obsec	r
obsecr	a
obsecra	t
obsecrat	i
obsecrati	o
obsecratio	n
obseq	u
obsequ	i
obsequi	eo
obsequie	s
obsequio	u
obsequiou	s
obser	v
observ	aei
observa	bnt
observab	il
observabi	l
observabil	i
observabili	t
observabilit	y
observabl	ey
observan	ct
observanc	e
observance	s
observant	ils
observanti	n
observantin	e
observantine	s
observantl	y
observat	io
observati	o
observatio	n
observation	as
observationa	l
observational	l
observationall	y
observato	r
observator	iy
observatori	e
observatorie	s
observe	drs
observed	l
observedl	y
observer	s
observers	h
observersh	i
observershi	p
observership	s
observi	n
observin	g
observing	l
observingl	y
obses	s
obsess	eio
obsesse	ds
obsessi	nov
obsessin	g
obsessing	l
obsessingl	y
obsessio	n
obsession	ais
obsessiona	l
obsessional	l
obsessionall	y
obsessioni	s
obsessionis	t
obsessiv	e
obsessive	lns
obsessivel	y
obsessiven	e
obsessivene	s
obsessivenes	s
obsessiveness	e
obsessivenesse	s
obsesso	r
obsessor	s
obsi	d
obsid	i
obsidi	a
obsidia	n
obso	l
obsol	e
obsole	st
obsoles	c
obsolesc	e
obsolesce	n
obsolescen	ct
obsolescenc	e
obsolet	ei
obsolete	dlns
obsoletel	y
obsoleten	e
obsoletene	s
obsoletenes	s
obsoleteness	e
obsoletenesse	s
obsoleti	no
obsoletin	g
obsoletio	n
obst	aeir
obsta	c
obstac	lu
obstacl	e
obstacle	s
obstacu	l
obstacul	a
obstacula	r
obste	t
obstet	r
obstetr	i
obstetri	c
obstetric	is
obstetrici	a
obstetricia	n
obstetrician	s
obstetrics	e
obstetricse	s
obsti	n
obstin	a
obstina	ct
obstinac	y
obstinat	e
obstinate	ln
obstinatel	y
obstinaten	e
obstinatene	s
obstinatenes	s
obstinateness	e
obstinatenesse	s
obstr	eu
obstre	p
obstrep	e
obstrepe	r
obstreper	o
obstrepero	u
obstreperou	s
obstru	c
obstruc	t
obstruct	eios
obstructe	dr
obstructed	l
obstructedl	y
obstructer	s
obstructi	nov
obstructin	g
obstructing	l
obstructingl	y
obstructio	n
obstruction	as
obstructiona	r
obstructionar	y
obstructiv	ei
obstructive	lns
obstructivel	y
obstructiven	e
obstructivene	s
obstructivenes	s
obstructiveness	e
obstructivenesse	s
obstructivi	t
obstructivit	iy
obstructiviti	e
obstructivitie	s
obstructo	r
obstructor	s
obt	aehoru
obta	i
obtai	n
obtain	aeims
obtaina	bl
obtainab	il
obtainabi	l
obtainabil	i
obtainabili	t
obtainabilit	iy
obtainabiliti	e
obtainabilitie	s
obtainabl	ey
obtaine	dr
obtainer	s
obtaini	n
obtainin	g
obtainm	e
obtainme	n
obtainmen	t
obtainment	s
obte	s
obtes	t
obtest	a
obtesta	t
obtestat	i
obtestati	o
obtestatio	n
obtr	u
obtru	ds
obtrud	e
obtrus	i
obtrusi	ov
obtrusio	n
obtrusiv	e
obtu	ns
obtun	d
obtus	ei
obtuse	lnrs
obtusel	y
obtusen	e
obtusene	s
obtusenes	s
obtuseness	e
obtusenesse	s
obtuses	t
obtusi	t
obtusit	y
obu	e
obv	eiv
obve	r
obver	st
obvers	ei
obversi	o
obversio	n
obvi	ao
obvia	t
obviat	ei
obviate	ds
obviati	no
obviatin	g
obviatio	n
obviation	s
obvio	u
obviou	s
obvious	ln
obviousl	y
obviousn	e
obviousne	s
obviousnes	s
obviousness	e
obviousnesse	s
obw	fu
obx	cv
oc	acdefghjlmnopqrstuvwx
oca	mrv
ocam	l
ocar	i
ocari	n
ocarin	a
occ	ailu
occa	ms
occas	i
occasi	o
occasio	n
occasion	aeis
occasiona	l
occasional	iln
occasionali	st
occasionalis	t
occasionalist	i
occasionalisti	c
occasionalit	i
occasionaliti	e
occasionalitie	s
occasionall	y
occasionaln	e
occasionalne	s
occasionalnes	s
occasionalness	e
occasionalnesse	s
occasione	dr
occasioni	n
occasionin	g
occasioning	s
occi	dp
occid	e
occide	n
occiden	t
occident	a
occidenta	l
occidental	is
occidentali	z
occidentaliz	aei
occidentaliza	t
occidentalizat	i
occidentalizati	o
occidentalizatio	n
occidentalization	s
occidentalize	ds
occidentalizi	n
occidentalizin	g
occip	iu
occipi	t
occipit	a
occipita	l
occipu	t
occl	u
occlu	ds
occlud	e
occlude	ds
occlus	i
occlusi	ov
occlusio	n
occlusion	s
occlusiv	e
occu	lpr
occul	t
occult	aeilns
occulta	t
occultat	i
occultati	o
occultatio	n
occulte	dr
occulter	s
occulti	ns
occultin	g
occultis	m
occultl	y
occultn	e
occultne	s
occultnes	s
occultness	e
occultnesse	s
occup	aiy
occupa	nt
occupan	ct
occupanc	iy
occupanci	e
occupancie	s
occupant	s
occupat	i
occupati	ov
occupatio	n
occupation	als
occupationa	l
occupational	l
occupationall	y
occupationl	e
occupationle	s
occupationles	s
occupativ	e
occupi	ae
occupia	b
occupiab	l
occupiabl	e
occupie	drs
occupier	s
occupy	i
occupyi	n
occupyin	g
occur	rs
occurr	ei
occurre	dn
occurren	ct
occurrenc	ey
occurrence	s
occurri	n
occurrin	g
ocd	j
oce	abelquv
ocea	n
ocean	bfgilos
oceanb	a
oceanba	s
oceanbas	e
oceanf	u
oceanfu	l
oceang	o
oceango	i
oceangoi	n
oceangoin	g
oceani	acd
oceanic	a
oceanica	l
oceanical	l
oceanicall	y
oceanl	i
oceanli	k
oceanlik	e
oceano	gl
oceanog	r
oceanogr	a
oceanogra	p
oceanograp	h
oceanograph	eiy
oceanographe	r
oceanographer	s
oceanographi	ce
oceanographic	a
oceanographica	l
oceanographical	l
oceanographicall	y
oceanographie	s
oceanol	o
oceanolo	g
oceanolog	i
oceanologi	c
oceanologic	a
oceanologica	l
oceanological	l
oceanologicall	y
oceb	v
ocel	lo
ocell	a
ocella	t
ocellat	e
ocellate	d
ocelo	t
och	elr
oche	r
ochl	o
ochlo	c
ochloc	r
ochlocr	a
ochlocra	ct
ochlocrac	y
ochlocrat	i
ochlocrati	c
ochr	eioy
ochre	di
ochrei	s
ochreis	h
ochri	en
ochrie	rs
ochries	t
ochrin	g
ochro	u
ochrou	s
ocj	ao
ocl	v
ocn	rv
oco	ln
ocon	o
ocono	m
oconom	o
oconomo	w
oconomow	o
oconomowo	c
ocp	u
ocpu	v
ocq	a
ocr	ks
ocs	p
oct	aeop
octa	dghlntv
octag	o
octago	n
octagon	as
octagona	l
octagonal	l
octagonall	y
octah	e
octahe	d
octahed	r
octahedr	ao
octahedra	l
octahedro	n
octan	eot
octane	s
octano	aiy
octanoa	t
octanoat	e
octanoi	c
octanoy	l
octat	e
octate	u
octateu	c
octateuc	h
octav	aeio
octava	l
octave	s
octavi	a
octe	t
octet	s
octo	bcfginprs
octob	e
octobe	r
october	s
octoc	ao
octoca	t
octoco	r
octocor	a
octocora	l
octocoral	l
octocorall	i
octocoralli	a
octocorallia	n
octof	io
octofi	d
octofo	i
octofoi	l
octofoil	e
octofoile	d
octog	e
octoge	n
octogen	a
octogena	r
octogenar	i
octogenari	a
octogenaria	n
octoi	c
octon	a
octona	r
octonar	iy
octonari	a
octonaria	n
octop	eou
octope	t
octopet	a
octopeta	l
octopetal	o
octopetalo	u
octopetalou	s
octopo	i
octopoi	d
octopu	s
octopus	e
octopuse	s
octor	o
octoro	o
octoroo	n
octos	e
octose	p
octosep	a
octosepa	l
octosepal	o
octosepalo	u
octosepalou	s
octp	l
octpl	o
octplo	i
octploi	d
ocu	al
ocul	aio
ocula	r
oculi	s
oculis	t
oculo	m
oculom	o
oculomo	t
oculomot	o
oculomoto	r
ocw	c
od	abcdefghijklnopqruvxy
oda	qv
odb	s
odd	beilmnrsu
oddb	a
oddba	l
oddbal	l
odde	rs
oddes	t
oddi	st
oddis	h
oddit	iy
odditi	e
odditie	s
oddl	y
oddm	e
oddme	n
oddmen	t
oddn	e
oddne	s
oddnes	s
oddness	e
oddnesse	s
ode	lmrsuv
odel	ei
odele	t
odeli	n
odelin	g
oder	b
oderb	e
oderbe	r
oderber	g
oderberg	s
odes	s
odess	a
odf	k
odi	clnorsuv
odio	u
odiou	s
odious	ln
odiousl	y
odiousn	e
odiousne	s
odiousnes	s
odiousness	e
odiousnesse	s
odis	t
odist	s
odiu	m
odj	r
odl	rv
odn	flv
odo	mruv
odom	e
odome	t
odomet	er
odomete	r
odometer	s
odometr	iy
odometri	ce
odometric	a
odometrica	l
odometrie	s
odor	ailos
odora	n
odoran	t
odori	f
odorif	e
odorife	r
odorifer	o
odorifero	u
odoriferou	s
odorl	e
odorle	s
odorles	s
odoro	u
odorou	s
odorous	ln
odorousl	y
odorousn	e
odorousne	s
odorousnes	s
odou	r
odour	efls
odoure	d
odourf	u
odourfu	l
odourl	e
odourle	s
odourles	s
odourless	ln
odourlessl	y
odourlessn	e
odourlessne	s
odourlessnes	s
odp	rv
odq	l
odr	kruvw
odu	kp
odup	v
odv	m
odx	v
ody	svy
odys	es
odyse	e
odyss	e
odysse	uy
odysseu	s
oe	abcdefghiklmnopqrstuvwxz
oeb	v
oec	do
oeco	l
oecol	o
oecolo	g
oecolog	i
oecologi	e
oecologie	s
oed	eirv
oedi	p
oedip	au
oedipa	l
oedipal	l
oedipall	y
oedipu	s
oee	cjmrv
oef	aef
oeg	u
oeh	v
oei	a
oel	orvy
oem	r
oen	bopu
oenb	v
oeno	l
oenol	o
oenolo	g
oenolog	y
oeo	rtv
oeq	ah
oer	lmsv
oerl	i
oerli	k
oerlik	o
oerliko	n
oers	t
oerst	e
oerste	d
oes	ot
oeso	p
oesop	h
oesoph	a
oesopha	g
oesophag	aiu
oesophaga	l
oesophagu	s
oesophagus	e
oesophaguse	s
oest	r
oestr	ou
oestro	gn
oestrog	e
oestroge	n
oestrogen	is
oestrogeni	cz
oestrogenic	ai
oestrogenica	l
oestrogenical	l
oestrogenicall	y
oestrogenici	t
oestrogenicit	y
oestrogeniz	ae
oestrogeniza	t
oestrogenizat	i
oestrogenizati	o
oestrogenizatio	n
oestrogenize	d
oestron	e
oestru	s
oet	brv
oetr	v
oeu	u
oev	v
oew	dfu
oex	v
oez	flv
of	abcdefklmnopstvwxyz
ofa	drsvy
ofb	bdvw
ofd	dsu
ofe	adk
ofek	v
off	abdehiklpsuvw
offa	l
offal	s
offb	e
offbe	a
offbea	t
offe	dnr
offen	bcds
offenb	a
offenba	c
offenbac	h
offenc	e
offence	ls
offencel	e
offencele	s
offenceles	s
offenceless	l
offencelessl	y
offend	aeis
offenda	n
offendan	t
offende	dr
offended	n
offendedn	e
offendedne	s
offendednes	s
offendedness	e
offendednesse	s
offender	s
offendi	n
offendin	g
offens	ei
offense	ls
offensel	e
offensele	s
offenseles	s
offensi	v
offensiv	e
offensive	lns
offensivel	y
offensiven	e
offensivene	s
offensivenes	s
offensiveness	e
offensivenesse	s
offer	aeiost
offera	b
offerab	l
offerabl	e
offere	der
offerer	s
offeri	n
offerin	g
offering	s
offero	r
offeror	s
offert	o
offerto	r
offertor	y
offh	a
offha	n
offhan	d
offhand	ei
offhande	d
offhanded	l
offhandedl	y
offhandi	s
offhandis	h
offi	cns
offic	ei
office	fhlmrs
officef	u
officefu	l
officeh	o
officeho	l
officehol	d
officehold	e
officeholde	r
officel	e
officele	s
officeles	s
officem	a
officema	t
officemat	e
officer	ehils
officere	d
officerh	o
officerho	o
officerhoo	d
officerhood	s
officeri	an
officeria	l
officerin	g
officerl	eiy
officerle	s
officerles	s
officerli	k
officerlik	e
officers	h
officersh	i
officershi	p
officership	s
offici	ano
officia	lnt
official	dilns
officiald	o
officialdo	m
officialdom	s
officiali	sz
officialis	em
officializ	e
officiall	y
officialn	e
officialne	s
officialnes	s
offician	t
officiat	e
officin	a
officina	l
officio	u
officiou	s
officious	ln
officiousl	y
officiousn	e
officiousne	s
officiousnes	s
offin	g
offing	s
offis	h
offl	io
offli	n
offlin	e
offlo	a
offloa	d
offload	eis
offloade	dr
offloader	s
offloadi	n
offloadin	g
offp	r
offpr	i
offpri	n
offprin	t
offs	ehip
offse	t
offset	st
offsett	i
offsetti	n
offsettin	g
offsh	o
offsho	or
offshoo	t
offshoot	s
offshor	e
offshore	ds
offsi	d
offsid	e
offside	s
offsp	r
offspr	i
offspri	n
offsprin	g
offspring	s
ofk	av
ofl	b
ofm	b
ofn	chqv
ofo	ov
ofs	v
oft	e
ofte	n
often	elnst
oftene	rs
oftenes	t
oftenl	y
oftenn	e
oftenne	s
oftennes	s
oftenness	e
oftennesse	s
oftent	i
oftenti	m
oftentim	e
oftentime	s
ofv	d
ofw	w
ofy	g
og	acdegijlnopqruvxy
oga	l
ogal	l
ogall	a
ogalla	l
ogallal	a
ogd	e
ogde	n
oge	e
ogg	v
ogi	rsuv
ogiv	ae
ogiva	l
ogj	y
ogl	erv
ogn	forsv
ogo	rv
ogq	f
ogr	eiy
ogre	is
ogrei	s
ogreis	hm
ogreish	l
ogreishl	y
ogreism	s
ogres	s
ogri	s
ogris	hm
ogrish	l
ogrishl	y
ogrism	s
ogu	v
oh	abdefghijmnoprsuwx
oha	rv
ohd	dsuw
ohe	drv
ohh	h
ohi	no
ohin	g
ohio	a
ohioa	n
ohm	bimsy
ohmi	c
ohmic	a
ohmica	l
ohmical	l
ohmicall	y
ohmm	e
ohmme	t
ohmmet	e
ohmmete	r
ohmy	z
ohmyz	s
ohmyzs	h
ohn	bpv
oho	v
ohr	v
ohu	v
ohw	rv
ohx	v
oi	aefijlmnoqrsvx
oij	v
oil	cdefilmpsy
oilc	al
oilca	n
oilcl	o
oilclo	t
oilclot	h
oild	o
oildo	m
oile	drs
oiler	s
oiles	t
oilf	i
oilfi	e
oilfie	l
oilfiel	d
oili	eln
oilie	rs
oilies	t
oilil	y
oilin	eg
oiline	s
oilines	s
oiliness	e
oilinesse	s
oill	ei
oille	s
oilles	s
oilless	n
oillessn	e
oillessne	s
oillessnes	s
oillessness	e
oillessnesse	s
oilli	k
oillik	e
oilm	a
oilma	n
oilp	a
oilpa	p
oilpap	e
oilpape	r
oils	kt
oilsk	i
oilski	n
oilst	o
oilsto	n
oilston	e
oim	b
oin	ktv
oint	m
ointm	e
ointme	n
ointmen	t
ointment	s
oio	v
oiq	il
oir	p
ois	st
oj	abcdefgijklmnopqrtuvz
ojc	ikr
ojd	uv
oje	gz
oji	b
ojib	w
ojibw	a
ojj	frsv
ojm	b
ojn	gsz
ojnz	rv
ojo	bv
ojp	d
ojq	ab
ojr	b
ojt	v
oju	v
ok	abdeijklnorstvwxz
oka	mprvy
okam	o
okamo	t
okamot	o
okap	i
okay	eis
okaye	d
okayi	n
okayin	g
okb	klv
okd	v
oke	bdvy
okeb	v
oki	enrv
okin	ag
okina	w
okinaw	a
okk	dvy
okl	abr
okla	h
oklah	o
oklaho	m
oklahom	a
oklahoma	n
okn	f
okr	al
okra	s
okt	v
okw	a
okwa	p
okz	rx
ol	abcdefghiklnopqrstuvwxyz
ola	dfrv
olb	i
old	defhilnrsuvy
olde	nrs
olden	bs
oldenb	u
oldenbu	r
oldenbur	g
oldes	t
oldf	a
oldfa	s
oldfas	h
oldfash	i
oldfashi	o
oldfashio	n
oldfashion	e
oldfashione	d
oldh	a
oldha	m
oldi	es
oldie	s
oldis	h
oldl	y
oldn	e
oldne	s
oldnes	s
oldness	e
oldnesse	s
oldr	e
oldre	c
oldrec	i
oldreci	p
oldrecip	i
oldrecipi	e
oldrecipie	n
oldrecipien	t
olds	mt
oldsm	o
oldsmo	b
oldsmob	i
oldsmobi	l
oldsmobil	e
oldst	e
oldste	r
oldu	v
olduv	a
olduva	i
ole	adgoquv
olea	gn
oleag	i
oleagi	n
oleagin	o
oleagino	u
oleaginou	s
olean	d
oleand	e
oleande	r
oleo	gmr
oleog	r
oleogr	a
oleogra	p
oleograp	h
oleom	a
oleoma	r
oleomar	g
oleomarg	a
oleomarga	r
oleomargar	i
oleomargari	n
oleomargarin	e
oleor	e
oleore	s
oleores	i
oleoresi	n
oleu	m
olev	e
oleve	l
olevel	s
olf	av
olfa	c
olfac	t
olfact	io
olfacti	o
olfactio	n
olfacto	r
olfactor	y
olg	a
olh	opqrwz
olhz	v
oli	gnov
olig	ao
oliga	r
oligar	c
oligarc	h
oligarch	y
oligo	cp
oligoc	e
oligoce	n
oligocen	e
oligop	o
oligopo	l
oligopol	y
oliv	ei
olive	drst
oliver	s
olivet	t
olivett	i
olivi	aen
olivie	r
olivin	e
olk	v
oll	abv
olla	m
ollam	a
oln	fnoqrv
olno	v
olo	bgkopqrwz
olob	rv
olog	y
olok	v
oloo	v
olow	v
olp	mrv
olq	v
olr	bfruv
ols	eko
olse	n
olso	n
olt	hkortw
olu	l
olw	vw
olx	v
oly	my
olym	p
olymp	iu
olympi	ac
olympia	n
olympian	i
olympiani	z
olympianiz	e
olympianize	s
olympic	s
olympu	s
olz	pr
om	abcdefgilmnopqry
oma	hnrsv
omah	a
omas	u
omasu	m
omb	bdfgruv
ombb	v
ombr	o
ombro	l
ombrol	o
ombrolo	g
ombrolog	y
ombu	d
ombud	s
ombuds	m
ombudsm	ae
ombudsma	n
ombudsman	s
ombudsmans	h
ombudsmansh	i
ombudsmanshi	p
ombudsmanship	s
ombudsme	n
omc	s
omd	g
ome	eglnv
omeg	a
omega	st
omegat	r
omegatr	o
omegatro	n
omel	e
omele	t
omelet	t
omelett	e
omelette	s
omen	eis
omene	d
omeni	n
omenin	g
omi	acinstz
omic	r
omicr	o
omicro	n
omin	o
omino	u
ominou	s
ominous	ln
ominousl	y
ominousn	e
ominousne	s
ominousnes	s
ominousness	e
ominousnesse	s
omis	s
omiss	i
omissi	bo
omissib	l
omissibl	e
omissio	n
omission	s
omit	st
omitt	ei
omitte	dr
omitter	s
omitti	n
omittin	g
oml	k
omm	bw
ommw	r
ommwr	i
ommwri	t
ommwrit	e
ommwrite	r
omn	giov
omni	bcdfglopstv
omnib	u
omnibu	s
omnic	o
omnico	m
omnicom	p
omnicomp	e
omnicompe	t
omnicompet	e
omnicompete	n
omnicompeten	t
omnid	i
omnidi	r
omnidir	e
omnidire	c
omnidirec	t
omnidirect	i
omnidirecti	o
omnidirectio	n
omnidirection	a
omnidirectiona	l
omnif	o
omnifo	c
omnifoc	u
omnifocu	s
omnig	r
omnigr	a
omnigra	fp
omnigraf	f
omnigraff	l
omnigraffl	e
omnigrap	h
omnil	aiu
omnila	t
omnilat	e
omnilate	r
omnilater	a
omnilatera	l
omnili	n
omnilin	g
omniling	u
omnilingu	a
omnilingua	l
omnilu	c
omniluc	e
omniluce	n
omnilucen	t
omnio	u
omniou	t
omniout	l
omnioutl	i
omnioutli	n
omnioutlin	e
omnioutline	r
omnip	aelor
omnipa	t
omnipat	i
omnipati	e
omnipatie	n
omnipatien	t
omnipe	r
omniper	c
omniperc	i
omniperci	p
omnipercip	i
omnipercipi	e
omnipercipie	n
omnipercipien	t
omnipl	a
omnipla	n
omnipo	t
omnipot	e
omnipote	n
omnipoten	ct
omnipotenc	e
omnipr	e
omnipre	sv
omnipres	e
omniprese	n
omnipresen	ct
omnipresenc	e
omniprev	a
omnipreva	l
omnipreval	e
omniprevale	n
omniprevalen	t
omnis	ceu
omnisc	i
omnisci	e
omniscie	n
omniscien	ct
omniscienc	ey
omniscient	ls
omniscientl	y
omnise	x
omnisex	u
omnisexu	a
omnisexua	l
omnisexual	i
omnisexuali	t
omnisexualit	y
omnisu	b
omnisub	j
omnisubj	u
omnisubju	g
omnisubjug	a
omnisubjuga	n
omnisubjugan	t
omnit	eo
omnite	m
omnitem	p
omnitemp	o
omnitempo	r
omnitempor	a
omnitempora	l
omnito	l
omnitol	e
omnitole	r
omnitoler	a
omnitolera	n
omnitoleran	t
omniv	ao
omniva	l
omnival	e
omnivale	n
omnivalen	t
omnivo	r
omnivor	eo
omnivore	s
omnivoro	u
omnivorou	s
omo	p
omop	l
omopl	a
omopla	t
omoplat	e
omp	h
omph	a
ompha	l
omphal	o
omphalo	s
omy	o
on	abcdefghijklmnoprstuvwxyz
ona	gn
onag	e
onage	r
onan	i
onani	s
onanis	m
onb	dfikorv
onbi	v
onbo	a
onboa	r
onboar	d
onc	eopv
once	ns
oncen	e
oncene	s
oncenes	s
onces	t
onco	lm
oncol	o
oncolo	g
oncolog	y
oncom	i
oncomi	n
oncomin	g
oncoming	s
ond	v
one	bdefhiknoprstuvz
oned	ar
oneda	r
onedar	k
onedr	i
onedri	v
onedriv	e
onef	o
onefo	l
onefol	d
onefold	n
onefoldn	e
onefoldne	s
onefoldnes	s
onei	dr
oneid	a
oneir	io
oneiri	c
oneiro	m
oneirom	a
oneiroma	n
oneiroman	c
oneiromanc	y
onek	e
oneke	y
onen	eo
onene	s
onenes	s
oneno	t
onenot	e
onep	il
onepi	e
onepie	c
onepiec	e
onepl	u
oneplu	s
oner	o
onero	su
oneros	i
onerosi	t
onerosit	iy
onerositi	e
onerositie	s
onerou	s
onerous	ln
onerousl	y
onerousn	e
onerousne	s
onerousnes	s
onerousness	e
onerousnesse	s
ones	et
onese	l
onesel	f
onet	i
oneti	m
onetim	e
oneu	i
onf	ablorsv
onfa	l
onfal	l
ong	orv
ongo	i
ongoi	n
ongoin	g
ongoing	ln
ongoingl	y
ongoingn	e
ongoingne	s
ongoingnes	s
ongoingness	e
ongoingnesse	s
onh	eot
oni	ouv
onio	n
onion	ls
onionl	i
onionli	k
onionlik	e
onions	k
onionsk	i
onionski	n
oniu	m
onj	svy
onl	ioy
onli	en
onlie	r
onlin	e
online	s
onlines	s
onlo	o
onloo	k
onlook	ei
onlooke	r
onlooker	s
onlooki	n
onlookin	g
onm	hv
onn	d
ono	abflmnrv
onom	a
onoma	t
onomat	o
onomato	p
onomatop	o
onomatopo	ei
onomatopoe	i
onomatopoei	ac
onomatopoeia	ns
onomatopoeic	as
onomatopoeica	l
onomatopoeical	l
onomatopoeicall	y
onomatopoi	e
onomatopoie	t
onomatopoiet	i
onomatopoieti	c
onon	d
onond	a
ononda	g
onondag	a
onp	o
onr	dioruv
onru	s
onrus	h
onrush	i
onrushi	n
onrushin	g
ons	ehilt
onse	t
onset	st
onsett	i
onsetti	n
onsettin	g
onsh	o
onsho	r
onshor	e
onsi	dt
onsid	e
onsit	e
onsl	a
onsla	u
onslau	g
onslaug	h
onslaugh	t
onslaught	s
onst	a
onsta	g
onstag	e
ont	aov
onta	r
ontar	i
ontari	o
onto	gl
ontog	e
ontoge	n
ontogen	ey
ontogene	s
ontogenes	i
ontogenesi	s
ontol	o
ontolo	g
ontolog	iy
ontologi	c
ontologic	a
ontologica	l
onu	s
onw	au
onwa	r
onwar	d
onward	s
onx	u
ony	ox
oo	abcdefghijklmnopqrtvwxyz
ooa	deor
oob	fw
ooc	ly
oocy	t
oocyt	e
ood	hlor
oodl	e
oodle	s
oof	y
oog	o
ooh	v
ooi	o
ooj	o
ook	arv
ool	bop
oolo	gn
oolog	y
oolon	g
oolp	v
oom	bfp
oomf	v
oomp	h
oon	bdrv
ooo	bejkmorstv
oooe	v
ooot	v
oop	s
ooq	bdfjkoqx
ooqj	rv
ooqk	v
oor	bfkoprtvw
oorb	v
oot	ot
ooto	v
oov	rv
oow	rsv
oox	v
ooy	oy
ooz	eiy
ooze	ds
oozi	n
oozin	g
op	abcdefghijlmnopqrstuvxz
opa	clqrv
opac	i
opaci	mt
opacim	e
opacime	t
opacimet	e
opacimete	r
opacit	y
opal	eis
opale	s
opales	c
opalesc	e
opalesce	n
opalescen	ct
opalescenc	e
opali	sz
opalis	e
opaliz	e
opaq	u
opaqu	ei
opaque	dlnrs
opaquel	y
opaquen	e
opaquene	s
opaquenes	s
opaqueness	e
opaquenesse	s
opaques	t
opaqui	n
opaquin	g
opb	dv
opc	o
opco	d
opcod	e
opd	acfjkopt
opdj	rv
opdk	v
opdp	v
ope	clnrsv
opec	s
open	abcefgijlnorstw
opena	bil
openab	il
openabi	l
openabil	i
openabili	t
openabilit	iy
openabiliti	e
openabilitie	s
openabl	e
openai	c
openaic	ho
openaich	a
openaicha	t
openaichat	g
openaichatg	p
openaichatgp	t
openaico	d
openaicod	e
openaicode	x
openb	s
openbs	d
openc	aclv
openca	st
opencas	t
opencl	a
opencla	s
openclas	h
opene	drs
opener	s
openes	t
openf	e
openfe	i
openfei	g
openfeig	n
openg	l
openi	dn
openin	g
opening	s
openj	d
openjd	k
openl	iy
openli	s
openlis	t
openn	e
openne	s
opennes	s
openness	e
opennesse	s
openo	f
openof	f
openoff	i
openoffi	c
openoffic	e
openr	o
openro	u
openrou	t
openrout	e
openroute	r
opens	etu
opense	a
openst	r
openstr	e
openstre	e
openstree	t
openstreet	m
openstreetm	a
openstreetma	p
opensu	s
opensus	e
opent	o
opento	f
opentof	u
openw	eor
openwe	b
openweb	u
openwebu	i
openwo	r
openwor	kl
openworl	d
openwr	t
oper	ace
opera	bnst
operab	il
operabi	l
operabil	i
operabili	t
operabilit	iy
operabiliti	e
operabilitie	s
operabl	ey
operan	dt
operand	is
operat	aeio
operata	b
operatab	l
operatabl	e
operate	ds
operati	cnosvz
operatin	g
operating	s
operatings	y
operatingsy	s
operatingsys	t
operatingsyst	e
operatingsyste	m
operatio	n
operation	as
operationa	l
operational	il
operationali	t
operationalit	y
operationall	y
operatis	e
operativ	ei
operative	lns
operativel	y
operativen	e
operativene	s
operativenes	s
operativeness	e
operativenesse	s
operativi	t
operativit	iy
operativiti	e
operativitie	s
operatiz	e
operato	r
operator	ls
operatorl	e
operatorle	s
operatorles	s
operc	u
opercu	l
opercul	u
operculu	m
opere	t
operet	t
operett	ae
opf	djv
oph	it
ophi	du
ophid	i
ophidi	a
ophidia	n
ophiu	c
ophiuc	hu
ophiuch	u
ophiuchu	s
ophiucu	s
opht	h
ophth	a
ophtha	l
ophthal	m
ophthalm	io
ophthalmi	c
ophthalmo	lns
ophthalmol	o
ophthalmolo	g
ophthalmolog	iy
ophthalmologi	cs
ophthalmologic	a
ophthalmologica	l
ophthalmologis	t
ophthalmon	o
ophthalmono	g
ophthalmonog	y
ophthalmos	c
ophthalmosc	o
ophthalmosco	p
ophthalmoscop	e
opi	anuv
opia	t
opiat	e
opin	ei
opini	o
opinio	n
opinion	als
opiniona	lt
opinionat	e
opinionate	d
opinionl	e
opinionle	s
opinionles	s
opiu	m
opium	s
opj	v
opl	rv
opm	djr
opn	do
opno	v
opo	borsv
opob	v
opos	s
oposs	u
opossu	m
opp	deorsu
oppe	nr
oppen	h
oppenh	e
oppenhe	i
oppenhei	m
oppenheim	e
oppenheime	r
opper	a
oppo	nrs
oppon	e
oppone	n
opponen	t
opponent	s
oppor	t
opport	u
opportu	n
opportun	ei
opportune	ln
opportunel	y
opportunen	e
opportunene	s
opportunenes	s
opportuneness	e
opportunenesse	s
opportuni	st
opportunis	mt
opportunism	s
opportunist	is
opportunisti	c
opportunistic	a
opportunistica	l
opportunistical	l
opportunisticall	y
opportunit	iy
opportuniti	e
opportunitie	s
oppos	aei
opposa	b
opposab	il
opposabi	l
opposabil	i
opposabili	t
opposabilit	y
opposabl	e
oppose	dlrs
opposed	n
opposedn	e
opposedne	s
opposednes	s
opposel	e
opposele	s
opposeles	s
opposer	s
opposi	nt
opposin	g
opposing	l
opposingl	y
opposit	ei
opposite	lns
oppositel	y
oppositen	e
oppositene	s
oppositenes	s
oppositeness	e
oppositenesse	s
oppositi	o
oppositio	n
opposition	als
oppositiona	lr
oppositionar	y
oppositionl	e
oppositionle	s
oppositionles	s
oppr	eo
oppre	s
oppres	s
oppress	eio
oppresse	ds
oppressi	bnov
oppressib	l
oppressibl	e
oppressin	g
oppressing	l
oppressingl	y
oppressio	n
oppressiv	e
oppressive	ln
oppressivel	y
oppressiven	e
oppressivene	s
oppressivenes	s
oppressiveness	e
oppressivenesse	s
oppresso	r
oppressor	s
oppro	b
opprob	r
opprobr	i
opprobri	ou
opprobrio	u
opprobriou	s
opprobriu	m
oppu	g
oppug	n
opq	g
opr	a
opra	h
opt	aehios
opta	bt
optab	l
optabl	e
optat	i
optati	v
optativ	e
opte	d
opth	a
optha	l
opthal	m
opthalm	i
opthalmi	c
opti	cmno
optic	ais
optica	l
optical	l
opticall	y
optici	at
opticia	n
optician	s
opticit	y
optim	aiu
optima	l
optimal	il
optimali	tz
optimalit	iy
optimaliti	e
optimalitie	s
optimaliz	a
optimaliza	t
optimalizat	i
optimalizati	o
optimalizatio	n
optimall	y
optimi	sz
optimis	aemt
optimisa	t
optimisat	i
optimisati	o
optimisatio	n
optimism	s
optimist	is
optimisti	c
optimistic	a
optimistica	l
optimistical	l
optimisticall	y
optimiz	aei
optimiza	t
optimizat	i
optimizati	o
optimizatio	n
optimization	s
optimize	drs
optimizer	s
optimizi	n
optimizin	g
optimu	m
optimum	s
optin	g
optio	n
option	aeils
optiona	bl
optionab	l
optionabl	e
optional	il
optionali	tz
optionalit	iy
optionaliti	e
optionalitie	s
optionaliz	e
optionall	y
optione	d
optioni	n
optionin	g
optionl	e
optionle	s
optionles	s
opto	aem
optoa	c
optoac	o
optoaco	u
optoacou	s
optoacous	t
optoacoust	i
optoacousti	c
optoe	l
optoel	e
optoele	c
optoelec	t
optoelect	r
optoelectr	o
optoelectro	n
optoelectron	i
optoelectroni	c
optoelectronic	s
optom	e
optome	t
optomet	er
optomete	r
optometr	iy
optometri	s
optometris	t
opu	ls
opul	e
opule	n
opulen	ct
opulenc	e
opx	v
opz	w
oq	abefijklnouvw
oqa	v
oqf	ovy
oqi	v
oqj	qv
oqn	fuv
oqo	rsv
oqu	rv
or	abcdefgijklmnopqrstuvwxyz
ora	clnoqt
orac	lu
oracl	ei
oracle	ds
oracli	n
oraclin	g
oracu	l
oracul	a
oracula	r
oral	ils
orali	st
oralis	t
oralit	i
oraliti	e
oralitie	s
orall	y
oran	g
orang	eiou
orange	adilrs
orangea	d
orangead	e
orangei	s
orangeis	m
orangeism	s
orangel	i
orangeli	k
orangelik	e
oranger	y
orangi	s
orangis	t
orango	u
orangou	t
orangout	a
orangouta	n
orangoutan	g
orangu	t
orangut	a
oranguta	n
orat	eior
orati	o
oratio	n
oration	s
orato	r
orator	ilsy
oratori	ceo
oratoric	a
oratorica	l
oratorie	s
oratorio	s
oratorl	i
oratorli	k
oratorlik	e
orators	h
oratorsh	i
oratorshi	p
oratorship	s
oratr	e
oratre	s
oratres	s
orb	beit
orbe	a
orbi	ct
orbic	u
orbicu	l
orbicul	a
orbicula	r
orbit	aeisz
orbita	lr
orbital	ls
orbitall	y
orbitar	y
orbite	dr
orbiter	s
orbiti	n
orbitin	g
orc	adhly
orch	aei
orcha	r
orchar	d
orchard	eis
orcharde	d
orchardi	s
orchardis	t
orche	s
orches	t
orchest	r
orchestr	a
orchestra	lst
orchestrat	ei
orchestrati	o
orchestratio	n
orchi	ds
orchid	ils
orchidi	s
orchidis	t
orchidl	i
orchidli	k
orchidlik	e
ord	adeilnouv
orda	i
ordai	n
ordain	aeims
ordaina	b
ordainab	l
ordainabl	e
ordaine	dr
ordainer	s
ordaini	n
ordainin	g
ordainm	e
ordainme	n
ordainmen	t
ordainment	s
orde	ar
ordea	l
ordeal	s
order	aeils
ordera	b
orderab	l
orderabl	e
ordere	dr
orderer	s
orderi	n
orderin	g
ordering	s
orderl	iy
orderli	en
orderlie	s
orderlin	e
orderline	s
orderlines	s
ordi	n
ordin	a
ordina	lnrt
ordinal	ls
ordinall	y
ordinan	cd
ordinanc	e
ordinance	s
ordinar	iy
ordinari	eln
ordinarie	rs
ordinaries	t
ordinaril	y
ordinarin	e
ordinarine	s
ordinarines	s
ordinariness	e
ordinarinesse	s
ordinat	ei
ordinate	s
ordinati	o
ordinatio	n
ordn	a
ordna	n
ordnan	c
ordnanc	e
ordo	nv
ordon	n
ordonn	a
ordonna	n
ordonnan	c
ordonnanc	e
ordov	i
ordovi	c
ordovic	i
ordovici	a
ordovicia	n
ordu	r
ordur	e
ore	cgs
orec	t
orect	i
orecti	c
oreg	ao
orega	n
oregan	o
oregano	s
orego	n
oregon	i
oregoni	a
oregonia	n
oregonian	s
ores	t
orest	e
oreste	is
orestei	a
orf	dfrtv
org	aeiuy
orga	ns
organ	eilosz
organe	l
organel	l
organell	e
organi	cfsz
organic	ais
organica	l
organical	ln
organicall	y
organicaln	e
organicalne	s
organicalnes	s
organicalness	e
organicalnesse	s
organici	t
organicit	iy
organiciti	e
organicitie	s
organif	i
organifi	c
organis	aeimt
organisa	t
organisat	i
organisati	o
organisatio	n
organisation	as
organisationa	l
organise	drs
organiser	s
organisi	n
organisin	g
organism	is
organismi	c
organismic	a
organismica	l
organismical	l
organismicall	y
organist	s
organiz	aei
organiza	bt
organizab	il
organizabi	l
organizabil	i
organizabili	t
organizabilit	i
organizabiliti	e
organizabilitie	s
organizabl	e
organizat	io
organizati	o
organizatio	n
organization	ais
organizationa	l
organizational	l
organizationall	y
organizationi	s
organizationis	t
organizato	r
organizator	y
organize	drs
organizer	s
organizi	n
organizin	g
organl	e
organle	s
organles	s
organo	t
organot	h
organoth	e
organothe	r
organother	a
organothera	p
organotherap	y
organz	a
orgas	mt
orgasm	aeis
orgasma	l
orgasme	d
orgasmi	cn
orgasmic	a
orgasmica	l
orgasmical	l
orgasmicall	y
orgasmin	g
orgast	i
orgasti	c
orge	a
orgea	t
orgi	ae
orgia	s
orgias	t
orgiast	i
orgiasti	c
orgie	s
orgu	l
orgul	o
orgulo	u
orgulou	s
ori	efgnos
orie	n
orien	t
orient	aeis
orienta	blt
orientab	il
orientabi	l
orientabil	i
orientabili	t
orientabilit	y
orientabl	e
oriental	ils
orientali	sz
orientalis	e
orientaliz	aei
orientaliza	t
orientalizat	i
orientalizati	o
orientalizatio	n
orientalization	s
orientalize	ds
orientalizi	n
orientalizin	g
orientall	y
orientat	i
orientati	o
orientatio	n
orientation	s
oriente	der
orientee	r
orienteer	i
orienteeri	n
orienteerin	g
orienteering	s
orienter	s
orienti	n
orientin	g
orif	il
orifi	c
orific	ei
orifice	s
orifici	a
orificia	l
orifl	a
orifla	m
oriflam	m
oriflamm	e
orig	ai
origa	m
origam	i
origami	s
origi	n
origin	aos
origina	blt
originab	l
originabl	e
original	ils
originali	t
originalit	iy
originaliti	e
originalitie	s
originall	y
originat	eio
originate	ds
originati	no
originatin	g
originatio	n
origination	s
originato	r
originator	s
origino	s
orin	o
orino	c
orinoc	o
orio	ln
oriol	e
oriole	s
oris	o
oriso	n
orj	qrtv
ork	n
orkn	e
orkne	y
orl	aeiovy
orla	n
orlan	d
orland	o
orle	a
orlea	n
orlean	s
orli	c
orlic	k
orlo	n
orm	os
ormo	l
ormol	u
orn	adeiruv
orna	mt
ornam	e
orname	n
ornamen	t
ornament	aeis
ornamenta	lt
ornamental	ilns
ornamentali	tz
ornamentalit	iy
ornamentaliti	e
ornamentalitie	s
ornamentaliz	e
ornamentall	y
ornamentaln	e
ornamentalne	s
ornamentalnes	s
ornamentat	i
ornamentati	o
ornamentatio	n
ornamente	dr
ornamenter	s
ornamenti	ns
ornamentin	g
ornamentis	t
ornat	e
ornate	ln
ornatel	y
ornaten	e
ornatene	s
ornatenes	s
ornateness	e
ornatenesse	s
orne	r
orner	y
orni	t
ornit	h
ornith	o
ornitho	l
ornithol	o
ornitholo	g
ornitholog	eiy
ornithologe	r
ornithologi	cesz
ornithologic	a
ornithologica	l
ornithological	l
ornithologicall	y
ornithologie	s
ornithologis	t
ornithologist	s
ornithologiz	e
oro	bdfgkntv
orog	er
oroge	n
orogen	y
orogr	a
orogra	p
orograp	h
orograph	i
orographi	c
oron	o
orot	u
orotu	n
orotun	d
orp	hio
orph	aei
orpha	n
orphan	acdehis
orphana	g
orphanag	e
orphanage	s
orphanc	y
orphand	o
orphando	m
orphane	d
orphanh	o
orphanho	o
orphanhoo	d
orphanhood	s
orphani	ns
orphanin	g
orphanis	m
orphe	u
orpheu	s
orphi	c
orphic	a
orphica	l
orphical	l
orphicall	y
orpi	m
orpim	e
orpime	n
orpimen	t
orq	cuv
orr	eijrv
orre	r
orrer	y
orri	s
orris	r
orrisr	o
orrisro	o
orrisroo	t
ors	s
ort	eho
orte	g
orteg	a
orth	aio
ortha	n
orthan	t
orthi	c
orthic	o
orthico	n
orthicon	o
orthicono	s
orthiconos	c
orthiconosc	o
orthiconosco	p
orthiconoscop	e
ortho	cdefgkprst
orthoc	o
orthoco	nr
orthocon	ei
orthoconi	c
orthocor	e
orthod	o
orthodo	nx
orthodon	t
orthodont	i
orthodonti	s
orthodontis	t
orthodox	aeilny
orthodoxa	l
orthodoxe	s
orthodoxi	ac
orthodoxia	n
orthodoxic	a
orthodoxica	l
orthodoxl	y
orthodoxn	e
orthodoxne	s
orthodoxnes	s
orthodoxness	e
orthodoxnesse	s
orthoe	p
orthoep	iy
orthoepi	s
orthoepis	t
orthof	o
orthofo	r
orthofor	m
orthog	enor
orthoge	o
orthogeo	s
orthogeos	y
orthogeosy	n
orthogeosyn	c
orthogeosync	l
orthogeosyncl	i
orthogeosyncli	n
orthogeosynclin	ae
orthogeosynclina	l
orthogn	e
orthogne	i
orthognei	s
orthogneis	s
orthogo	n
orthogon	a
orthogona	l
orthogonal	il
orthogonali	t
orthogonalit	y
orthogonall	y
orthogr	a
orthogra	p
orthograp	h
orthograph	iy
orthographi	ce
orthographie	s
orthok	i
orthoki	n
orthokin	e
orthokine	st
orthokines	i
orthokinesi	s
orthokinet	i
orthokineti	c
orthop	aehisty
orthopa	e
orthopae	d
orthopaed	i
orthopaedi	c
orthopaedic	s
orthope	dr
orthoped	i
orthopedi	c
orthopedic	s
orthoper	c
orthoperc	u
orthopercu	s
orthopercus	s
orthopercuss	i
orthopercussi	o
orthopercussio	n
orthoph	o
orthopho	nrt
orthophon	iy
orthophoni	c
orthophor	i
orthophori	ac
orthophot	o
orthophoto	m
orthophotom	a
orthophotoma	p
orthopi	n
orthopin	a
orthopina	c
orthopinac	o
orthopinaco	i
orthopinacoi	d
orthops	y
orthopsy	c
orthopsyc	h
orthopsych	i
orthopsychi	a
orthopsychia	t
orthopsychiat	r
orthopsychiatr	y
orthopt	e
orthopte	r
orthopter	a
orthoptera	n
orthopy	r
orthopyr	o
orthopyro	x
orthopyrox	e
orthopyroxe	n
orthopyroxen	e
orthor	r
orthorr	h
orthorrh	a
orthorrha	p
orthorrhap	h
orthorrhaph	o
orthorrhapho	u
orthorrhaphou	s
orthos	ei
orthose	l
orthosel	e
orthosele	c
orthoselec	t
orthoselect	i
orthoselecti	o
orthoselectio	n
orthosi	l
orthosil	i
orthosili	c
orthosilic	a
orthosilica	t
orthosilicat	e
orthot	eor
orthote	c
orthotec	t
orthotect	o
orthotecto	n
orthotecton	i
orthotectoni	c
orthoto	p
orthotop	i
orthotopi	c
orthotopic	a
orthotopica	l
orthotopical	l
orthotopicall	y
orthotr	o
orthotro	p
orthotrop	ay
orthotropa	l
orto	l
ortol	a
ortola	n
oru	hu
orv	fgiru
orvi	l
orvil	l
orvill	e
orw	ew
orwe	l
orwel	l
orwell	i
orwelli	a
orwellia	n
orx	ov
ory	tx
orz	v
os	abceghijlmnoprstuwx
osa	agkm
osag	e
osak	a
osam	a
osb	eo
osbe	r
osber	t
osbo	r
osbor	n
osborn	e
osc	ahiou
osca	r
osch	i
oschi	n
oschin	a
osci	dln
oscid	u
oscidu	c
osciduc	e
osciduce	r
oscil	l
oscill	ao
oscilla	t
oscillat	eio
oscillate	ds
oscillati	no
oscillatin	g
oscillatio	n
oscillation	s
oscillato	r
oscillator	sy
oscillo	gs
oscillog	r
oscillogr	a
oscillogra	mp
oscillograp	h
oscillograph	y
oscillos	c
oscillosc	o
oscillosco	p
oscilloscop	ei
oscilloscope	s
oscilloscopi	c
oscilloscopic	a
oscilloscopica	l
oscilloscopical	l
oscilloscopicall	y
oscin	e
oscine	s
osco	m
oscom	m
oscomm	e
oscomme	r
oscommer	c
oscommerc	e
oscu	l
oscul	au
oscula	nrt
osculan	t
osculat	ei
osculati	o
osculatio	n
osculu	m
ose	r
osg	o
osgo	o
osgoo	d
osh	k
oshk	o
oshko	s
oshkos	h
osi	aerst
osie	r
osir	i
osiri	s
osl	o
osm	abiou
osma	n
osman	d
osmi	cu
osmiu	m
osmo	st
osmos	ei
osmose	s
osmosi	s
osmot	i
osmoti	c
osmu	n
osmun	d
osn	adqy
oso	clv
osp	r
ospr	e
ospre	y
osr	b
oss	eiuv
osse	o
osseo	u
osseou	s
ossi	f
ossif	iry
ossifi	c
ossific	a
ossifica	t
ossificat	i
ossificati	o
ossificatio	n
ossifr	a
ossifra	g
ossifrag	e
ossu	a
ossua	r
ossuar	y
ost	eimr
oste	mno
ostem	y
ostemy	e
ostemye	l
ostemyel	i
ostemyeli	t
ostemyelit	i
ostemyeliti	s
osten	st
ostens	i
ostensi	b
ostensib	l
ostensibl	ey
ostent	a
ostenta	t
ostentat	i
ostentati	o
ostentatio	nu
ostentatiou	s
ostentatious	ln
ostentatiousl	y
ostentatiousn	e
ostentatiousne	s
ostentatiousnes	s
ostentatiousness	e
ostentatiousnesse	s
osteo	abcdlpt
osteoa	r
osteoar	t
osteoart	h
osteoarth	r
osteoarthr	io
osteoarthri	t
osteoarthrit	i
osteoarthriti	cs
osteoarthro	pt
osteoarthrop	a
osteoarthropa	t
osteoarthropat	h
osteoarthropath	y
osteoarthrot	i
osteoarthroti	c
osteob	l
osteobl	a
osteobla	s
osteoblas	t
osteoblast	i
osteoblasti	c
osteoc	hl
osteoch	o
osteocho	n
osteochon	d
osteochond	r
osteochondr	o
osteochondro	m
osteochondrom	a
osteocl	a
osteocla	s
osteoclas	i
osteoclasi	a
osteod	eoy
osteode	r
osteoder	m
osteodo	n
osteodon	t
osteodont	o
osteodonto	k
osteodontok	e
osteodontoke	r
osteodontoker	a
osteodontokera	t
osteodontokerat	i
osteodontokerati	c
osteody	s
osteodys	t
osteodyst	r
osteodystr	o
osteodystro	p
osteodystrop	h
osteodystroph	iy
osteodystrophi	ac
osteol	o
osteolo	g
osteolog	iy
osteologi	c
osteologic	a
osteologica	l
osteop	aho
osteopa	t
osteopat	h
osteopath	isy
osteopathi	cs
osteopathis	t
osteopathist	s
osteoph	y
osteophy	t
osteophyt	i
osteophyti	c
osteopo	r
osteopor	o
osteoporo	s
osteoporos	ei
osteoporose	s
osteoporosi	s
osteot	o
osteoto	m
osteotom	y
osti	aou
ostia	r
ostiar	y
ostio	l
ostiol	e
ostiu	m
ostm	a
ostma	r
ostmar	k
ostr	aio
ostra	cn
ostrac	ei
ostrace	a
ostracea	n
ostraci	sz
ostracis	eim
ostracise	ds
ostracisi	n
ostracisin	g
ostraciz	aei
ostraciza	bt
ostracizab	l
ostracizabl	e
ostracizat	i
ostracizati	o
ostracizatio	n
ostracization	s
ostracize	drs
ostracizer	s
ostracizi	n
ostracizin	g
ostran	d
ostrand	e
ostrande	r
ostri	c
ostric	h
ostrich	e
ostriche	s
ostro	g
ostrog	o
ostrogo	t
ostrogot	h
osw	a
oswa	l
oswal	d
osx	elmy
osxe	l
osxel	c
osxelc	a
osxelca	p
osxelcap	i
osxelcapi	t
osxelcapit	a
osxelcapita	n
osxl	i
osxli	o
osxlio	n
osxm	ao
osxma	v
osxmav	e
osxmave	r
osxmaver	i
osxmaveri	c
osxmaveric	k
osxmaverick	s
osxmo	u
osxmou	n
osxmoun	t
osxmount	a
osxmounta	i
osxmountai	n
osxmountain	l
osxmountainl	i
osxmountainli	o
osxmountainlio	n
osxy	o
osxyo	s
osxyos	e
osxyose	m
osxyosem	i
osxyosemi	t
osxyosemit	e
ot	acdefhijkmnoqrtuvwx
ota	rsv
otd	epq
oth	e
othe	lr
othel	l
othell	o
other	sw
otherw	io
otherwi	s
otherwis	e
otherwo	r
otherwor	l
otherworl	d
otherworld	l
otherworldl	iy
otherworldli	n
otherworldlin	e
otherworldline	s
otherworldlines	s
oti	costv
otio	s
otios	e
otit	i
otiti	s
otj	ov
otm	bpq
otmb	v
otmp	v
otmq	v
otn	rvw
oto	hlrstv
otol	ao
otola	r
otolar	y
otolary	n
otolaryn	g
otolaryng	o
otolaryngo	l
otolaryngol	o
otolaryngolo	g
otolaryngolog	y
otolo	g
otolog	iy
otologi	s
otologis	t
otor	r
otorr	h
otorrh	o
otorrho	e
otorrhoe	a
otos	c
otosc	o
otosco	p
otoscop	e
otq	x
otr	p
ott	aeos
otta	w
ottaw	a
otte	r
otter	s
otto	m
ottom	a
ottoma	n
ottoman	i
ottomani	z
ottomaniz	ae
ottomaniza	t
ottomanizat	i
ottomanizati	o
ottomanizatio	n
ottomanization	s
ottomanize	s
ou	abcefgijlmnoprstuvwxz
oua	fgv
ouag	a
ouaga	d
ouagad	o
ouagado	u
ouagadou	g
ouagadoug	o
ouagadougo	u
oub	bip
oubi	e
oubie	t
oubiet	t
oubiett	e
ouc	h
ouch	e
ouche	ds
ouf	d
oug	h
ough	t
oui	j
ouij	a
ouj	hov
oul	ho
oum	b
oun	cf
ounc	e
ounce	rs
ouo	v
our	prsv
ours	e
ourse	l
oursel	fv
ourselv	e
ourselve	s
ous	t
oust	eis
ouste	d
ousti	n
oustin	g
out	abcdefghijklmnopqrstvwy
outa	cgrtw
outac	ht
outach	i
outachi	e
outachie	v
outachiev	ei
outachieve	ds
outachievi	n
outachievin	g
outact	eis
outacte	d
outacti	n
outactin	g
outag	e
outar	m
outat	e
outaw	ei
outawe	ds
outawi	n
outawin	g
outb	aeiloru
outba	bcklnrw
outbab	b
outbabb	l
outbabbl	ei
outbabble	ds
outbabbli	n
outbabblin	g
outbac	k
outbak	ei
outbake	ds
outbaki	n
outbakin	g
outbal	a
outbala	n
outbalan	c
outbalanc	e
outban	t
outbant	e
outbante	r
outbanter	eis
outbantere	d
outbanteri	n
outbanterin	g
outbar	gt
outbarg	a
outbarga	i
outbargai	n
outbargain	eis
outbargaine	d
outbargaini	n
outbargainin	g
outbart	e
outbarte	r
outbarter	eis
outbartere	d
outbarteri	n
outbarterin	g
outbaw	l
outbawl	eis
outbawle	d
outbawli	n
outbawlin	g
outbe	aln
outbea	mr
outbeam	eis
outbeame	d
outbeami	n
outbeamin	g
outbel	cl
outbelc	h
outbelch	ei
outbelche	ds
outbelchi	n
outbelchin	g
outbell	o
outbello	w
outbellow	eis
outbellowe	d
outbellowi	n
outbellowin	g
outben	t
outbi	drt
outbid	ds
outbidd	i
outbiddi	n
outbiddin	g
outbir	t
outbirt	h
outbit	c
outbitc	h
outbitch	ei
outbitche	ds
outbitchi	n
outbitchin	g
outbl	eou
outble	ades
outblea	t
outbleat	eis
outbleate	d
outbleati	n
outbleatin	g
outblee	d
outbleed	is
outbleedi	n
outbleedin	g
outbles	st
outbless	ei
outblesse	ds
outblessi	n
outblessin	g
outblo	st
outblos	s
outbloss	o
outblosso	m
outblossom	eis
outblossome	d
outblossomi	n
outblossomin	g
outblu	fns
outbluf	f
outbluff	eis
outbluffe	d
outbluffi	n
outbluffin	g
outblun	d
outblund	e
outblunde	r
outblunder	eis
outblundere	d
outblunderi	n
outblunderin	g
outblus	h
outblush	ei
outblushe	ds
outblushi	n
outblushin	g
outbo	aux
outboa	r
outboar	d
outbou	gn
outboug	h
outbough	t
outboun	d
outbox	ei
outboxe	ds
outboxi	n
outboxin	g
outbr	aeio
outbra	gnwz
outbrag	gs
outbragg	ei
outbragge	d
outbraggi	n
outbraggin	g
outbran	c
outbranc	h
outbranch	ei
outbranche	ds
outbranchi	n
outbranchin	g
outbraw	l
outbrawl	eis
outbrawle	d
outbrawli	n
outbrawlin	g
outbraz	e
outbraze	n
outbrazen	eis
outbrazene	d
outbrazeni	n
outbrazenin	g
outbre	a
outbrea	kt
outbreak	s
outbreat	h
outbreath	ei
outbreathe	ds
outbreathi	n
outbreathin	g
outbri	bn
outbrib	ei
outbribe	ds
outbribi	n
outbribin	g
outbrin	g
outbring	is
outbringi	n
outbringin	g
outbro	u
outbrou	g
outbroug	h
outbrough	t
outbu	ilry
outbui	l
outbuil	dt
outbuild	is
outbuildi	n
outbuildin	g
outbul	gk
outbulg	ei
outbulge	ds
outbulgi	n
outbulgin	g
outbulk	eis
outbulke	d
outbulki	n
outbulkin	g
outbur	s
outburs	t
outburst	s
outbuy	is
outbuyi	n
outbuyin	g
outc	ahiloru
outca	mnrstu
outcam	p
outcan	t
outcar	or
outcaro	l
outcarol	eils
outcarole	d
outcaroli	n
outcarolin	g
outcaroll	ei
outcarolle	d
outcarolli	n
outcarollin	g
outcarr	y
outcas	t
outcast	eis
outcasti	n
outcastin	g
outcat	c
outcatc	h
outcatch	ei
outcatche	s
outcatchi	n
outcatchin	g
outcau	g
outcaug	h
outcaugh	t
outch	ae
outcha	rt
outchar	gm
outcharg	ei
outcharge	ds
outchargi	n
outchargin	g
outchat	t
outchatt	e
outchatte	r
outchatter	eis
outchattere	d
outchatteri	n
outchatterin	g
outche	a
outchea	t
outcheat	eis
outcheate	d
outcheati	n
outcheatin	g
outci	t
outcit	iy
outciti	e
outcitie	s
outcl	aei
outcla	s
outclas	s
outclass	ei
outclasse	ds
outclassi	n
outclassin	g
outcle	r
outcler	k
outclerk	s
outcli	m
outclim	b
outclimb	eis
outclimbe	d
outclimbi	n
outclimbin	g
outco	amu
outcoa	c
outcoac	h
outcoach	ei
outcoache	ds
outcoachi	n
outcoachin	g
outcom	ep
outcome	s
outcomp	ael
outcompa	s
outcompas	s
outcompass	ei
outcompasse	ds
outcompassi	n
outcompassin	g
outcompe	t
outcompet	ei
outcompete	ds
outcompeti	n
outcompetin	g
outcompl	i
outcompli	m
outcomplim	e
outcomplime	n
outcomplimen	t
outcompliment	eis
outcomplimente	d
outcomplimenti	n
outcomplimentin	g
outcou	nr
outcoun	t
outcount	e
outcounte	n
outcounten	a
outcountena	n
outcountenan	c
outcountenanc	e
outcour	t
outcourt	eis
outcourte	d
outcourti	n
outcourtin	g
outcr	aeioy
outcra	f
outcraf	t
outcraft	y
outcre	ep
outcree	p
outcreep	eis
outcreepe	d
outcreepi	n
outcreepin	g
outcrep	t
outcri	e
outcrie	ds
outcro	p
outcrop	ps
outcropp	e
outcroppe	d
outcry	i
outcryi	n
outcryin	g
outcu	lrt
outcul	l
outcull	eis
outculle	d
outculli	n
outcullin	g
outcur	s
outcurs	eit
outcurse	ds
outcursi	n
outcursin	g
outcut	st
outcutt	i
outcutti	n
outcuttin	g
outd	aeioruw
outda	ntz
outdan	c
outdanc	ei
outdance	ds
outdanci	n
outdancin	g
outdat	e
outdate	d
outdated	ln
outdatedl	y
outdatedn	e
outdatedne	s
outdatednes	s
outdatedness	e
outdatednesse	s
outdaz	z
outdazz	l
outdazzl	ei
outdazzle	ds
outdazzli	n
outdazzlin	g
outde	blsv
outdeb	a
outdeba	t
outdebat	ei
outdebate	ds
outdebati	n
outdebatin	g
outdel	i
outdeli	v
outdeliv	e
outdelive	r
outdeliver	eis
outdelivere	d
outdeliveri	n
outdeliverin	g
outdes	ip
outdesi	g
outdesig	n
outdesign	eis
outdesigne	d
outdesigni	n
outdesignin	g
outdesp	a
outdespa	t
outdespat	c
outdespatc	h
outdespatch	ei
outdespatche	ds
outdespatchi	n
outdespatchin	g
outdev	i
outdevi	l
outdevil	eils
outdevile	d
outdevili	n
outdevilin	g
outdevill	ei
outdeville	d
outdevilli	n
outdevillin	g
outdi	ds
outdis	pt
outdisp	a
outdispa	t
outdispat	c
outdispatc	h
outdispatch	ei
outdispatche	ds
outdispatchi	n
outdispatchin	g
outdist	r
outdistr	i
outdistri	c
outdistric	t
outdistrict	s
outdo	deino
outdod	g
outdodg	ei
outdodge	ds
outdodgi	n
outdodgin	g
outdoe	rs
outdoi	n
outdoin	g
outdon	e
outdoo	r
outdoor	ins
outdoori	s
outdooris	h
outdoorn	e
outdoorne	s
outdoornes	s
outdoors	e
outdoorse	s
outdr	aeiou
outdra	gnu
outdrag	gs
outdragg	ei
outdragge	d
outdraggi	n
outdraggin	g
outdran	k
outdrau	g
outdraug	h
outdraugh	t
outdre	as
outdrea	m
outdres	s
outdress	ei
outdresse	ds
outdressi	n
outdressin	g
outdri	nv
outdrin	k
outdrink	is
outdrinki	n
outdrinkin	g
outdriv	ei
outdrive	ns
outdrivi	n
outdrivin	g
outdro	v
outdrov	e
outdru	n
outdrun	k
outdu	e
outdue	l
outduel	eils
outduele	d
outdueli	n
outduelin	g
outduell	ei
outduelle	d
outduelli	n
outduellin	g
outdw	e
outdwe	l
outdwel	lt
outdwell	eis
outdwelle	dr
outdwelli	n
outdwellin	g
oute	acdrx
outea	rt
outear	n
outearn	eis
outearne	d
outearni	n
outearnin	g
outeat	eis
outeate	n
outeati	n
outeatin	g
outec	h
outech	o
outecho	ei
outechoe	ds
outechoi	n
outechoin	g
outed	g
outedg	ei
outedge	ds
outedgi	n
outedgin	g
outer	mnsw
outerm	o
outermo	s
outermos	t
outern	e
outerne	s
outernes	s
outerness	e
outernesse	s
outers	p
outersp	a
outerspa	c
outerspac	e
outerw	e
outerwe	a
outerwea	r
outex	e
outexe	c
outexec	u
outexecu	t
outexecut	ei
outexecute	ds
outexecuti	n
outexecutin	g
outf	aeiloru
outfa	bclms
outfab	l
outfabl	ei
outfable	ds
outfabli	n
outfablin	g
outfac	e
outfal	l
outfam	ei
outfame	ds
outfami	n
outfamin	g
outfas	t
outfe	aden
outfea	s
outfeas	t
outfeast	eis
outfeaste	d
outfeasti	n
outfeastin	g
outfee	d
outfeed	is
outfeedi	n
outfeedin	g
outfen	c
outfenc	ei
outfence	ds
outfenci	n
outfencin	g
outfi	gst
outfig	hu
outfigh	t
outfight	s
outfigu	r
outfigur	ei
outfigure	ds
outfiguri	n
outfigurin	g
outfis	h
outfish	ei
outfishe	ds
outfishi	n
outfishin	g
outfit	st
outfitt	ei
outfitte	dr
outfitter	s
outfitti	n
outfittin	g
outfl	aeiouy
outfla	mnrs
outflam	ei
outflame	ds
outflami	n
outflamin	g
outflan	k
outflar	ei
outflare	ds
outflari	n
outflarin	g
outflas	h
outflash	ei
outflashe	ds
outflashi	n
outflashin	g
outfle	dew
outflee	is
outfleei	n
outfleein	g
outfli	en
outflie	s
outflin	g
outfling	is
outflingi	n
outflingin	g
outflo	auw
outfloa	t
outfloat	eis
outfloate	d
outfloati	n
outfloatin	g
outflou	r
outflour	i
outflouri	s
outflouris	h
outflourish	ei
outflourishe	ds
outflourishi	n
outflourishin	g
outflu	s
outflus	h
outfly	i
outflyi	n
outflyin	g
outfo	orux
outfoo	lt
outfor	t
outfou	g
outfoug	h
outfough	t
outfr	o
outfro	nt
outfron	t
outfrot	h
outfroth	eis
outfrothe	d
outfrothi	n
outfrothin	g
outfu	m
outfum	b
outfumb	l
outfumbl	ei
outfumble	ds
outfumbli	n
outfumblin	g
outg	ailnoru
outga	ilmsz
outgai	n
outgain	eis
outgaine	d
outgaini	n
outgainin	g
outgal	l
outgall	o
outgallo	p
outgallop	eis
outgallope	d
outgallopi	n
outgallopin	g
outgam	b
outgamb	l
outgambl	ei
outgamble	ds
outgambli	n
outgamblin	g
outgas	s
outgass	i
outgassi	n
outgassin	g
outgaz	ei
outgaze	ds
outgazi	n
outgazin	g
outgi	v
outgiv	ei
outgivi	n
outgivin	g
outgl	aeio
outgla	r
outglar	e
outgle	a
outglea	m
outgleam	eis
outgleame	d
outgleami	n
outgleamin	g
outgli	t
outglit	t
outglitt	e
outglitte	r
outglitter	eis
outglittere	d
outglitteri	n
outglitterin	g
outglo	ow
outgloo	m
outgloom	eis
outgloome	d
outgloomi	n
outgloomin	g
outglow	eis
outglowe	d
outglowi	n
outglowin	g
outgn	a
outgna	w
outgnaw	eins
outgnawe	d
outgnawi	n
outgnawin	g
outgo	i
outgoi	n
outgoin	g
outgoing	ens
outgoinge	rs
outgoinges	t
outgoingn	e
outgoingne	s
outgoingnes	s
outgoingness	e
outgoingnesse	s
outgr	eo
outgre	ew
outgree	n
outgreen	eis
outgreene	d
outgreeni	n
outgreenin	g
outgro	sw
outgros	s
outgross	ei
outgrosse	ds
outgrossi	n
outgrossin	g
outgrow	inst
outgrowi	n
outgrowin	g
outgrowt	h
outgu	es
outgue	s
outgues	s
outgus	h
outgush	ei
outgushe	ds
outgushi	n
outgushin	g
outh	aeiou
outha	ms
outham	m
outhamm	e
outhamme	r
outhammer	eis
outhammere	d
outhammeri	n
outhammerin	g
outhas	t
outhast	e
outhaste	n
outhasten	eis
outhastene	d
outhasteni	n
outhastenin	g
outhe	ac
outhea	r
outhear	dis
outheari	n
outhearin	g
outhec	t
outhect	o
outhecto	r
outhi	rst
outhir	ei
outhire	ds
outhiri	n
outhirin	g
outhis	s
outhiss	ei
outhisse	ds
outhissi	n
outhissin	g
outhit	st
outhitt	i
outhitti	n
outhittin	g
outho	lmuw
outhol	d
outhom	e
outhome	r
outhomer	eis
outhomere	d
outhomeri	n
outhomerin	g
outhou	s
outhous	e
outhow	l
outhowl	eis
outhowle	d
outhowli	n
outhowlin	g
outhu	mnrs
outhum	o
outhumo	u
outhumou	r
outhun	t
outhunt	eis
outhunte	d
outhunti	n
outhuntin	g
outhur	l
outhurl	eis
outhurle	d
outhurli	n
outhurlin	g
outhus	t
outhust	l
outhustl	ei
outhustle	ds
outhustli	n
outhustlin	g
outi	ns
outin	fgtv
outinf	l
outinfl	u
outinflu	e
outinflue	n
outinfluen	c
outinfluenc	ei
outinfluence	ds
outinfluenci	n
outinfluencin	g
outing	s
outint	r
outintr	i
outintri	g
outintrig	u
outintrigu	ei
outintrigue	ds
outintrigui	n
outintriguin	g
outinv	e
outinve	n
outinven	t
outinvent	eis
outinvente	d
outinventi	n
outinventin	g
outis	s
outiss	u
outissu	ei
outissue	ds
outissui	n
outissuin	g
outj	eiou
outje	t
outji	n
outjin	x
outjinx	ei
outjinxe	ds
outjinxi	n
outjinxin	g
outjo	cu
outjoc	k
outjock	e
outjocke	y
outjou	r
outjour	n
outjourn	e
outjourne	y
outjourney	eis
outjourneye	d
outjourneyi	n
outjourneyin	g
outju	gmt
outjug	g
outjugg	l
outjuggl	ei
outjuggle	ds
outjuggli	n
outjugglin	g
outjum	p
outjump	eis
outjumpe	d
outjumpi	n
outjumpin	g
outjut	st
outjutt	e
outjutte	d
outk	ai
outka	s
outkas	t
outki	clnst
outkic	k
outkick	eis
outkicke	d
outkicki	n
outkickin	g
outkil	l
outkill	eis
outkille	d
outkilli	n
outkillin	g
outkin	g
outking	eis
outkinge	d
outkingi	n
outkingin	g
outkis	s
outkiss	ei
outkisse	ds
outkissi	n
outkissin	g
outkit	c
outkitc	h
outkitch	e
outkitche	n
outkitchen	s
outl	aeiouy
outla	binsuwy
outlab	o
outlabo	u
outlabou	r
outlai	d
outlan	d
outland	ei
outlande	r
outlandi	s
outlandis	h
outlandish	ln
outlandishl	y
outlandishn	e
outlandishne	s
outlandishnes	s
outlandishness	e
outlandishnesse	s
outlas	t
outlast	eis
outlaste	d
outlasti	n
outlastin	g
outlau	g
outlaug	h
outlaugh	eis
outlaughe	d
outlaughi	n
outlaughin	g
outlaw	eirs
outlawe	drs
outlawes	t
outlawi	n
outlawin	g
outlawr	i
outlawri	e
outlawrie	s
outlay	is
outlayi	n
outlayin	g
outle	ant
outlea	pr
outleap	eist
outleape	d
outleapi	n
outleapin	g
outlear	n
outlearn	eist
outlearne	d
outlearni	n
outlearnin	g
outlen	g
outleng	t
outlengt	h
outlength	e
outlengthe	n
outlengthen	eis
outlengthene	d
outlengtheni	n
outlengthenin	g
outlet	s
outli	enpv
outlie	r
outlin	egi
outline	ads
outlinea	r
outling	e
outlinge	r
outlinger	eis
outlingere	d
outlingeri	n
outlingerin	g
outlini	n
outlinin	g
outlip	ps
outlipp	ei
outlippe	d
outlippi	n
outlippin	g
outliv	ei
outlive	drs
outliver	s
outlivi	n
outlivin	g
outlo	ov
outloo	k
outlook	s
outlov	ei
outlove	ds
outlovi	n
outlovin	g
outlu	ns
outlun	g
outlus	t
outlust	r
outlustr	e
outly	i
outlyi	n
outlyin	g
outm	aeiou
outma	knrst
outmak	i
outmaki	n
outmakin	g
outman	eins
outmane	u
outmaneu	v
outmaneuv	e
outmaneuve	r
outmaneuver	eis
outmaneuvere	d
outmaneuveri	n
outmaneuverin	g
outmani	p
outmanip	u
outmanipu	l
outmanipul	a
outmanipula	t
outmanipulat	ei
outmanipulate	ds
outmanipulati	n
outmanipulatin	g
outmann	ei
outmanne	d
outmanni	n
outmannin	g
outmar	c
outmarc	h
outmarch	ei
outmarche	ds
outmarchi	n
outmarchin	g
outmas	t
outmast	e
outmaste	r
outmaster	eis
outmastere	d
outmasteri	n
outmasterin	g
outmat	c
outmatc	h
outme	ar
outmea	s
outmeas	u
outmeasu	r
outmeasur	ei
outmeasure	ds
outmeasuri	n
outmeasurin	g
outmer	c
outmerc	h
outmerch	a
outmercha	n
outmerchan	t
outmerchant	s
outmi	g
outmig	r
outmigr	a
outmigra	t
outmigrat	i
outmigrati	o
outmigratio	n
outmo	duv
outmod	e
outmode	d
outmoded	n
outmodedn	e
outmodedne	s
outmodednes	s
outmou	t
outmout	h
outmouth	eis
outmouthe	d
outmouthi	n
outmouthin	g
outmov	ei
outmove	ds
outmovi	n
outmovin	g
outmu	s
outmus	c
outmusc	l
outmuscl	ei
outmuscle	ds
outmuscli	n
outmusclin	g
outn	ou
outno	i
outnoi	s
outnois	e
outnu	m
outnum	b
outnumb	e
outnumbe	r
outnumber	eis
outnumbere	d
outnumberi	n
outnumberin	g
outo	fr
outof	f
outoff	i
outoffi	c
outoffic	e
outoffice	s
outor	g
outorg	a
outorga	n
outorgan	i
outorgani	z
outorganiz	ei
outorganize	ds
outorganizi	n
outorganizin	g
outp	aeiloru
outpa	cist
outpac	e
outpai	n
outpain	t
outpaint	eis
outpainte	d
outpainti	n
outpaintin	g
outpas	s
outpass	ei
outpasse	ds
outpassi	n
outpassin	g
outpat	hi
outpath	s
outpati	e
outpatie	n
outpatien	t
outpatient	s
outpe	eor
outpee	p
outpeo	p
outpeop	l
outpeopl	ei
outpeople	ds
outpeopli	n
outpeoplin	g
outper	f
outperf	o
outperfo	r
outperfor	m
outperform	eis
outperforme	d
outperformi	n
outperformin	g
outpi	t
outpit	ciy
outpitc	h
outpitch	ei
outpitche	ds
outpitchi	n
outpitchin	g
outpiti	e
outpitie	ds
outpity	i
outpityi	n
outpityin	g
outpl	aeo
outpla	ny
outplan	ns
outplann	ei
outplanne	d
outplanni	n
outplannin	g
outplay	eis
outplaye	d
outplayi	n
outplayin	g
outple	a
outplea	s
outpleas	ei
outplease	ds
outpleasi	n
outpleasin	g
outplo	dt
outplod	ds
outplodd	ei
outplodde	d
outploddi	n
outploddin	g
outplot	st
outplott	ei
outplotte	d
outplotti	n
outplottin	g
outpo	cilpsuw
outpoc	k
outpock	e
outpocke	t
outpocket	i
outpocketi	n
outpocketin	g
outpoi	s
outpois	eo
outpoiso	n
outpoison	eis
outpoisone	d
outpoisoni	n
outpoisonin	g
outpol	il
outpoli	t
outpolit	i
outpoliti	c
outpolitic	k
outpolitick	eis
outpoliticke	d
outpoliticki	n
outpolitickin	g
outpoll	eis
outpolle	d
outpolli	n
outpollin	g
outpop	u
outpopu	l
outpopul	a
outpopula	t
outpopulat	ei
outpopulate	ds
outpopulati	n
outpopulatin	g
outpos	it
outposi	t
outposit	i
outpositi	o
outpositio	n
outpost	s
outpou	r
outpour	i
outpouri	n
outpourin	g
outpow	e
outpowe	r
outpower	eis
outpowere	d
outpoweri	n
outpowerin	g
outpr	aeio
outpra	ciy
outprac	t
outpract	i
outpracti	c
outpractic	ei
outpractice	ds
outpractici	n
outpracticin	g
outprai	s
outprais	ei
outpraise	ds
outpraisi	n
outpraisin	g
outpray	eis
outpraye	d
outprayi	n
outprayin	g
outpre	a
outprea	c
outpreac	h
outpreach	ei
outpreache	ds
outpreachi	n
outpreachin	g
outpri	cz
outpric	ei
outprice	ds
outprici	n
outpricin	g
outpriz	e
outpro	dm
outprod	u
outprodu	c
outproduc	ei
outproduce	ds
outproduci	n
outproducin	g
outprom	i
outpromi	s
outpromis	ei
outpromise	ds
outpromisi	n
outpromisin	g
outpu	nrst
outpun	c
outpunc	h
outpunch	ei
outpunche	ds
outpunchi	n
outpunchin	g
outpur	s
outpurs	u
outpursu	ei
outpursue	ds
outpursui	n
outpursuin	g
outpus	h
outpush	ei
outpushe	ds
outpushi	n
outpushin	g
output	st
outputt	ei
outputte	dr
outputti	n
outputtin	g
outq	u
outqu	aei
outqua	r
outquar	t
outquart	e
outquarte	r
outquarter	s
outquarters	e
outquarterse	s
outque	nrs
outquen	c
outquenc	h
outquench	e
outquenche	r
outquer	iy
outqueri	e
outquerie	ds
outquery	i
outqueryi	n
outqueryin	g
outques	t
outquest	i
outquesti	o
outquestio	n
outquestion	eis
outquestione	d
outquestioni	n
outquestionin	g
outqui	b
outquib	b
outquibb	l
outquibbl	ei
outquibble	ds
outquibbli	n
outquibblin	g
outr	aehiou
outra	gint
outrag	ei
outrage	dors
outrageo	u
outrageou	s
outrageous	ln
outrageousl	y
outrageousn	e
outrageousne	s
outrageousnes	s
outrageousness	e
outrageousnesse	s
outragi	n
outragin	g
outrai	l
outran	t
outrant	eis
outrante	d
outranti	n
outrantin	g
outrat	ei
outrate	ds
outrati	n
outratin	g
outre	abcdip
outrea	cds
outreac	h
outreas	o
outreaso	n
outreason	eis
outreasone	d
outreasoni	n
outreasonin	g
outreb	o
outrebo	u
outrebou	n
outreboun	d
outrebound	eis
outrebounde	d
outreboundi	n
outreboundin	g
outrec	k
outreck	o
outrecko	n
outreckon	eis
outreckone	d
outreckoni	n
outreckonin	g
outred	d
outredd	e
outredde	n
outredden	eis
outreddene	d
outreddeni	n
outreddenin	g
outrei	g
outreig	n
outreign	eis
outreigne	d
outreigni	n
outreignin	g
outrep	r
outrepr	o
outrepro	d
outreprod	u
outreprodu	c
outreproduc	ei
outreproduce	ds
outreproduci	n
outreproducin	g
outrh	y
outrhy	m
outrhym	ei
outrhyme	ds
outrhymi	n
outrhymin	g
outri	dgv
outrid	e
outrig	ghs
outrigg	ei
outrigge	r
outriggi	n
outriggin	g
outrigh	t
outright	eln
outrighte	rs
outrightes	t
outrightl	y
outrightn	e
outrightne	s
outrightnes	s
outrightness	e
outrightnesse	s
outriv	a
outriva	l
outrival	eils
outrivale	d
outrivali	n
outrivalin	g
outrivall	ei
outrivalle	d
outrivalli	n
outrivallin	g
outro	aglow
outroa	r
outroar	eis
outroare	d
outroari	n
outroarin	g
outrog	u
outrogu	ei
outrogue	ds
outrogui	n
outroguin	g
outrol	l
outroo	m
outrow	eis
outrowe	d
outrowi	n
outrowin	g
outru	ns
outrun	ns
outrunn	i
outrunni	n
outrunnin	g
outrus	h
outrush	ei
outrushe	ds
outrushi	n
outrushin	g
outs	acehiklmnoptuw
outsa	it
outsai	ln
outsail	eis
outsaile	d
outsaili	n
outsailin	g
outsain	t
outsaint	eis
outsainte	d
outsainti	n
outsaintin	g
outsat	i
outsati	s
outsatis	f
outsatisf	iy
outsatisfi	e
outsatisfie	ds
outsatisfy	i
outsatisfyi	n
outsatisfyin	g
outsc	ehor
outsce	n
outscen	t
outscent	eis
outscente	d
outscenti	n
outscentin	g
outsch	e
outsche	m
outschem	ei
outscheme	ds
outschemi	n
outschemin	g
outsco	lor
outscol	d
outscold	eis
outscolde	d
outscoldi	n
outscoldin	g
outscoo	p
outscoop	eis
outscoope	d
outscoopi	n
outscoopin	g
outscor	ein
outscore	ds
outscori	n
outscorin	g
outscorn	eis
outscorne	d
outscorni	n
outscornin	g
outscr	e
outscre	a
outscrea	m
outscream	eis
outscreame	d
outscreami	n
outscreamin	g
outse	aelt
outsea	r
outsear	c
outsearc	h
outsearch	ei
outsearche	ds
outsearchi	n
outsearchin	g
outsee	k
outseek	is
outseeki	n
outseekin	g
outsel	l
outset	st
outsett	l
outsettl	e
outsettle	r
outsh	aior
outsha	mp
outsham	ei
outshame	ds
outshami	n
outshamin	g
outshap	ei
outshape	ds
outshapi	n
outshapin	g
outshi	n
outshin	e
outsho	puvw
outshou	lt
outshoul	d
outshould	e
outshoulde	r
outshoulder	eis
outshouldere	d
outshoulderi	n
outshoulderin	g
outshout	eis
outshoute	d
outshouti	n
outshoutin	g
outshov	e
outshow	eins
outshowe	d
outshowi	n
outshowin	g
outshr	i
outshri	el
outshrie	k
outshriek	eis
outshrieke	d
outshrieki	n
outshriekin	g
outshril	l
outshrill	eis
outshrille	d
outshrilli	n
outshrillin	g
outsi	dfgntz
outsid	e
outside	dnrs
outsided	n
outsidedn	e
outsidedne	s
outsidednes	s
outsiden	e
outsidene	s
outsidenes	s
outsider	dilns
outsiderd	o
outsiderdo	m
outsideri	s
outsideris	hm
outsiderish	n
outsiderishn	e
outsiderishne	s
outsiderishnes	s
outsiderl	y
outsidern	e
outsiderne	s
outsidernes	s
outsiderness	e
outsidernesse	s
outsif	t
outsift	eis
outsifte	d
outsifti	n
outsiftin	g
outsig	h
outsigh	eis
outsighe	d
outsighi	n
outsighin	g
outsin	g
outsing	is
outsingi	n
outsingin	g
outsit	st
outsitt	i
outsitti	n
outsittin	g
outsiz	e
outsize	ds
outsk	ai
outska	t
outskat	ei
outskate	ds
outskati	n
outskatin	g
outski	r
outskir	mt
outskirm	i
outskirmi	s
outskirmis	h
outskirmish	ei
outskirmishe	ds
outskirmishi	n
outskirmishin	g
outskirt	s
outsl	aiu
outsla	n
outslan	d
outsland	e
outslande	r
outslander	eis
outslandere	d
outslanderi	n
outslanderin	g
outsli	dn
outslid	dei
outslidd	e
outslidde	n
outslide	s
outslidi	n
outslidin	g
outslin	k
outslink	eis
outslinke	d
outslinki	n
outslinkin	g
outslu	n
outslun	k
outsm	aei
outsma	r
outsmar	t
outsme	l
outsmel	lt
outsmell	eis
outsmelle	d
outsmelli	n
outsmellin	g
outsmi	l
outsmil	ei
outsmile	ds
outsmili	n
outsmilin	g
outsn	ao
outsna	t
outsnat	c
outsnatc	h
outsnatch	ei
outsnatche	ds
outsnatchi	n
outsnatchin	g
outsno	r
outsnor	ei
outsnore	ds
outsnori	n
outsnorin	g
outso	anu
outsoa	r
outsoar	eis
outsoare	d
outsoari	n
outsoarin	g
outson	n
outsonn	e
outsonne	t
outsonnet	eis
outsonnete	d
outsonneti	n
outsonnetin	g
outsou	gr
outsoug	h
outsough	t
outsour	c
outsourc	ei
outsource	ds
outsourci	n
outsourcin	g
outsourcing	s
outsp	aeioruy
outspa	nr
outspar	k
outspark	l
outsparkl	ei
outsparkle	ds
outsparkli	n
outsparklin	g
outspe	de
outspee	d
outspeed	eis
outspeede	d
outspeedi	n
outspeedin	g
outspi	enr
outspie	ds
outspin	ns
outspinn	i
outspinni	n
outspinnin	g
outspir	i
outspiri	t
outspirit	eis
outspirite	d
outspiriti	n
outspiritin	g
outspo	kr
outspok	e
outspoke	n
outspoken	ln
outspokenl	y
outspokenn	e
outspokenne	s
outspokennes	s
outspokenness	e
outspokennesse	s
outspor	t
outsport	eis
outsporte	d
outsporti	n
outsportin	g
outspr	aeiu
outspra	n
outspran	g
outspre	a
outsprea	d
outspri	n
outsprin	gt
outspring	is
outspringi	n
outspringin	g
outsprint	eis
outsprinte	d
outsprinti	n
outsprintin	g
outspru	n
outsprun	g
outspu	nr
outspur	nt
outspurn	eis
outspurne	d
outspurni	n
outspurnin	g
outspurt	eis
outspurte	d
outspurti	n
outspurtin	g
outspy	i
outspyi	n
outspyin	g
outst	aeioru
outsta	gnrt
outstag	g
outstagg	e
outstagge	r
outstagger	eis
outstaggere	d
outstaggeri	n
outstaggerin	g
outstan	dk
outstand	i
outstandi	n
outstandin	g
outstanding	ln
outstandingl	y
outstandingn	e
outstandingne	s
outstandingnes	s
outstandingness	e
outstandingnesse	s
outstar	t
outstart	l
outstartl	ei
outstartle	ds
outstartli	n
outstartlin	g
outstat	ei
outstate	ds
outstati	no
outstatin	g
outstatio	n
outste	ap
outstea	lm
outsteal	is
outsteali	n
outstealin	g
outsteam	eis
outsteame	d
outsteami	n
outsteamin	g
outstep	ps
outstepp	ei
outsteppe	d
outsteppi	n
outsteppin	g
outsti	n
outstin	gk
outsting	is
outstingi	n
outstingin	g
outstink	is
outstinki	n
outstinkin	g
outsto	lr
outstol	e
outstole	n
outstor	m
outstorm	eis
outstorme	d
outstormi	n
outstormin	g
outstr	aeiou
outstra	i
outstrai	n
outstre	at
outstrea	m
outstream	eis
outstreame	d
outstreami	n
outstreamin	g
outstret	c
outstretc	h
outstretch	e
outstretche	d
outstri	cdkpv
outstric	k
outstrick	e
outstricke	n
outstrid	dei
outstridd	e
outstridde	n
outstride	s
outstridi	n
outstridin	g
outstrik	ei
outstrike	s
outstriki	n
outstrikin	g
outstrip	ps
outstripp	ei
outstrippe	d
outstrippi	n
outstrippin	g
outstriv	ei
outstrive	ns
outstrivi	n
outstrivin	g
outstro	dv
outstrod	e
outstrov	e
outstru	c
outstruc	k
outstu	dn
outstud	iy
outstudi	e
outstudie	ds
outstudy	i
outstudyi	n
outstudyin	g
outstun	gk
outsu	cflm
outsuc	k
outsuck	eis
outsucke	d
outsucki	n
outsuckin	g
outsuf	f
outsuff	e
outsuffe	r
outsuffer	eis
outsuffere	d
outsufferi	n
outsufferin	g
outsul	k
outsulk	eis
outsulke	d
outsulki	n
outsulkin	g
outsum	ms
outsumm	ei
outsumme	d
outsummi	n
outsummin	g
outsw	aeiou
outswa	gm
outswag	g
outswagg	e
outswagge	r
outswagger	eis
outswaggere	d
outswaggeri	n
outswaggerin	g
outswe	ael
outswea	r
outswear	is
outsweari	n
outswearin	g
outswee	t
outsweet	e
outsweete	n
outsweeten	eis
outsweetene	d
outsweeteni	n
outsweetenin	g
outswel	l
outswi	mnr
outswim	ms
outswimm	i
outswimmi	n
outswimmin	g
outswin	d
outswind	l
outswindl	ei
outswindle	ds
outswindli	n
outswindlin	g
outswir	l
outswirl	eis
outswirle	d
outswirli	n
outswirlin	g
outswo	r
outswor	en
outswu	m
outt	aehior
outta	l
outtal	k
outtalk	eis
outtalke	d
outtalki	n
outtalkin	g
outte	a
outtea	s
outteas	ei
outtease	ds
outteasi	n
outteasin	g
outth	ioru
outthi	n
outthin	k
outthink	is
outthinki	n
outthinkin	g
outtho	u
outthou	g
outthoug	h
outthough	t
outthr	eo
outthre	aw
outthrea	t
outthreat	e
outthreate	n
outthreaten	eis
outthreatene	d
outthreateni	n
outthreatenin	g
outthro	bw
outthrob	bs
outthrobb	ei
outthrobbe	d
outthrobbi	n
outthrobbin	g
outthrow	ins
outthrowi	n
outthrowin	g
outthu	n
outthun	d
outthund	e
outthunde	r
outthunder	eis
outthundere	d
outthunderi	n
outthunderin	g
outti	n
outtin	k
outtink	l
outtinkl	ei
outtinkle	ds
outtinkli	n
outtinklin	g
outto	n
outton	g
outtong	u
outtongu	ei
outtongue	ds
outtongui	n
outtonguin	g
outtr	ai
outtra	dv
outtrad	ei
outtrade	ds
outtradi	n
outtradin	g
outtrav	e
outtrave	l
outtravel	eils
outtravele	d
outtraveli	n
outtravelin	g
outtravell	ei
outtravelle	d
outtravelli	n
outtravellin	g
outtri	c
outtric	k
outtrick	eis
outtricke	d
outtricki	n
outtrickin	g
outv	aeioy
outva	ln
outval	u
outvalu	ei
outvalue	ds
outvalui	n
outvaluin	g
outvan	i
outvani	s
outvanis	h
outvanish	ei
outvanishe	ds
outvanishi	n
outvanishin	g
outve	n
outven	o
outveno	m
outvenom	eis
outvenome	d
outvenomi	n
outvenomin	g
outvi	el
outvie	ds
outvil	l
outvill	a
outvilla	i
outvillai	n
outvo	ity
outvoi	c
outvoic	ei
outvoice	ds
outvoici	n
outvoicin	g
outvot	ei
outvote	ds
outvoti	n
outvotin	g
outvoy	a
outvoya	g
outvoyag	ei
outvoyage	ds
outvoyagi	n
outvoyagin	g
outvy	i
outvyi	n
outvyin	g
outw	aehior
outwa	ilnrstv
outwai	t
outwait	eis
outwaite	d
outwaiti	n
outwaitin	g
outwal	ekl
outwalk	eis
outwalke	d
outwalki	n
outwalkin	g
outwall	o
outwallo	p
outwallop	eis
outwallope	d
outwallopi	n
outwallopin	g
outwan	d
outwand	e
outwande	r
outwander	eis
outwandere	d
outwanderi	n
outwanderin	g
outwar	d
outward	lms
outwardl	y
outwardm	o
outwardmo	s
outwardmos	t
outwas	ht
outwast	ei
outwaste	ds
outwasti	n
outwastin	g
outwat	ce
outwatc	h
outwatch	ei
outwatche	ds
outwatchi	n
outwatchin	g
outwate	r
outwater	eis
outwatere	d
outwateri	n
outwaterin	g
outwav	ei
outwave	ds
outwavi	n
outwavin	g
outwe	ai
outwea	prv
outweap	o
outweapo	n
outweapon	e
outweapone	d
outwear	iy
outweari	e
outwearie	ds
outweary	i
outwearyi	n
outwearyin	g
outweav	ei
outweave	ds
outweavi	n
outweavin	g
outwei	g
outweig	h
outweigh	eis
outweighe	d
outweighi	n
outweighin	g
outwh	i
outwhi	r
outwhir	l
outwhirl	eis
outwhirle	d
outwhirli	n
outwhirlin	g
outwi	gnst
outwig	g
outwigg	l
outwiggl	ei
outwiggle	ds
outwiggli	n
outwigglin	g
outwin	g
outwing	eis
outwinge	d
outwingi	n
outwingin	g
outwis	h
outwish	ei
outwishe	ds
outwishi	n
outwishin	g
outwit	st
outwitt	ei
outwitte	d
outwitti	n
outwittin	g
outwo	orv
outwoo	d
outwor	dk
outword	eis
outworde	d
outwordi	n
outwordin	g
outwork	es
outworke	dr
outwov	e
outwove	n
outwr	aeiou
outwra	n
outwran	g
outwrang	l
outwrangl	ei
outwrangle	ds
outwrangli	n
outwranglin	g
outwre	ns
outwren	c
outwrenc	h
outwrench	ei
outwrenche	ds
outwrenchi	n
outwrenchin	g
outwres	t
outwrest	l
outwrestl	ei
outwrestle	ds
outwrestli	n
outwrestlin	g
outwri	gnt
outwrig	g
outwrigg	l
outwriggl	ei
outwriggle	ds
outwriggli	n
outwrigglin	g
outwrin	g
outwring	is
outwringi	n
outwringin	g
outwrit	eit
outwrite	s
outwriti	n
outwritin	g
outwritt	e
outwritte	n
outwro	tu
outwrot	e
outwrou	g
outwroug	h
outwrough	t
outwru	n
outwrun	g
outy	ei
outye	l
outyel	lp
outyell	eis
outyelle	d
outyelli	n
outyellin	g
outyelp	eis
outyelpe	d
outyelpi	n
outyelpin	g
outyi	e
outyie	l
outyiel	d
outyield	eis
outyielde	d
outyieldi	n
outyieldin	g
ouu	mtu
ouv	d
ouw	u
oux	v
ouz	eo
ouze	l
ov	aefijnorsuvz
ova	lrt
oval	ilns
ovali	ft
ovalif	o
ovalifo	r
ovalifor	m
ovalit	iy
ovaliti	e
ovalitie	s
ovall	y
ovaln	e
ovalne	s
ovalnes	s
ovalness	e
ovalnesse	s
ovar	iy
ovari	ae
ovaria	n
ovarie	s
ovat	ei
ovati	o
ovatio	n
ovation	as
ovationa	l
ove	nr
oven	abelsw
ovena	b
ovenab	l
ovenabl	e
ovenb	i
ovenbi	r
ovenbir	d
ovene	t
ovenet	t
ovenett	e
ovenl	i
ovenli	k
ovenlik	e
ovenw	a
ovenwa	r
ovenwar	e
over	abcdefghijklmnopqrstuvwz
overa	bcdfglmnprstw
overab	losu
overabl	ey
overabo	u
overabou	n
overaboun	d
overabound	eis
overabounde	d
overaboundi	n
overaboundin	g
overabs	ot
overabso	r
overabsor	bp
overabsorb	eis
overabsorbe	d
overabsorbi	n
overabsorbin	g
overabsorp	t
overabsorpt	i
overabsorpti	o
overabsorptio	n
overabsorption	s
overabst	ar
overabsta	i
overabstai	n
overabstain	eis
overabstaine	d
overabstaini	n
overabstainin	g
overabstr	a
overabstra	c
overabstrac	t
overabstract	eis
overabstracte	d
overabstracti	n
overabstractin	g
overabu	ns
overabun	d
overabund	a
overabunda	n
overabundan	ct
overabundanc	e
overabundance	s
overabus	ei
overabuse	ds
overabusi	nv
overabusin	g
overabusiv	e
overabusive	ln
overabusivel	y
overabusiven	e
overabusivene	s
overabusivenes	s
overabusiveness	e
overabusivenesse	s
overac	citu
overacc	eu
overacce	ln
overaccel	e
overaccele	r
overacceler	a
overaccelera	t
overaccelerat	ei
overaccelerate	ds
overaccelerati	n
overacceleratin	g
overaccen	t
overaccent	u
overaccentu	a
overaccentua	t
overaccentuat	ei
overaccentuate	ds
overaccentuati	n
overaccentuatin	g
overaccu	m
overaccum	u
overaccumu	l
overaccumul	a
overaccumula	t
overaccumulat	ei
overaccumulate	ds
overaccumulati	n
overaccumulatin	g
overaci	d
overacid	i
overacidi	t
overacidit	iy
overaciditi	e
overaciditie	s
overact	i
overacti	v
overactiv	a
overactiva	t
overactivat	ei
overactivate	ds
overactivati	n
overactivatin	g
overacu	t
overacut	e
overacute	ln
overacutel	y
overacuten	e
overacutene	s
overacutenes	s
overacuteness	e
overacutenesse	s
overad	jov
overadj	u
overadju	s
overadjus	t
overadjust	eims
overadjuste	d
overadjusti	n
overadjustin	g
overadjustm	e
overadjustme	n
overadjustmen	t
overadjustment	s
overado	r
overador	n
overadorn	eis
overadorne	d
overadorni	n
overadornin	g
overadv	ae
overadva	n
overadvan	c
overadvanc	ei
overadvance	ds
overadvanci	n
overadvancin	g
overadve	r
overadver	t
overadvert	i
overadverti	s
overadvertis	ei
overadvertise	ds
overadvertisi	n
overadvertisin	g
overaf	f
overaff	eil
overaffe	c
overaffec	t
overaffect	i
overaffecti	o
overaffectio	n
overaffection	a
overaffectiona	t
overaffectionat	e
overaffi	r
overaffir	m
overaffirm	aeis
overaffirma	t
overaffirmat	i
overaffirmati	v
overaffirmativ	e
overaffirmative	l
overaffirmativel	y
overaffirme	d
overaffirmi	n
overaffirmin	g
overaffl	i
overaffli	c
overafflic	t
overafflict	eis
overafflicte	d
overafflicti	n
overafflictin	g
overag	egi
overagg	r
overaggr	ae
overaggra	v
overaggrav	a
overaggrava	t
overaggravat	ei
overaggravate	ds
overaggravati	n
overaggravatin	g
overaggre	s
overaggres	s
overaggress	i
overaggressi	v
overaggressiv	e
overaggressive	ln
overaggressivel	y
overaggressiven	e
overaggressivene	s
overaggressivenes	s
overaggressiveness	e
overaggressivenesse	s
overagi	t
overagit	a
overagita	t
overagitat	ei
overagitate	ds
overagitati	n
overagitatin	g
overal	el
overale	r
overaler	t
overall	es
overalle	g
overalleg	i
overallegi	a
overallegia	n
overallegian	c
overallegianc	e
overallegiance	s
overam	bp
overamb	i
overambi	t
overambit	i
overambiti	o
overambitio	u
overambitiou	s
overambitious	ln
overambitiousl	y
overambitiousn	e
overambitiousne	s
overambitiousnes	s
overambitiousness	e
overambitiousnesse	s
overamp	l
overampl	i
overampli	f
overamplif	iy
overamplifi	e
overamplifie	ds
overamplify	i
overamplifyi	n
overamplifyin	g
overan	aginx
overana	l
overanal	y
overanaly	stz
overanalys	ei
overanalyse	s
overanalysi	s
overanalyt	i
overanalyti	c
overanalytic	a
overanalytica	l
overanalyz	ei
overanalyze	ds
overanalyzi	n
overanalyzin	g
overang	r
overangr	y
overani	m
overanim	a
overanima	t
overanimat	ei
overanimate	d
overanimated	l
overanimatedl	y
overanimati	o
overanimatio	n
overanimation	s
overann	o
overanno	t
overannot	a
overannota	t
overannotat	ei
overannotate	ds
overannotati	n
overannotatin	g
overanx	i
overanxi	e
overanxie	t
overanxiet	i
overanxieti	e
overanxietie	s
overap	pt
overapp	lr
overappl	ai
overappla	u
overapplau	d
overapplaud	eis
overapplaude	d
overapplaudi	n
overapplaudin	g
overappli	c
overapplic	a
overapplica	t
overapplicat	i
overapplicati	o
overapplicatio	n
overapplication	s
overappr	ae
overappra	i
overapprai	s
overapprais	aei
overappraisa	l
overappraisal	s
overappraise	ds
overappraisi	n
overappraisin	g
overappre	ch
overapprec	i
overappreci	a
overapprecia	t
overappreciat	i
overappreciati	ov
overappreciatio	n
overappreciation	s
overappreciativ	e
overappreciative	ln
overappreciativel	y
overappreciativen	e
overappreciativene	s
overappreciativenes	s
overappreciativeness	e
overappreciativenesse	s
overappreh	e
overapprehe	n
overapprehen	s
overapprehens	i
overapprehensi	v
overapprehensiv	e
overapprehensive	ln
overapprehensivel	y
overapprehensiven	e
overapprehensivene	s
overapprehensivenes	s
overapprehensiveness	e
overapprehensivenesse	s
overapt	ln
overaptl	y
overaptn	e
overaptne	s
overaptnes	s
overaptness	e
overaptnesse	s
overar	cgmort
overarc	h
overarg	u
overargu	eim
overargue	ds
overargui	n
overarguin	g
overargum	e
overargume	n
overargumen	t
overargument	a
overargumenta	t
overargumentat	i
overargumentati	v
overargumentativ	e
overargumentative	ln
overargumentativel	y
overargumentativen	e
overargumentativene	s
overargumentativenes	s
overargumentativeness	e
overargumentativenesse	s
overaro	u
overarou	s
overarous	a
overarousa	l
overarousal	s
overarr	a
overarra	n
overarran	g
overarrang	ei
overarrange	ds
overarrangi	n
overarrangin	g
overart	i
overarti	cf
overartic	u
overarticu	l
overarticul	a
overarticula	t
overarticulat	ei
overarticulate	ds
overarticulati	no
overarticulatin	g
overarticulatio	n
overartif	i
overartifi	c
overartific	i
overartifici	a
overartificia	l
overartificial	l
overartificiall	y
overas	s
overass	eiu
overasse	rs
overasser	t
overassert	eis
overasserte	d
overasserti	nov
overassertin	g
overassertio	n
overassertion	s
overassertiv	e
overassertive	ln
overassertivel	y
overassertiven	e
overassertivene	s
overassertivenes	s
overassertiveness	e
overassertivenesse	s
overasses	s
overassess	eim
overassesse	ds
overassessi	n
overassessin	g
overassessm	e
overassessme	n
overassessmen	t
overassessment	s
overassi	s
overassis	t
overassist	eis
overassiste	d
overassisti	n
overassistin	g
overassu	mr
overassum	eip
overassume	ds
overassumi	n
overassumin	g
overassump	t
overassumpt	i
overassumpti	o
overassumptio	n
overassumption	s
overassur	e
overassure	d
overassured	ln
overassuredl	y
overassuredn	e
overassuredne	s
overassurednes	s
overassuredness	e
overassurednesse	s
overat	t
overatt	ae
overatta	c
overattac	h
overattach	em
overattache	d
overattachm	e
overattachme	n
overattachmen	t
overattachment	s
overatte	n
overatten	t
overattent	i
overattenti	ov
overattentio	n
overattention	s
overattentiv	e
overattentive	ln
overattentivel	y
overattentiven	e
overattentivene	s
overattentivenes	s
overattentiveness	e
overattentivenesse	s
overaw	aei
overawa	r
overawar	de
overaware	n
overawaren	e
overawarene	s
overawarenes	s
overawareness	e
overawarenesse	s
overawe	ds
overawi	n
overawin	g
overb	aeiloru
overba	iklnrs
overbai	t
overbait	eis
overbaite	d
overbaiti	n
overbaitin	g
overbak	ei
overbake	ds
overbaki	n
overbakin	g
overbal	al
overbala	n
overbalan	c
overbalanc	ei
overbalance	ds
overbalanci	n
overbalancin	g
overball	a
overballa	s
overballas	t
overballast	eis
overballaste	d
overballasti	n
overballastin	g
overban	k
overbar	k
overbas	h
overbash	f
overbashf	u
overbashfu	l
overbashful	ln
overbashfull	y
overbashfuln	e
overbashfulne	s
overbashfulnes	s
overbashfulness	e
overbashfulnesse	s
overbe	ajl
overbea	rt
overbear	i
overbeari	n
overbearin	g
overbearing	ln
overbearingl	y
overbearingn	e
overbearingne	s
overbearingnes	s
overbearingness	e
overbearingnesse	s
overbeat	eis
overbeate	n
overbeati	n
overbeatin	g
overbej	e
overbeje	w
overbejew	e
overbejewe	l
overbejewel	e
overbejewele	d
overbel	i
overbeli	e
overbelie	f
overbi	adlt
overbia	s
overbil	l
overbill	eis
overbille	d
overbilli	n
overbillin	g
overbit	t
overbitt	e
overbitte	r
overbitter	ln
overbitterl	y
overbittern	e
overbitterne	s
overbitternes	s
overbitterness	e
overbitternesse	s
overbl	aeio
overbla	mn
overblam	ei
overblame	ds
overblami	n
overblamin	g
overblan	k
overblank	e
overblanke	t
overble	a
overblea	c
overbleac	h
overbleach	ei
overbleache	ds
overbleachi	n
overbleachin	g
overbli	n
overblin	d
overblo	w
overblow	n
overbo	ailr
overboa	rs
overboar	d
overboas	t
overboast	f
overboastf	u
overboastfu	l
overboastful	ln
overboastfull	y
overboastfuln	e
overboastfulne	s
overboastfulnes	s
overboastfulness	e
overboastfulnesse	s
overboi	l
overboil	eis
overboile	d
overboili	n
overboilin	g
overbol	d
overbold	ln
overboldl	y
overboldn	e
overboldne	s
overboldnes	s
overboldness	e
overboldnesse	s
overbor	r
overborr	o
overborro	w
overborrow	eis
overborrowe	d
overborrowi	n
overborrowin	g
overbr	aeiou
overbra	cgv
overbrac	ei
overbrace	ds
overbraci	n
overbracin	g
overbrag	gs
overbragg	ei
overbragge	d
overbraggi	n
overbraggin	g
overbrav	ae
overbrava	d
overbravad	io
overbrave	ln
overbravel	y
overbraven	e
overbravene	s
overbravenes	s
overbraveness	e
overbravenesse	s
overbre	ae
overbrea	t
overbreat	h
overbreath	i
overbreathi	n
overbreathin	g
overbree	d
overbreed	is
overbreedi	n
overbreedin	g
overbri	degl
overbrid	g
overbridg	e
overbrie	f
overbrief	eis
overbriefe	d
overbriefi	n
overbriefin	g
overbrig	h
overbrigh	t
overbright	ln
overbrightl	y
overbrightn	e
overbrightne	s
overbrightnes	s
overbrightness	e
overbrightnesse	s
overbril	l
overbrill	i
overbrilli	a
overbrillia	n
overbrillian	t
overbrilliant	l
overbrilliantl	y
overbro	aow
overbroa	d
overbroad	e
overbroade	n
overbroaden	eis
overbroadene	d
overbroadeni	n
overbroadenin	g
overbroo	d
overbrow	ns
overbrown	eis
overbrowne	d
overbrowni	n
overbrownin	g
overbrows	ei
overbrowse	ds
overbrowsi	n
overbrowsin	g
overbru	t
overbrut	a
overbruta	l
overbrutal	l
overbrutall	y
overbu	dlmrsy
overbud	g
overbudg	e
overbudge	t
overbul	kl
overbulk	iy
overbulki	ln
overbulkil	y
overbulkin	e
overbulkine	s
overbulkines	s
overbulkiness	e
overbulkinesse	s
overbum	p
overbur	dn
overburd	e
overburde	n
overburn	eist
overburne	d
overburni	n
overburnin	g
overbus	i
overbusi	n
overbusin	e
overbusine	s
overbusines	s
overbusiness	e
overbusinesse	s
overc	aehiloru
overca	mnprstu
overcam	e
overcan	o
overcano	p
overcanop	y
overcap	ai
overcapa	bc
overcapab	il
overcapabi	l
overcapabil	i
overcapabili	t
overcapabilit	iy
overcapabiliti	e
overcapabilitie	s
overcapabl	e
overcapac	i
overcapaci	t
overcapacit	y
overcapi	t
overcapit	a
overcapita	l
overcapital	i
overcapitali	sz
overcapitalis	e
overcapitaliz	e
overcar	e
overcare	fls
overcaref	u
overcarefu	l
overcarel	e
overcarele	s
overcareles	s
overcareless	ln
overcarelessl	y
overcarelessn	e
overcarelessne	s
overcarelessnes	s
overcarelessness	e
overcarelessnesse	s
overcas	tu
overcast	s
overcasu	a
overcasua	l
overcasual	ln
overcasuall	y
overcasualn	e
overcasualne	s
overcasualnes	s
overcasualness	e
overcasualnesse	s
overcat	c
overcatc	h
overcau	st
overcaus	t
overcaust	i
overcausti	c
overcaustic	ai
overcaustica	l
overcaustical	l
overcausticall	y
overcaustici	t
overcausticit	iy
overcausticiti	e
overcausticitie	s
overcaut	i
overcauti	o
overcautio	n
overcaution	eis
overcautione	d
overcautioni	n
overcautionin	g
overce	nr
overcen	st
overcens	o
overcenso	r
overcensor	eis
overcensore	d
overcensori	n
overcensorin	g
overcent	r
overcentr	a
overcentra	l
overcentral	i
overcentrali	z
overcentraliz	aei
overcentraliza	t
overcentralizat	i
overcentralizati	o
overcentralizatio	n
overcentralization	s
overcentralize	s
overcentralizi	n
overcentralizin	g
overcer	e
overcere	b
overcereb	r
overcerebr	a
overcerebra	l
overch	aeio
overcha	r
overchar	gi
overcharg	ei
overcharge	drs
overcharger	s
overchargi	n
overchargin	g
overchari	t
overcharit	aiy
overcharita	b
overcharitab	l
overcharitabl	ey
overcharitable	n
overcharitablen	e
overcharitablene	s
overcharitablenes	s
overcharitableness	e
overcharitablenesse	s
overchariti	e
overcharitie	s
overche	ar
overchea	p
overcheap	ln
overcheapl	y
overcheapn	e
overcheapne	s
overcheapnes	s
overcheapness	e
overcheapnesse	s
overcher	i
overcheri	s
overcheris	h
overcherish	ei
overcherishe	ds
overcherishi	n
overcherishin	g
overchi	l
overchil	dl
overchild	i
overchildi	s
overchildis	h
overchildish	ln
overchildishl	y
overchildishn	e
overchildishne	s
overchildishnes	s
overchildishness	e
overchildishnesse	s
overchill	eis
overchille	d
overchilli	n
overchillin	g
overcho	s
overchos	e
overchose	n
overci	rv
overcir	c
overcirc	u
overcircu	m
overcircum	s
overcircums	p
overcircumsp	e
overcircumspe	c
overcircumspec	t
overciv	i
overcivi	l
overcivil	il
overcivili	z
overciviliz	aei
overciviliza	t
overcivilizat	i
overcivilizati	o
overcivilizatio	n
overcivilization	s
overcivilize	ds
overcivilizi	n
overcivilizin	g
overcivill	y
overcl	aeiou
overcla	ims
overclai	m
overclaim	eis
overclaime	d
overclaimi	n
overclaimin	g
overclam	o
overclamo	u
overclamou	r
overclas	s
overclass	i
overclassi	f
overclassif	iy
overclassifi	ce
overclassific	a
overclassifica	t
overclassificat	i
overclassificati	o
overclassificatio	n
overclassification	s
overclassifie	ds
overclassify	i
overclassifyi	n
overclassifyin	g
overcle	amv
overclea	nr
overclean	eilns
overcleane	d
overcleani	n
overcleanin	g
overcleanl	y
overcleann	e
overcleanne	s
overcleannes	s
overcleanness	e
overcleannesse	s
overclem	e
overcleme	n
overclemen	c
overclemenc	iy
overclemenci	e
overclemencie	s
overclev	e
overcleve	r
overclever	ln
overcleverl	y
overclevern	e
overcleverne	s
overclevernes	s
overcleverness	e
overclevernesse	s
overcli	n
overclin	i
overclini	c
overclinic	a
overclinica	l
overclinical	l
overclinicall	y
overclo	agsuy
overcloa	k
overclog	gs
overclogg	ei
overclogge	d
overcloggi	n
overcloggin	g
overclos	e
overclose	ln
overclosel	y
overclosen	e
overclosene	s
overclosenes	s
overcloseness	e
overclosenesse	s
overclou	d
overclu	t
overclut	t
overclutt	e
overclutte	r
overclutter	eis
overcluttere	d
overclutteri	n
overclutterin	g
overco	ailmnoprsuy
overcoa	ct
overcoac	h
overcoach	ei
overcoache	ds
overcoachi	n
overcoachin	g
overcoat	els
overcoate	d
overcoatl	e
overcoatle	s
overcoatles	s
overcoi	l
overcol	do
overcold	l
overcoldl	y
overcolo	r
overcolor	is
overcolori	n
overcolorin	g
overcom	aeimp
overcoma	b
overcomab	l
overcomabl	e
overcome	rs
overcomer	s
overcomi	n
overcomin	g
overcoming	l
overcomingl	y
overcomm	eiou
overcomme	nr
overcommen	d
overcommend	eis
overcommende	d
overcommendi	n
overcommendin	g
overcommer	c
overcommerc	i
overcommerci	a
overcommercia	l
overcommercial	i
overcommerciali	z
overcommercializ	aei
overcommercializa	t
overcommercializat	i
overcommercializati	o
overcommercializatio	n
overcommercialization	s
overcommercialize	ds
overcommercializi	n
overcommercializin	g
overcommi	t
overcommo	n
overcommon	ln
overcommonl	y
overcommonn	e
overcommonne	s
overcommonnes	s
overcommonness	e
overcommonnesse	s
overcommu	n
overcommun	i
overcommuni	c
overcommunic	a
overcommunica	t
overcommunicat	ei
overcommunicate	ds
overcommunicati	nov
overcommunicatin	g
overcommunicatio	n
overcommunication	s
overcommunicativ	e
overcomp	elor
overcompe	nt
overcompen	s
overcompens	a
overcompensa	t
overcompensat	i
overcompensati	o
overcompensatio	n
overcompet	i
overcompeti	t
overcompetit	i
overcompetiti	v
overcompetitiv	e
overcompetitive	ln
overcompetitivel	y
overcompetitiven	e
overcompetitivene	s
overcompetitivenes	s
overcompetitiveness	e
overcompetitivenesse	s
overcompl	aei
overcompla	c
overcomplac	e
overcomplace	n
overcomplacen	t
overcomplacent	l
overcomplacentl	y
overcomple	x
overcomplex	i
overcomplexi	t
overcomplexit	iy
overcomplexiti	e
overcomplexitie	s
overcompli	ac
overcomplia	n
overcomplian	ct
overcomplianc	e
overcompliance	s
overcomplic	a
overcomplica	t
overcomplicat	ei
overcomplicate	ds
overcomplicati	n
overcomplicatin	g
overcompo	u
overcompou	n
overcompoun	d
overcompound	i
overcompoundi	n
overcompoundin	g
overcompr	e
overcompre	s
overcompres	s
overcompress	ei
overcompresse	ds
overcompressi	n
overcompressin	g
overcon	cdfst
overconc	e
overconce	nr
overconcen	t
overconcent	r
overconcentr	a
overconcentra	t
overconcentrat	ei
overconcentrate	ds
overconcentrati	no
overconcentratin	g
overconcentratio	n
overconcentration	s
overconcer	n
overconcern	eis
overconcerne	d
overconcerni	n
overconcernin	g
overcond	e
overconde	n
overconden	s
overcondens	aei
overcondensa	t
overcondensat	i
overcondensati	o
overcondensatio	n
overcondensation	s
overcondense	ds
overcondensi	n
overcondensin	g
overconf	i
overconfi	d
overconfid	e
overconfide	n
overconfiden	ct
overconfidenc	e
overconfidence	s
overconfident	l
overconfidentl	y
overcons	ceiotu
overconsc	i
overconsci	eo
overconscie	n
overconscien	t
overconscient	i
overconscienti	o
overconscientio	u
overconscientiou	s
overconscientious	ln
overconscientiousl	y
overconscientiousn	e
overconscientiousne	s
overconscientiousnes	s
overconscientiousness	e
overconscientiousnesse	s
overconscio	u
overconsciou	s
overconscious	ln
overconsciousl	y
overconsciousn	e
overconsciousne	s
overconsciousnes	s
overconsciousness	e
overconsciousnesse	s
overconse	r
overconser	v
overconserv	a
overconserva	t
overconservat	i
overconservati	sv
overconservatis	m
overconservatism	s
overconservativ	e
overconservative	ln
overconservativel	y
overconservativen	e
overconservativene	s
overconservativenes	s
overconservativeness	e
overconservativenesse	s
overconsi	d
overconsid	e
overconside	r
overconsider	a
overconsidera	t
overconsiderat	ei
overconsiderate	ln
overconsideratel	y
overconsideraten	e
overconsideratene	s
overconsideratenes	s
overconsiderateness	e
overconsideratenesse	s
overconsiderati	o
overconsideratio	n
overconsideration	s
overconso	l
overconsol	i
overconsoli	d
overconsolid	a
overconsolida	t
overconsolidat	ei
overconsolidate	d
overconsolidati	o
overconsolidatio	n
overconst	ar
overconsta	n
overconstan	t
overconstant	ln
overconstantl	y
overconstantn	e
overconstantne	s
overconstantnes	s
overconstantness	e
overconstantnesse	s
overconstr	u
overconstru	c
overconstruc	t
overconstruct	eis
overconstructe	d
overconstructi	n
overconstructin	g
overconsu	m
overconsum	eip
overconsume	ds
overconsumi	n
overconsumin	g
overconsump	t
overconsumpt	i
overconsumpti	o
overconsumptio	n
overconsumption	s
overcont	er
overconte	n
overconten	t
overcontent	eim
overcontente	d
overcontented	ln
overcontentedl	y
overcontentedn	e
overcontentedne	s
overcontentednes	s
overcontentedness	e
overcontentednesse	s
overcontenti	o
overcontentio	u
overcontentiou	s
overcontentious	ln
overcontentiousl	y
overcontentiousn	e
overcontentiousne	s
overcontentiousnes	s
overcontentiousness	e
overcontentiousnesse	s
overcontentm	e
overcontentme	n
overcontentmen	t
overcontentment	s
overcontr	aio
overcontra	c
overcontrac	t
overcontract	eis
overcontracte	d
overcontracti	no
overcontractin	g
overcontractio	n
overcontraction	s
overcontri	b
overcontrib	u
overcontribu	t
overcontribut	ei
overcontribute	ds
overcontributi	no
overcontributin	g
overcontributio	n
overcontribution	s
overcontro	l
overcontrol	eils
overcontrole	d
overcontroli	n
overcontrolin	g
overcontroll	ei
overcontrolle	d
overcontrolli	n
overcontrollin	g
overcoo	kl
overcook	eis
overcooke	d
overcooki	n
overcookin	g
overcool	eilns
overcoole	d
overcooli	n
overcoolin	g
overcooll	y
overcooln	e
overcoolne	s
overcoolnes	s
overcoolness	e
overcoolnesse	s
overcop	i
overcopi	o
overcopio	u
overcopiou	s
overcopious	ln
overcopiousl	y
overcopiousn	e
overcopiousne	s
overcopiousnes	s
overcopiousness	e
overcopiousnesse	s
overcor	r
overcorr	eu
overcorre	c
overcorrec	t
overcorrect	eis
overcorrecte	d
overcorrecti	n
overcorrectin	g
overcorru	p
overcorrup	t
overcorrupt	eils
overcorrupte	d
overcorrupti	no
overcorruptin	g
overcorruptio	n
overcorruption	s
overcorruptl	y
overcos	t
overcost	l
overcostl	iy
overcostli	n
overcostlin	e
overcostline	s
overcostlines	s
overcostliness	e
overcostlinesse	s
overcou	nr
overcoun	t
overcount	is
overcounti	n
overcountin	g
overcour	t
overcourt	e
overcourte	os
overcourteo	u
overcourteou	s
overcourteous	ln
overcourteousl	y
overcourteousn	e
overcourteousne	s
overcourteousnes	s
overcourteousness	e
overcourteousnesse	s
overcourtes	iy
overcourtesi	e
overcourtesie	s
overcoy	ln
overcoyl	y
overcoyn	e
overcoyne	s
overcoynes	s
overcoyness	e
overcoynesse	s
overcr	eio
overcre	de
overcred	iu
overcredi	t
overcredit	eis
overcredite	d
overcrediti	n
overcreditin	g
overcredu	l
overcredul	o
overcredulo	u
overcredulou	s
overcree	p
overcri	t
overcrit	i
overcriti	c
overcritic	ai
overcritica	l
overcritici	sz
overcriticis	m
overcriticism	s
overcriticiz	ei
overcriticize	ds
overcriticizi	n
overcriticizin	g
overcro	psw
overcros	s
overcrow	d
overcrowd	eis
overcrowde	d
overcrowded	ln
overcrowdedl	y
overcrowdedn	e
overcrowdedne	s
overcrowdednes	s
overcrowdedness	e
overcrowdednesse	s
overcrowdi	n
overcrowdin	g
overcu	lnprt
overcul	lt
overcull	eis
overculle	d
overculli	n
overcullin	g
overcult	iu
overculti	v
overcultiv	a
overcultiva	t
overcultivat	ei
overcultivate	ds
overcultivati	no
overcultivatin	g
overcultivatio	n
overcultivation	s
overcultu	r
overcultur	e
overculture	d
overcun	n
overcunn	i
overcunni	n
overcunnin	g
overcunning	ln
overcunningl	y
overcunningn	e
overcunningne	s
overcunningnes	s
overcunningness	e
overcunningnesse	s
overcur	eir
overcure	ds
overcuri	no
overcurin	g
overcurio	su
overcurios	i
overcuriosi	t
overcuriosit	i
overcuriositi	e
overcuriositie	s
overcuriou	s
overcurious	ln
overcuriousl	y
overcuriousn	e
overcuriousne	s
overcuriousnes	s
overcuriousness	e
overcuriousnesse	s
overcurr	e
overcurre	n
overcurren	t
overcut	t
overcutt	i
overcutti	n
overcuttin	g
overd	aeioru
overda	ityz
overdai	n
overdain	t
overdaint	iy
overdainti	ln
overdaintil	y
overdaintin	e
overdaintine	s
overdaintines	s
overdaintiness	e
overdaintinesse	s
overdat	e
overdate	d
overdaz	z
overdazz	l
overdazzl	ei
overdazzle	ds
overdazzli	n
overdazzlin	g
overde	bcdeflmnprsv
overdeb	ai
overdeba	t
overdebat	ei
overdebate	ds
overdebati	n
overdebatin	g
overdebi	l
overdebil	i
overdebili	t
overdebilit	a
overdebilita	t
overdebilitat	ei
overdebilitate	ds
overdebilitati	n
overdebilitatin	g
overdec	ao
overdeca	d
overdecad	e
overdecade	n
overdecaden	c
overdecadenc	e
overdecadence	s
overdeco	r
overdecor	a
overdecora	t
overdecorat	ei
overdecorate	s
overdecorati	nov
overdecoratin	g
overdecoratio	n
overdecoration	s
overdecorativ	e
overdecorative	ln
overdecorativel	y
overdecorativen	e
overdecorativene	s
overdecorativenes	s
overdecorativeness	e
overdecorativenesse	s
overded	i
overdedi	c
overdedic	a
overdedica	t
overdedicat	ei
overdedicate	ds
overdedicati	no
overdedicatin	g
overdedicatio	n
overdedication	s
overdee	p
overdeep	e
overdeepe	n
overdeepen	eis
overdeepene	d
overdeepeni	n
overdeepenin	g
overdef	ei
overdefe	n
overdefen	s
overdefens	i
overdefensi	v
overdefensiv	e
overdefensive	ln
overdefensivel	y
overdefensiven	e
overdefensivene	s
overdefensivenes	s
overdefensiveness	e
overdefensivenesse	s
overdefi	a
overdefia	n
overdefian	t
overdefiant	ln
overdefiantl	y
overdefiantn	e
overdefiantne	s
overdefiantnes	s
overdefiantness	e
overdefiantnesse	s
overdel	i
overdeli	bc
overdelib	e
overdelibe	r
overdeliber	a
overdelibera	t
overdeliberat	ei
overdeliberate	dlns
overdeliberatel	y
overdeliberaten	e
overdeliberatene	s
overdeliberatenes	s
overdeliberateness	e
overdeliberatenesse	s
overdeliberati	no
overdeliberatin	g
overdeliberatio	n
overdeliberation	s
overdelic	i
overdelici	o
overdelicio	u
overdeliciou	s
overdelicious	ln
overdeliciousl	y
overdeliciousn	e
overdeliciousne	s
overdeliciousnes	s
overdeliciousness	e
overdeliciousnesse	s
overdem	a
overdema	n
overdeman	d
overdemand	eis
overdemande	d
overdemandi	n
overdemandin	g
overdemanding	l
overdemandingl	y
overden	u
overdenu	n
overdenun	c
overdenunc	i
overdenunci	a
overdenuncia	t
overdenunciat	i
overdenunciati	o
overdenunciatio	n
overdenunciation	s
overdep	er
overdepe	n
overdepen	d
overdepend	e
overdepende	n
overdependen	ct
overdependenc	e
overdependence	s
overdepr	e
overdepre	s
overdepres	s
overdepress	ei
overdepresse	ds
overdepressi	n
overdepressin	g
overder	i
overderi	d
overderid	ei
overderide	ds
overderidi	n
overderidin	g
overdes	cit
overdesc	r
overdescr	i
overdescri	bp
overdescrib	ei
overdescribe	ds
overdescribi	n
overdescribin	g
overdescrip	t
overdescript	i
overdescripti	v
overdescriptiv	e
overdescriptive	ln
overdescriptivel	y
overdescriptiven	e
overdescriptivene	s
overdescriptivenes	s
overdescriptiveness	e
overdescriptivenesse	s
overdesi	r
overdesir	e
overdesire	s
overdest	r
overdestr	u
overdestru	c
overdestruc	t
overdestruct	i
overdestructi	v
overdestructiv	e
overdestructive	ln
overdestructivel	y
overdestructiven	e
overdestructivene	s
overdestructivenes	s
overdestructiveness	e
overdestructivenesse	s
overdev	eo
overdeve	l
overdevel	o
overdevelo	p
overdevo	t
overdevot	e
overdevote	d
overdevoted	ln
overdevotedl	y
overdevotedn	e
overdevotedne	s
overdevotednes	s
overdevotedness	e
overdevotednesse	s
overdi	dfglrsv
overdif	f
overdiff	eu
overdiffe	r
overdiffer	e
overdiffere	n
overdifferen	t
overdifferent	i
overdifferenti	a
overdifferentia	t
overdifferentiat	i
overdifferentiati	o
overdifferentiatio	n
overdifferentiation	s
overdiffu	s
overdiffus	ei
overdiffuse	dlns
overdiffusel	y
overdiffusen	e
overdiffusene	s
overdiffusenes	s
overdiffuseness	e
overdiffusenesse	s
overdiffusi	n
overdiffusin	g
overdig	e
overdige	s
overdiges	t
overdigest	eis
overdigeste	d
overdigesti	n
overdigestin	g
overdil	aiu
overdila	t
overdilat	ei
overdilate	ds
overdilati	n
overdilatin	g
overdili	g
overdilig	e
overdilige	n
overdiligen	t
overdiligent	ln
overdiligentl	y
overdiligentn	e
overdiligentne	s
overdiligentnes	s
overdiligentness	e
overdiligentnesse	s
overdilu	t
overdilut	ei
overdilute	ds
overdiluti	n
overdilutin	g
overdir	e
overdire	c
overdirec	t
overdirect	ei
overdirecte	d
overdirecti	n
overdirectin	g
overdis	cpt
overdisc	hioru
overdisch	a
overdischa	r
overdischar	g
overdischarg	e
overdisci	p
overdiscip	l
overdiscipl	i
overdiscipli	n
overdisciplin	ei
overdiscipline	ds
overdisciplini	n
overdisciplinin	g
overdisco	u
overdiscou	nr
overdiscoun	t
overdiscount	eis
overdiscounte	d
overdiscounti	n
overdiscountin	g
overdiscour	a
overdiscoura	g
overdiscourag	ei
overdiscourage	dms
overdiscouragem	e
overdiscourageme	n
overdiscouragemen	t
overdiscouragement	s
overdiscouragi	n
overdiscouragin	g
overdiscr	ei
overdiscre	e
overdiscree	t
overdiscreet	ln
overdiscreetl	y
overdiscreetn	e
overdiscreetne	s
overdiscreetnes	s
overdiscreetness	e
overdiscreetnesse	s
overdiscri	m
overdiscrim	i
overdiscrimi	n
overdiscrimin	a
overdiscrimina	t
overdiscriminat	i
overdiscriminati	n
overdiscriminatin	g
overdiscriminating	l
overdiscriminatingl	y
overdiscu	s
overdiscus	s
overdiscuss	ei
overdiscusse	ds
overdiscussi	n
overdiscussin	g
overdisp	e
overdispe	r
overdisper	s
overdispers	ei
overdisperse	d
overdispersi	o
overdispersio	n
overdist	aeor
overdista	n
overdistan	t
overdistant	l
overdistantl	y
overdiste	n
overdisten	d
overdistend	eis
overdistende	d
overdistendi	n
overdistendin	g
overdisto	r
overdistor	t
overdistort	eis
overdistorte	d
overdistorti	n
overdistortin	g
overdistr	a
overdistra	u
overdistrau	g
overdistraug	h
overdistraugh	t
overdiv	e
overdive	r
overdiver	s
overdivers	ei
overdiverse	ln
overdiversel	y
overdiversen	e
overdiversene	s
overdiversenes	s
overdiverseness	e
overdiversenesse	s
overdiversi	ft
overdiversif	iy
overdiversifi	e
overdiversifie	ds
overdiversify	i
overdiversifyi	n
overdiversifyin	g
overdiversit	iy
overdiversiti	e
overdiversitie	s
overdo	cegimnstu
overdoc	u
overdocu	m
overdocum	e
overdocume	n
overdocumen	t
overdocument	eis
overdocumente	d
overdocumenti	n
overdocumentin	g
overdoe	rs
overdoer	s
overdog	m
overdogm	a
overdogma	t
overdogmat	i
overdogmati	c
overdogmatic	a
overdogmatica	l
overdogmatical	ln
overdogmaticall	y
overdogmaticaln	e
overdogmaticalne	s
overdogmaticalnes	s
overdogmaticalness	e
overdogmaticalnesse	s
overdoi	n
overdoin	g
overdom	i
overdomi	n
overdomin	a
overdomina	t
overdominat	ei
overdominate	ds
overdominati	n
overdominatin	g
overdon	e
overdos	aei
overdosa	g
overdosag	e
overdosage	s
overdose	ds
overdosi	n
overdosin	g
overdou	b
overdoub	t
overdoubt	eis
overdoubte	d
overdoubti	n
overdoubtin	g
overdr	aeiuy
overdra	fimnw
overdraf	t
overdraft	s
overdrai	n
overdrain	aeis
overdraina	g
overdrainag	e
overdrainage	s
overdraine	d
overdraini	n
overdrainin	g
overdram	a
overdrama	t
overdramat	i
overdramati	cz
overdramatic	a
overdramatica	l
overdramatical	l
overdramaticall	y
overdramatiz	ei
overdramatize	ds
overdramatizi	n
overdramatizin	g
overdran	k
overdraw	n
overdre	s
overdres	s
overdri	elnpv
overdrie	ds
overdril	y
overdrin	k
overdrink	is
overdrinki	n
overdrinkin	g
overdriv	e
overdru	n
overdrun	k
overdry	iln
overdryi	n
overdryin	g
overdryl	y
overdryn	e
overdryne	s
overdrynes	s
overdryness	e
overdrynesse	s
overdu	e
overdue	n
overduen	e
overduene	s
overduenes	s
overdueness	e
overduenesse	s
overe	adfglmnqrsvxy
overea	grst
overeag	e
overeage	r
overeager	n
overeagern	e
overeagerne	s
overeagernes	s
overeagerness	e
overeagernesse	s
overear	l
overearl	y
overeas	iy
overeasi	l
overeasil	y
overeat	eis
overeate	nr
overeater	s
overeati	n
overeatin	g
overed	iu
overedi	t
overedit	eis
overedite	d
overediti	n
overeditin	g
overedu	c
overeduc	a
overeduca	t
overeducat	ei
overeducate	ds
overeducati	no
overeducatin	g
overeducatio	n
overeducation	s
overef	f
overeff	ou
overeffo	r
overeffor	t
overeffort	s
overeffu	s
overeffus	i
overeffusi	v
overeffusiv	e
overeg	g
overel	ael
overela	b
overelab	o
overelabo	r
overelabor	a
overelabora	t
overelaborat	ei
overelaborate	ds
overelaborati	no
overelaboratin	g
overelaboratio	n
overelaboration	s
overele	g
overeleg	a
overelega	n
overelegan	t
overelegant	l
overelegantl	y
overell	i
overelli	p
overellip	t
overellipt	i
overellipti	c
overelliptic	a
overelliptica	l
overelliptical	l
overellipticall	y
overem	bopu
overemb	er
overembe	l
overembel	l
overembell	i
overembelli	s
overembellis	h
overembellish	ei
overembellishe	ds
overembellishi	n
overembellishin	g
overembr	o
overembro	i
overembroi	d
overembroid	e
overembroide	r
overembroider	eis
overembroidere	d
overembroideri	n
overembroiderin	g
overemo	t
overemot	ei
overemote	ds
overemoti	no
overemotin	g
overemotio	n
overemotion	a
overemotiona	l
overemotional	l
overemotionall	y
overemp	hilt
overemph	a
overempha	st
overemphas	ei
overemphase	s
overemphasi	sz
overemphasis	e
overemphasise	d
overemphasiz	ei
overemphasize	ds
overemphasizi	n
overemphasizin	g
overemphat	i
overemphati	c
overempi	r
overempir	i
overempiri	c
overempiric	a
overempirica	l
overempirical	l
overempiricall	y
overempl	o
overemplo	y
overemploy	eims
overemploye	d
overemployi	n
overemployin	g
overemploym	e
overemployme	n
overemploymen	t
overemployment	s
overempt	y
overemu	l
overemul	a
overemula	t
overemulat	ei
overemulate	ds
overemulati	n
overemulatin	g
overen	acegrtv
overena	m
overenam	o
overenamo	r
overenamor	e
overenamore	d
overenc	o
overenco	u
overencou	r
overencour	a
overencoura	g
overencourag	ei
overencourage	ds
overencouragi	n
overencouragin	g
overene	r
overener	g
overenerg	e
overenerge	t
overenerget	i
overenergeti	c
overeng	i
overengi	n
overengin	e
overengine	e
overenginee	r
overengineer	eis
overengineere	d
overengineeri	n
overengineerin	g
overenr	o
overenro	l
overenrol	l
overenroll	e
overenrolle	d
overent	eh
overente	r
overenter	t
overentert	a
overenterta	i
overentertai	n
overentertain	e
overentertaine	d
overenth	u
overenthu	s
overenthus	i
overenthusi	a
overenthusia	s
overenthusias	mt
overenthusiasm	s
overenthusiast	i
overenthusiasti	c
overenv	i
overenvi	o
overenvio	u
overenviou	s
overenvious	ln
overenviousl	y
overenviousn	e
overenviousne	s
overenviousnes	s
overenviousness	e
overenviousnesse	s
overeq	u
overequ	i
overequi	p
overequip	p
overequipp	e
overequippe	d
overer	u
overeru	p
overerup	t
overerupt	i
overerupti	o
overeruptio	n
overes	t
overest	i
overesti	m
overestim	a
overestima	t
overestimat	ei
overestimate	ds
overestimati	no
overestimatin	g
overestimatio	n
overestimation	s
overev	a
overeva	l
overeval	u
overevalu	a
overevalua	t
overevaluat	i
overevaluati	o
overevaluatio	n
overevaluation	s
overex	aceptu
overexa	cg
overexac	t
overexact	i
overexacti	n
overexactin	g
overexag	g
overexagg	e
overexagge	r
overexagger	a
overexaggera	t
overexaggerat	ei
overexaggerate	ds
overexaggerati	no
overexaggeratin	g
overexaggeratio	n
overexaggeration	s
overexc	i
overexci	t
overexcit	ei
overexcite	ds
overexciti	n
overexcitin	g
overexe	r
overexer	ct
overexerc	i
overexerci	s
overexercis	ei
overexercise	ds
overexercisi	n
overexercisin	g
overexert	eis
overexerte	d
overexerti	no
overexertin	g
overexertio	n
overexertion	s
overexp	aelor
overexpa	n
overexpan	ds
overexpand	eis
overexpande	d
overexpandi	n
overexpandin	g
overexpans	i
overexpansi	ov
overexpansio	n
overexpansion	s
overexpansiv	e
overexpansive	ln
overexpansivel	y
overexpansiven	e
overexpansivene	s
overexpansivenes	s
overexpansiveness	e
overexpansivenesse	s
overexpe	cn
overexpec	t
overexpect	aeis
overexpecta	nt
overexpectan	t
overexpectant	l
overexpectantl	y
overexpectat	i
overexpectati	o
overexpectatio	n
overexpectation	s
overexpecte	d
overexpecti	n
overexpectin	g
overexpen	d
overexpend	eis
overexpende	d
overexpendi	nt
overexpendin	g
overexpendit	u
overexpenditu	r
overexpenditur	e
overexpenditure	s
overexpl	aio
overexpla	in
overexplai	n
overexplain	eis
overexplaine	d
overexplaini	n
overexplainin	g
overexplan	a
overexplana	t
overexplanat	i
overexplanati	o
overexplanatio	n
overexplanation	s
overexpli	c
overexplic	i
overexplici	t
overexplo	i
overexploi	t
overexploit	aeis
overexploita	t
overexploitat	i
overexploitati	o
overexploitatio	n
overexploitation	s
overexploite	d
overexploiti	n
overexploitin	g
overexpo	s
overexpos	eu
overexposu	r
overexposur	e
overexpr	e
overexpre	s
overexpres	s
overexpress	ei
overexpresse	ds
overexpressi	nv
overexpressin	g
overexpressiv	e
overexpressive	ln
overexpressivel	y
overexpressiven	e
overexpressivene	s
overexpressivenes	s
overexpressiveness	e
overexpressivenesse	s
overext	er
overexte	n
overexten	d
overextr	ae
overextra	cpv
overextrac	t
overextract	eis
overextracte	d
overextracti	no
overextractin	g
overextractio	n
overextraction	s
overextrap	o
overextrapo	l
overextrapol	a
overextrapola	t
overextrapolat	i
overextrapolati	o
overextrapolatio	n
overextrapolation	s
overextrav	a
overextrava	g
overextravag	a
overextravaga	n
overextravagan	t
overextravagant	l
overextravagantl	y
overextre	m
overextrem	e
overexu	b
overexub	e
overexube	r
overexuber	a
overexubera	n
overexuberan	t
overexuberant	l
overexuberantl	y
overey	e
overf	aeiloru
overfa	cimrstv
overfac	i
overfaci	l
overfacil	ei
overfacile	l
overfacilel	y
overfacili	t
overfacilit	iy
overfaciliti	e
overfacilitie	s
overfai	nt
overfain	t
overfaint	ln
overfaintl	y
overfaintn	e
overfaintne	s
overfaintnes	s
overfaintness	e
overfaintnesse	s
overfait	h
overfaith	f
overfaithf	u
overfaithfu	l
overfaithful	ln
overfaithfull	y
overfaithfuln	e
overfaithfulne	s
overfaithfulnes	s
overfaithfulness	e
overfaithfulnesse	s
overfam	eio
overfame	d
overfami	l
overfamil	i
overfamili	a
overfamilia	r
overfamiliar	i
overfamiliari	t
overfamiliarit	i
overfamiliariti	e
overfamiliaritie	s
overfamo	u
overfamou	s
overfar	t
overfart	h
overfarth	e
overfarthe	rs
overfarthes	t
overfas	t
overfast	i
overfasti	d
overfastid	i
overfastidi	o
overfastidio	u
overfastidiou	s
overfastidious	ln
overfastidiousl	y
overfastidiousn	e
overfastidiousne	s
overfastidiousnes	s
overfastidiousness	e
overfastidiousnesse	s
overfat	it
overfati	g
overfatig	u
overfatigu	e
overfatt	e
overfatte	n
overfatten	eis
overfattene	d
overfatteni	n
overfattenin	g
overfav	o
overfavo	ru
overfavor	eis
overfavore	d
overfavori	n
overfavorin	g
overfavou	r
overfavour	a
overfavoura	b
overfavourab	l
overfavourabl	e
overfe	aelmrw
overfea	rs
overfear	f
overfearf	u
overfearfu	l
overfearful	ln
overfearfull	y
overfearfuln	e
overfearfulne	s
overfearfulnes	s
overfearfulness	e
overfearfulnesse	s
overfeas	t
overfeast	eis
overfeaste	d
overfeasti	n
overfeastin	g
overfee	dls
overfeel	is
overfeeli	n
overfeelin	g
overfel	t
overfem	i
overfemi	n
overfemin	i
overfemini	n
overfeminin	e
overfeminine	l
overfemininel	y
overfer	tv
overfert	i
overferti	l
overfertil	ei
overfertili	z
overfertiliz	aei
overfertiliza	t
overfertilizat	i
overfertilizati	o
overfertilizatio	n
overfertilization	s
overfertilize	ds
overfertilizi	n
overfertilizin	g
overferv	e
overferve	n
overferven	t
overfervent	ln
overferventl	y
overferventn	e
overferventne	s
overferventnes	s
overferventness	e
overferventnesse	s
overfi	elrstx
overfie	r
overfier	c
overfierc	e
overfierce	ln
overfiercel	y
overfiercen	e
overfiercene	s
overfiercenes	s
overfierceness	e
overfiercenesse	s
overfil	lmt
overfilt	e
overfilte	r
overfilter	eis
overfiltere	d
overfilteri	n
overfilterin	g
overfir	e
overfis	h
overfish	i
overfishi	n
overfishin	g
overfit	t
overfitt	i
overfitti	n
overfittin	g
overfix	ei
overfixe	ds
overfixi	n
overfixin	g
overfl	aou
overfla	t
overflat	t
overflatt	e
overflatte	n
overflatten	eis
overflattene	d
overflatteni	n
overflattenin	g
overflo	gouw
overflog	gs
overflogg	ei
overflogge	d
overfloggi	n
overfloggin	g
overfloo	d
overflood	eis
overfloode	d
overfloodi	n
overfloodin	g
overflou	r
overflour	eis
overfloure	d
overflouri	n
overflourin	g
overflow	aeis
overflowa	b
overflowab	l
overflowabl	e
overflowe	d
overflowi	n
overflowin	g
overflowing	ln
overflowingl	y
overflowingn	e
overflowingne	s
overflowingnes	s
overflu	es
overflue	n
overfluen	ct
overfluenc	iy
overfluenci	e
overfluencie	s
overfluent	ln
overfluentl	y
overfluentn	e
overfluentne	s
overfluentnes	s
overfluentness	e
overfluentnesse	s
overflus	h
overfo	cnoru
overfoc	u
overfocu	s
overfocus	eis
overfocuse	ds
overfocusi	n
overfocusin	g
overfocuss	ei
overfocusse	ds
overfocussi	n
overfocussin	g
overfon	d
overfond	l
overfondl	ei
overfondle	ds
overfondli	n
overfondlin	g
overfoo	l
overfool	i
overfooli	s
overfoolis	h
overfoolish	ln
overfoolishl	y
overfoolishn	e
overfoolishne	s
overfoolishnes	s
overfoolishness	e
overfoolishnesse	s
overfor	cmw
overforc	ei
overforce	ds
overforci	n
overforcin	g
overform	e
overforme	d
overforw	a
overforwa	r
overforwar	d
overforward	ln
overforwardl	y
overforwardn	e
overforwardne	s
overforwardnes	s
overforwardness	e
overforwardnesse	s
overfou	l
overfoul	ln
overfoull	y
overfouln	e
overfoulne	s
overfoulnes	s
overfoulness	e
overfoulnesse	s
overfr	aeiu
overfra	gin
overfrag	i
overfragi	l
overfragil	e
overfrai	l
overfrail	t
overfrailt	iy
overfrailti	e
overfrailtie	s
overfran	c
overfranc	h
overfranch	i
overfranchi	s
overfranchis	e
overfranchise	d
overfre	eiq
overfree	dl
overfreed	o
overfreedo	m
overfreedom	s
overfreel	y
overfrei	g
overfreig	h
overfreigh	t
overfreight	eis
overfreighte	d
overfreighti	n
overfreightin	g
overfreq	u
overfrequ	e
overfreque	n
overfrequen	ct
overfrequenc	iy
overfrequenci	e
overfrequencie	s
overfrequent	l
overfrequentl	y
overfri	g
overfrig	h
overfrigh	t
overfright	e
overfrighte	n
overfrighten	eis
overfrightene	d
overfrighteni	n
overfrightenin	g
overfru	gis
overfrug	a
overfruga	l
overfrugal	l
overfrugall	y
overfrui	t
overfruit	f
overfruitf	u
overfruitfu	l
overfruitful	ln
overfruitfull	y
overfruitfuln	e
overfruitfulne	s
overfruitfulnes	s
overfruitfulness	e
overfruitfulnesse	s
overfrus	t
overfrust	r
overfrustr	a
overfrustra	t
overfrustrat	i
overfrustrati	o
overfrustratio	n
overfrustration	s
overfu	lnrs
overful	f
overfulf	i
overfulfi	l
overfulfil	lm
overfulfill	eis
overfulfille	d
overfulfilli	n
overfulfillin	g
overfulfilm	e
overfulfilme	n
overfulfilmen	t
overfun	cd
overfunc	t
overfunct	i
overfuncti	o
overfunctio	n
overfunction	i
overfunctioni	n
overfunctionin	g
overfund	eis
overfunde	d
overfundi	n
overfundin	g
overfur	nt
overfurn	i
overfurni	s
overfurnis	h
overfurnish	ei
overfurnishe	ds
overfurnishi	n
overfurnishin	g
overfurt	h
overfurth	e
overfurthe	rs
overfurthes	t
overfus	s
overfuss	y
overg	aeiloru
overga	mrz
overgam	b
overgamb	l
overgambl	ei
overgamble	ds
overgambli	n
overgamblin	g
overgar	nr
overgarn	i
overgarni	s
overgarnis	h
overgarnish	ei
overgarnishe	ds
overgarnishi	n
overgarnishin	g
overgarr	i
overgarri	s
overgarris	o
overgarriso	n
overgarrison	eis
overgarrisone	d
overgarrisoni	n
overgarrisonin	g
overgaz	e
overge	ns
overgen	eit
overgene	r
overgener	ao
overgenera	l
overgeneral	i
overgenerali	z
overgeneraliz	aei
overgeneraliza	t
overgeneralizat	i
overgeneralizati	o
overgeneralizatio	n
overgeneralization	s
overgeneralize	ds
overgeneralizi	n
overgeneralizin	g
overgenero	su
overgeneros	i
overgenerosi	t
overgenerosit	i
overgenerositi	e
overgenerositie	s
overgenerou	s
overgenerous	l
overgenerousl	y
overgeni	a
overgenia	l
overgenial	i
overgeniali	t
overgenialit	iy
overgenialiti	e
overgenialitie	s
overgent	l
overgentl	ey
overges	t
overgest	i
overgesti	c
overgestic	u
overgesticu	l
overgesticul	a
overgesticula	t
overgesticulat	ei
overgesticulate	ds
overgesticulati	nv
overgesticulatin	g
overgesticulativ	e
overgesticulative	l
overgesticulativel	y
overgi	fl
overgif	t
overgift	e
overgifte	d
overgil	d
overgl	aiou
overgla	dmnz
overglam	o
overglamo	ru
overglamor	i
overglamori	z
overglamoriz	ei
overglamorize	ds
overglamorizi	n
overglamorizin	g
overglamou	r
overglamour	i
overglamouri	z
overglamouriz	ei
overglamourize	ds
overglamourizi	n
overglamourizin	g
overglan	c
overglanc	e
overglaz	e
overgli	d
overglid	e
overglo	o
overgloo	m
overgloom	iy
overgloomi	ln
overgloomil	y
overgloomin	e
overgloomine	s
overgloomines	s
overgloominess	e
overgloominesse	s
overglu	t
overglut	st
overglutt	ei
overglutte	d
overglutti	n
overgluttin	g
overgo	v
overgov	e
overgove	r
overgover	n
overgovern	eis
overgoverne	d
overgoverni	n
overgovernin	g
overgr	aeio
overgra	cdstz
overgrac	i
overgraci	o
overgracio	u
overgraciou	s
overgracious	ln
overgraciousl	y
overgraciousn	e
overgraciousne	s
overgraciousnes	s
overgraciousness	e
overgraciousnesse	s
overgrad	ei
overgrade	ds
overgradi	n
overgradin	g
overgras	p
overgrasp	i
overgraspi	n
overgraspin	g
overgrat	ei
overgrate	f
overgratef	u
overgratefu	l
overgrateful	ln
overgratefull	y
overgratefuln	e
overgratefulne	s
overgratefulnes	s
overgratefulness	e
overgratefulnesse	s
overgrati	ft
overgratif	iy
overgratifi	e
overgratifie	ds
overgratify	i
overgratifyi	n
overgratifyin	g
overgratit	u
overgratitu	d
overgratitud	e
overgratitude	s
overgraz	ei
overgrazi	n
overgrazin	g
overgre	ae
overgrea	st
overgreas	iy
overgreasi	n
overgreasin	e
overgreasine	s
overgreasines	s
overgreasiness	e
overgreasinesse	s
overgreat	ln
overgreatl	y
overgreatn	e
overgreatne	s
overgreatnes	s
overgreatness	e
overgreatnesse	s
overgree	dn
overgreed	iy
overgreedi	ln
overgreedil	y
overgreedin	e
overgreedine	s
overgreedines	s
overgreediness	e
overgreedinesse	s
overgri	e
overgrie	v
overgriev	ei
overgrieve	ds
overgrievi	n
overgrievin	g
overgro	suw
overgros	s
overgross	ln
overgrossl	y
overgrossn	e
overgrossne	s
overgrossnes	s
overgrossness	e
overgrossnesse	s
overgrou	n
overgroun	d
overgrow	nt
overgrowt	h
overgu	i
overgui	l
overguil	t
overguilt	y
overh	aeiouy
overha	inprsu
overhai	r
overhan	dg
overhand	il
overhandi	c
overhandic	a
overhandica	p
overhandicap	ps
overhandicapp	ei
overhandicappe	d
overhandicappi	n
overhandicappin	g
overhandl	ei
overhandle	ds
overhandli	n
overhandlin	g
overhang	eis
overhange	d
overhangi	n
overhangin	g
overhap	p
overhapp	i
overhappi	l
overhappil	y
overhar	adsv
overhara	s
overharas	s
overharass	ei
overharasse	ds
overharassi	n
overharassin	g
overhard	eny
overharde	n
overharden	eis
overhardene	d
overhardeni	n
overhardenin	g
overhardn	e
overhardne	s
overhardnes	s
overhardness	e
overhardnesse	s
overhars	h
overharsh	ln
overharshl	y
overharshn	e
overharshne	s
overharshnes	s
overharshness	e
overharshnesse	s
overharv	e
overharve	s
overharves	t
overharvest	eis
overharveste	d
overharvesti	n
overharvestin	g
overhas	t
overhast	e
overhaste	n
overhasten	eis
overhastene	d
overhasteni	n
overhastenin	g
overhau	gl
overhaug	h
overhaugh	t
overhaught	iy
overhaughti	ln
overhaughtil	y
overhaughtin	e
overhaughtine	s
overhaughtines	s
overhaughtiness	e
overhaughtinesse	s
overhaul	eis
overhaule	dr
overhauler	s
overhauli	n
overhaulin	g
overhauling	s
overhe	al
overhea	dprtv
overhead	isy
overheadi	n
overheadin	e
overheadine	s
overheadines	s
overheadiness	e
overheadinesse	s
overheap	eis
overheape	d
overheapi	n
overheapin	g
overhear	deist
overheare	r
overhearer	s
overheari	n
overhearin	g
overheart	iy
overhearti	ln
overheartil	y
overheartin	e
overheartine	s
overheartines	s
overheartiness	e
overheartinesse	s
overheat	i
overheati	n
overheatin	g
overheav	iy
overheavi	n
overheavin	e
overheavine	s
overheavines	s
overheaviness	e
overheavinesse	s
overhel	p
overhelp	f
overhelpf	u
overhelpfu	l
overhelpful	ln
overhelpfull	y
overhelpfuln	e
overhelpfulne	s
overhelpfulnes	s
overhelpfulness	e
overhelpfulnesse	s
overhi	gl
overhig	h
overhigh	l
overhighl	y
overhil	l
overho	lmnrstu
overhol	d
overhom	eo
overhome	l
overhomel	iy
overhomeli	n
overhomelin	e
overhomeline	s
overhomelines	s
overhomeliness	e
overhomelinesse	s
overhomo	g
overhomog	e
overhomoge	n
overhomogen	i
overhomogeni	z
overhomogeniz	ei
overhomogenize	ds
overhomogenizi	n
overhomogenizin	g
overhon	e
overhone	s
overhones	t
overhonest	ln
overhonestl	y
overhonestn	e
overhonestne	s
overhonestnes	s
overhonestness	e
overhonestnesse	s
overhor	s
overhors	e
overhos	t
overhost	i
overhosti	l
overhostil	ei
overhostile	l
overhostilel	y
overhostili	t
overhostilit	iy
overhostiliti	e
overhostilitie	s
overhot	l
overhotl	y
overhou	s
overhous	e
overhouse	d
overhu	gmnr
overhug	e
overhuge	ln
overhugel	y
overhugen	e
overhugene	s
overhugenes	s
overhugeness	e
overhugenesse	s
overhum	ab
overhuma	n
overhuman	ei
overhumani	t
overhumanit	iy
overhumaniti	e
overhumanitie	s
overhumb	l
overhumbl	ey
overhumble	n
overhumblen	e
overhumblene	s
overhumblenes	s
overhumbleness	e
overhumblenesse	s
overhun	t
overhunt	eis
overhunte	d
overhunti	n
overhuntin	g
overhunting	s
overhur	r
overhurr	iy
overhurri	e
overhurrie	ds
overhurried	l
overhurriedl	y
overhurry	i
overhurryi	n
overhurryin	g
overhy	dps
overhyd	r
overhydr	a
overhydra	t
overhydrat	ei
overhydrate	d
overhydrati	o
overhydratio	n
overhyp	ei
overhype	ds
overhypi	n
overhypin	g
overhys	t
overhyst	e
overhyste	r
overhyster	i
overhysteri	c
overhysteric	a
overhysterica	l
overi	dlmnr
overid	el
overide	an
overidea	l
overideal	i
overideali	sz
overidealis	m
overidealism	s
overidealiz	ei
overidealize	ds
overidealizi	n
overidealizin	g
overiden	t
overident	i
overidenti	f
overidentif	iy
overidentifi	ce
overidentific	a
overidentifica	t
overidentificat	i
overidentificati	o
overidentificatio	n
overidentification	s
overidentifie	ds
overidentify	i
overidentifyi	n
overidentifyin	g
overidl	ey
overidle	n
overidlen	e
overidlene	s
overidlenes	s
overidleness	e
overidlenesse	s
overil	l
overill	u
overillu	s
overillus	t
overillust	r
overillustr	a
overillustra	t
overillustrat	ei
overillustrate	ds
overillustrati	no
overillustratin	g
overillustratio	n
overillustration	s
overim	aimp
overima	g
overimag	i
overimagi	n
overimagin	a
overimagina	t
overimaginat	i
overimaginati	v
overimaginativ	e
overimaginative	ln
overimaginativel	y
overimaginativen	e
overimaginativene	s
overimaginativenes	s
overimaginativeness	e
overimaginativenesse	s
overimi	t
overimit	a
overimita	t
overimitat	ei
overimitate	ds
overimitati	no
overimitatin	g
overimitatio	n
overimitation	s
overimm	u
overimmu	n
overimmun	i
overimmuni	z
overimmuniz	ei
overimmunize	ds
overimmunizi	n
overimmunizin	g
overimp	or
overimpo	rs
overimpor	t
overimport	eis
overimporte	d
overimporti	n
overimportin	g
overimpos	ei
overimpose	ds
overimposi	n
overimposin	g
overimpr	e
overimpre	s
overimpres	s
overimpress	ei
overimpresse	ds
overimpressi	no
overimpressin	g
overimpressio	n
overimpression	a
overimpressiona	b
overimpressionab	il
overimpressionabi	l
overimpressionabil	i
overimpressionabili	t
overimpressionabilit	iy
overimpressionabiliti	e
overimpressionabilitie	s
overimpressionabl	ey
overimpressionable	n
overimpressionablen	e
overimpressionablene	s
overimpressionablenes	s
overimpressionableness	e
overimpressionablenesse	s
overin	cdfghstv
overinc	l
overincl	iu
overincli	n
overinclin	aei
overinclina	t
overinclinat	i
overinclinati	o
overinclinatio	n
overinclination	s
overincline	ds
overinclini	n
overinclinin	g
overinclu	s
overinclus	i
overinclusi	o
overinclusio	n
overind	eiu
overinde	bx
overindeb	t
overindebt	e
overindebte	d
overindebted	n
overindebtedn	e
overindebtedne	s
overindebtednes	s
overindebtedness	e
overindebtednesse	s
overindex	ei
overindexe	ds
overindexi	n
overindexin	g
overindexing	s
overindi	v
overindiv	i
overindivi	d
overindivid	u
overindividu	a
overindividua	l
overindividual	i
overindividuali	s
overindividualis	m
overindividualism	s
overindu	ls
overindul	g
overindulg	ei
overindulge	dns
overindulgen	c
overindulgenc	e
overindulgence	s
overindulgi	n
overindulgin	g
overindus	t
overindust	r
overindustr	i
overindustri	a
overindustria	l
overindustrial	i
overindustriali	z
overindustrializ	ei
overindustrialize	ds
overindustrializi	n
overindustrializin	g
overinf	lo
overinfl	au
overinfla	t
overinflat	ei
overinflate	s
overinflati	no
overinflatin	g
overinflatio	n
overinflation	s
overinflu	e
overinflue	n
overinfluen	ct
overinfluenc	ei
overinfluence	ds
overinfluenci	n
overinfluencin	g
overinfluent	i
overinfluenti	a
overinfluentia	l
overinfo	r
overinfor	m
overinform	eis
overinforme	d
overinformi	n
overinformin	g
overing	e
overinge	n
overingen	iu
overingeni	o
overingenio	u
overingeniou	s
overingenious	ln
overingeniousl	y
overingeniousn	e
overingeniousne	s
overingeniousnes	s
overingeniousness	e
overingeniousnesse	s
overingenu	i
overingenui	t
overingenuit	iy
overingenuiti	e
overingenuitie	s
overinh	i
overinhi	b
overinhib	i
overinhibi	t
overinhibit	is
overinhibiti	n
overinhibitin	g
overins	iotu
overinsi	s
overinsis	t
overinsist	eis
overinsiste	dn
overinsisten	t
overinsistent	l
overinsistentl	y
overinsisti	n
overinsistin	g
overinso	l
overinsol	e
overinsole	n
overinsolen	t
overinsolent	l
overinsolentl	y
overinst	r
overinstr	u
overinstru	c
overinstruc	t
overinstruct	eis
overinstructe	d
overinstructi	nov
overinstructin	g
overinstructio	n
overinstruction	s
overinstructiv	e
overinstructive	ln
overinstructivel	y
overinstructiven	e
overinstructivene	s
overinstructivenes	s
overinstructiveness	e
overinstructivenesse	s
overinsu	lr
overinsul	a
overinsula	t
overinsulat	i
overinsulati	o
overinsulatio	n
overinsur	aei
overinsura	n
overinsuran	c
overinsuranc	e
overinsure	ds
overinsuri	n
overinsurin	g
overint	e
overinte	lnr
overintel	l
overintell	e
overintelle	c
overintellec	t
overintellect	u
overintellectu	a
overintellectua	l
overintellectual	iln
overintellectuali	z
overintellectualiz	aei
overintellectualiza	t
overintellectualizat	i
overintellectualizati	o
overintellectualizatio	n
overintellectualization	s
overintellectualize	ds
overintellectualizi	n
overintellectualizin	g
overintellectuall	y
overintellectualn	e
overintellectualne	s
overintellectualnes	s
overintellectualness	e
overintellectualnesse	s
overinten	s
overintens	ei
overintense	ln
overintensel	y
overintensen	e
overintensene	s
overintensenes	s
overintenseness	e
overintensenesse	s
overintensi	ft
overintensif	iy
overintensifi	ce
overintensific	a
overintensifica	t
overintensificat	i
overintensificati	o
overintensificatio	n
overintensification	s
overintensifie	ds
overintensify	i
overintensifyi	n
overintensifyin	g
overintensit	iy
overintensiti	e
overintensitie	s
overinter	efp
overintere	s
overinteres	t
overinterest	es
overintereste	d
overinterested	ln
overinterestedl	y
overinterestedn	e
overinterestedne	s
overinterestednes	s
overinterestedness	e
overinterestednesse	s
overinterf	e
overinterfe	r
overinterfer	e
overinterfere	n
overinterferen	c
overinterferenc	e
overinterference	s
overinterp	r
overinterpr	e
overinterpre	t
overinterpret	a
overinterpreta	t
overinterpretat	i
overinterpretati	o
overinterpretatio	n
overinterpretation	s
overinv	eo
overinve	ns
overinven	t
overinvent	o
overinvento	r
overinventor	i
overinventori	e
overinventorie	d
overinves	t
overinvest	eims
overinveste	d
overinvesti	n
overinvestin	g
overinvestm	e
overinvestme	n
overinvestmen	t
overinvestment	s
overinvo	l
overinvol	v
overinvolv	ei
overinvolve	ds
overinvolvi	n
overinvolvin	g
overir	r
overirr	i
overirri	g
overirrig	a
overirriga	t
overirrigat	ei
overirrigate	ds
overirrigati	no
overirrigatin	g
overirrigatio	n
overj	aeou
overja	c
overjac	k
overjack	e
overjacke	t
overje	at
overjea	l
overjeal	o
overjealo	u
overjealou	s
overjealous	ln
overjealousl	y
overjealousn	e
overjealousne	s
overjealousnes	s
overjealousness	e
overjealousnesse	s
overjo	y
overjoy	ef
overjoye	d
overjoyf	u
overjoyfu	l
overjoyful	ln
overjoyfull	y
overjoyfuln	e
overjoyfulne	s
overjoyfulnes	s
overjoyfulness	e
overjoyfulnesse	s
overju	dm
overjud	i
overjudi	c
overjudic	i
overjudici	o
overjudicio	u
overjudiciou	s
overjudicious	ln
overjudiciousl	y
overjudiciousn	e
overjudiciousne	s
overjudiciousnes	s
overjudiciousness	e
overjudiciousnesse	s
overjum	p
overk	ein
overke	e
overkee	p
overki	cln
overkic	k
overkick	eis
overkicke	d
overkicki	n
overkickin	g
overkil	l
overkin	g
overkn	o
overkno	w
overknow	i
overknowi	n
overknowin	g
overl	aeiouy
overla	bdinprtvxy
overlab	o
overlabo	r
overlabor	eis
overlabore	d
overlabori	n
overlaborin	g
overlad	e
overlade	n
overlai	d
overlan	d
overland	es
overlande	r
overlap	ps
overlapp	ei
overlappe	d
overlappi	n
overlappin	g
overlar	dg
overlard	eis
overlarde	d
overlardi	n
overlardin	g
overlarg	e
overlarge	l
overlargel	y
overlat	e
overlate	n
overlaten	e
overlatene	s
overlatenes	s
overlateness	e
overlatenesse	s
overlav	i
overlavi	s
overlavis	h
overlavish	ln
overlavishl	y
overlavishn	e
overlavishne	s
overlavishnes	s
overlavishness	e
overlavishnesse	s
overlax	ln
overlaxl	y
overlaxn	e
overlaxne	s
overlaxnes	s
overlaxness	e
overlaxnesse	s
overlay	is
overlayi	n
overlayin	g
overle	agn
overlea	dfnprtv
overlear	n
overlearn	e
overlearne	d
overlearned	ln
overlearnedl	y
overlearnedn	e
overlearnedne	s
overlearnednes	s
overlearnedness	e
overlearnednesse	s
overleat	h
overleath	e
overleathe	r
overleav	e
overleave	n
overleg	i
overlegi	s
overlegis	l
overlegisl	a
overlegisla	t
overlegislat	ei
overlegislate	ds
overlegislati	n
overlegislatin	g
overlen	dgit
overlend	is
overlendi	n
overlendin	g
overleng	t
overlengt	h
overlength	es
overlengthe	n
overlengthen	eis
overlengthene	d
overlengtheni	n
overlengthenin	g
overleni	e
overlenie	n
overlenien	t
overli	begkmnpstv
overlib	e
overlibe	r
overliber	a
overlibera	l
overliberal	il
overliberali	t
overliberalit	y
overliberall	y
overlig	h
overligh	t
overlight	l
overlightl	y
overlik	i
overliki	n
overlikin	g
overliking	s
overlim	i
overlimi	t
overlimit	eis
overlimite	d
overlimiti	n
overlimitin	g
overlin	eg
overling	e
overlinge	r
overlinger	eis
overlingere	d
overlingeri	n
overlingerin	g
overlis	t
overlist	e
overliste	n
overlit	e
overlite	r
overliter	a
overlitera	lr
overliterar	iy
overliterari	ln
overliteraril	y
overliterarin	e
overliterarine	s
overliterarines	s
overliterariness	e
overliterarinesse	s
overliv	e
overlive	l
overlivel	iy
overliveli	n
overlivelin	e
overliveline	s
overlivelines	s
overliveliness	e
overlivelinesse	s
overlo	acgoruvwy
overloa	dt
overload	eis
overloade	d
overloadi	n
overloadin	g
overloat	h
overloc	k
overlock	e
overlocke	r
overlog	i
overlogi	c
overlogic	a
overlogica	l
overlogical	iln
overlogicali	t
overlogicalit	iy
overlogicaliti	e
overlogicalitie	s
overlogicall	y
overlogicaln	e
overlogicalne	s
overlogicalnes	s
overlogicalness	e
overlogicalnesse	s
overloo	ks
overlook	eis
overlooke	d
overlooki	n
overlookin	g
overloos	e
overloose	ln
overloosel	y
overloosen	e
overloosene	s
overloosenes	s
overlooseness	e
overloosenesse	s
overlor	d
overlou	dp
overloud	ln
overloudl	y
overloudn	e
overloudne	s
overloudnes	s
overloudness	e
overloudnesse	s
overlov	ei
overlove	ds
overlovi	n
overlovin	g
overlow	n
overlown	e
overlowne	s
overlownes	s
overlowness	e
overlownesse	s
overloy	a
overloya	l
overloyal	l
overloyall	y
overlu	bsx
overlub	r
overlubr	i
overlubri	c
overlubric	a
overlubrica	t
overlubricat	ei
overlubricate	ds
overlubricati	no
overlubricatin	g
overlubricatio	n
overlubrication	s
overlus	ch
overlusc	i
overlusci	o
overluscio	u
overlusciou	s
overluscious	ln
overlusciousl	y
overlusciousn	e
overlusciousne	s
overlusciousnes	s
overlusciousness	e
overlusciousnesse	s
overlux	u
overluxu	r
overluxur	i
overluxuri	o
overluxurio	u
overluxuriou	s
overluxurious	ln
overluxuriousl	y
overluxuriousn	e
overluxuriousne	s
overluxuriousnes	s
overluxuriousness	e
overluxuriousnesse	s
overm	aeiouy
overma	gnst
overmag	n
overmagn	ei
overmagne	t
overmagnet	i
overmagneti	c
overmagnetic	a
overmagnetica	l
overmagnetical	l
overmagneticall	y
overmagni	ft
overmagnif	iy
overmagnifi	e
overmagnifie	ds
overmagnify	i
overmagnifyi	n
overmagnifyin	g
overmagnit	u
overmagnitu	d
overmagnitud	e
overmagnitude	s
overman	ant
overmana	g
overmanag	ei
overmanage	ds
overmanagi	n
overmanagin	g
overmann	e
overmanne	r
overmanner	e
overmannere	d
overmant	l
overmantl	e
overmas	t
overmast	e
overmaste	r
overmat	cu
overmatc	h
overmatu	r
overmatur	ei
overmature	ln
overmaturel	y
overmaturen	e
overmaturene	s
overmaturenes	s
overmatureness	e
overmaturenesse	s
overmaturi	t
overmaturit	iy
overmaturiti	e
overmaturitie	s
overme	adelr
overmea	s
overmeas	u
overmeasu	r
overmeasur	e
overmed	di
overmedd	l
overmeddl	ei
overmeddle	ds
overmeddli	n
overmeddlin	g
overmedi	c
overmedic	a
overmedica	t
overmedicat	ei
overmedicate	ds
overmedicati	no
overmedicatin	g
overmedicatio	n
overmedication	s
overmee	k
overmeek	ln
overmeekl	y
overmeekn	e
overmeekne	s
overmeeknes	s
overmeekness	e
overmeeknesse	s
overmel	lo
overmell	o
overmello	w
overmellow	ln
overmellowl	y
overmellown	e
overmellowne	s
overmellownes	s
overmellowness	e
overmellownesse	s
overmelo	d
overmelod	i
overmelodi	o
overmelodio	u
overmelodiou	s
overmelodious	ln
overmelodiousl	y
overmelodiousn	e
overmelodiousne	s
overmelodiousnes	s
overmelodiousness	e
overmelodiousnesse	s
overmer	cir
overmerc	i
overmerci	f
overmercif	u
overmercifu	l
overmerciful	ln
overmercifull	y
overmercifuln	e
overmercifulne	s
overmercifulnes	s
overmercifulness	e
overmercifulnesse	s
overmeri	t
overmerit	eis
overmerite	d
overmeriti	n
overmeritin	g
overmerr	iy
overmerri	lmn
overmerril	y
overmerrim	e
overmerrime	n
overmerrimen	t
overmerriment	s
overmerrin	e
overmerrine	s
overmerrines	s
overmerriness	e
overmerrinesse	s
overmi	clntx
overmic	k
overmick	l
overmickl	e
overmil	dk
overmilk	eis
overmilke	d
overmilki	n
overmilkin	g
overmin	ei
overmine	ds
overmini	n
overminin	g
overmit	it
overmiti	g
overmitig	a
overmitiga	t
overmitigat	ei
overmitigate	ds
overmitigati	n
overmitigatin	g
overmix	eit
overmixe	ds
overmixi	n
overmixin	g
overmo	bdinrsu
overmob	i
overmobi	l
overmobil	i
overmobili	z
overmobiliz	ei
overmobilize	ds
overmobilizi	n
overmobilizin	g
overmod	eiu
overmode	rs
overmoder	n
overmodern	i
overmoderni	z
overmoderniz	aei
overmoderniza	t
overmodernizat	i
overmodernizati	o
overmodernizatio	n
overmodernization	s
overmodernize	ds
overmodernizi	n
overmodernizin	g
overmodes	t
overmodest	l
overmodestl	y
overmodi	f
overmodif	iy
overmodifi	e
overmodifie	ds
overmodify	i
overmodifyi	n
overmodifyin	g
overmodu	l
overmodul	a
overmodula	t
overmodulat	ei
overmodulati	o
overmodulatio	n
overmoi	s
overmois	t
overmon	o
overmono	p
overmonop	o
overmonopo	l
overmonopol	i
overmonopoli	z
overmonopoliz	ei
overmonopolize	ds
overmonopolizi	n
overmonopolizin	g
overmor	aet
overmora	l
overmoral	il
overmorali	z
overmoraliz	ei
overmoralize	ds
overmoralizi	n
overmoralizin	g
overmoralizing	l
overmoralizingl	y
overmorall	y
overmort	g
overmortg	a
overmortga	g
overmortgag	ei
overmortgage	ds
overmortgagi	n
overmortgagin	g
overmos	t
overmou	nr
overmoun	t
overmour	n
overmourn	efis
overmourne	d
overmournf	u
overmournfu	l
overmournful	ln
overmournfull	y
overmournfuln	e
overmournfulne	s
overmournfulnes	s
overmournfulness	e
overmournfulnesse	s
overmourni	n
overmournin	g
overmu	cs
overmuc	h
overmus	c
overmusc	l
overmuscl	e
overmuscle	d
overmy	s
overmys	t
overmyst	i
overmysti	f
overmystif	iy
overmystifi	ce
overmystific	a
overmystifica	t
overmystificat	i
overmystificati	o
overmystificatio	n
overmystification	s
overmystifie	ds
overmystify	i
overmystifyi	n
overmystifyin	g
overn	aeiou
overna	mrt
overnam	e
overnar	r
overnarr	o
overnarro	w
overnarrow	ln
overnarrowl	y
overnarrown	e
overnarrowne	s
overnarrownes	s
overnarrowness	e
overnarrownesse	s
overnat	i
overnati	o
overnatio	n
overnation	a
overnationa	l
overnational	i
overnationali	z
overnationaliz	aei
overnationaliza	t
overnationalizat	i
overnationalizati	o
overnationalizatio	n
overnationalization	s
overnationalize	ds
overnationalizi	n
overnationalizin	g
overne	agrtu
overnea	r
overnear	n
overnearn	e
overnearne	s
overnearnes	s
overnearness	e
overnearnesse	s
overneg	l
overnegl	ei
overnegle	c
overneglec	t
overneglect	eis
overneglecte	d
overneglecti	n
overneglectin	g
overnegli	g
overneglig	e
overneglige	n
overnegligen	c
overnegligenc	e
overnegligence	s
overner	v
overnerv	o
overnervo	u
overnervou	s
overnervous	ln
overnervousl	y
overnervousn	e
overnervousne	s
overnervousnes	s
overnervousness	e
overnervousnesse	s
overneu	t
overneut	r
overneutr	a
overneutra	l
overneutral	i
overneutrali	z
overneutraliz	ei
overneutralize	drs
overneutralizer	s
overneutralizi	n
overneutralizin	g
overni	cg
overnic	e
overnice	ln
overnicel	y
overnicen	e
overnicene	s
overnicenes	s
overniceness	e
overnicenesse	s
overnig	h
overnigh	t
overnight	eis
overnighte	dr
overnighter	s
overnighti	n
overnightin	g
overno	bru
overnob	l
overnobl	ey
overnoble	n
overnoblen	e
overnoblene	s
overnoblenes	s
overnobleness	e
overnoblenesse	s
overnor	m
overnorm	a
overnorma	l
overnormal	il
overnormali	tz
overnormalit	iy
overnormaliti	e
overnormalitie	s
overnormaliz	aei
overnormaliza	t
overnormalizat	i
overnormalizati	o
overnormalizatio	n
overnormalization	s
overnormalize	ds
overnormalizi	n
overnormalizin	g
overnormall	y
overnou	r
overnour	i
overnouri	s
overnouris	h
overnourish	ei
overnourishe	ds
overnourishi	n
overnourishin	g
overnu	mrt
overnum	e
overnume	r
overnumer	o
overnumero	u
overnumerou	s
overnumerous	ln
overnumerousl	y
overnumerousn	e
overnumerousne	s
overnumerousnes	s
overnumerousness	e
overnumerousnesse	s
overnur	s
overnurs	ei
overnurse	ds
overnursi	n
overnursin	g
overnut	r
overnutr	i
overnutri	t
overnutrit	i
overnutriti	o
overnutritio	n
overnutrition	s
overo	bflprx
overob	ejv
overobe	ds
overobed	i
overobedi	e
overobedie	n
overobedien	t
overobedient	l
overobedientl	y
overobes	e
overobese	ln
overobesel	y
overobesen	e
overobesene	s
overobesenes	s
overobeseness	e
overobesenesse	s
overobj	e
overobje	c
overobjec	t
overobject	eis
overobjecte	d
overobjecti	n
overobjectin	g
overobv	i
overobvi	o
overobvio	u
overobviou	s
overof	f
overoff	ei
overoffe	n
overoffen	ds
overoffend	eis
overoffende	d
overoffendi	n
overoffendin	g
overoffens	i
overoffensi	v
overoffensiv	e
overoffensive	ln
overoffensivel	y
overoffensiven	e
overoffensivene	s
overoffensivenes	s
overoffensiveness	e
overoffensivenesse	s
overoffi	c
overoffic	ei
overoffici	o
overofficio	u
overofficiou	s
overofficious	ln
overofficiousl	y
overofficiousn	e
overofficiousne	s
overofficiousnes	s
overofficiousness	e
overofficiousnesse	s
overol	d
overop	eit
overope	r
overoper	a
overopera	t
overoperat	ei
overoperate	ds
overoperati	n
overoperatin	g
overopi	n
overopin	i
overopini	o
overopinio	n
overopinion	a
overopiniona	t
overopinionat	e
overopinionate	d
overopt	i
overopti	m
overoptim	i
overoptimi	s
overoptimis	mt
overoptimism	s
overoptimist	is
overoptimisti	c
overoptimistic	a
overoptimistica	l
overoptimistical	l
overoptimisticall	y
overor	cgn
overorc	h
overorch	e
overorche	s
overorches	t
overorchest	r
overorchestr	a
overorchestra	t
overorchestrat	ei
overorchestrate	ds
overorchestrati	n
overorchestratin	g
overorg	a
overorga	n
overorgan	i
overorgani	z
overorganiz	ei
overorganize	ds
overorganizi	n
overorganizin	g
overorn	a
overorna	m
overornam	e
overorname	n
overornamen	t
overornament	aeis
overornamenta	l
overornamental	il
overornamentali	t
overornamentalit	iy
overornamentaliti	e
overornamentalitie	s
overornamentall	y
overornamente	d
overornamenti	n
overornamentin	g
overox	i
overoxi	d
overoxid	i
overoxidi	z
overoxidiz	ei
overoxidize	ds
overoxidizi	n
overoxidizin	g
overp	aeiloru
overpa	cimrsty
overpac	k
overpack	a
overpacka	g
overpackag	ei
overpackage	ds
overpackagi	n
overpackagin	g
overpai	dn
overpain	ef
overpaine	d
overpainf	u
overpainfu	l
overpainful	ln
overpainfull	y
overpainfuln	e
overpainfulne	s
overpainfulnes	s
overpainfulness	e
overpainfulnesse	s
overpam	p
overpamp	e
overpampe	r
overpamper	eis
overpampere	d
overpamperi	n
overpamperin	g
overpar	kt
overpark	eis
overparke	d
overparki	n
overparkin	g
overpart	i
overparti	ac
overpartia	l
overpartial	iln
overpartiali	t
overpartialit	iy
overpartialiti	e
overpartialitie	s
overpartiall	y
overpartialn	e
overpartialne	s
overpartialnes	s
overpartialness	e
overpartialnesse	s
overpartic	u
overparticu	l
overparticul	a
overparticula	r
overparticular	l
overparticularl	y
overpas	s
overpass	ei
overpasse	s
overpassi	no
overpassin	g
overpassio	n
overpassion	a
overpassiona	t
overpassionat	e
overpassionate	ln
overpassionatel	y
overpassionaten	e
overpassionatene	s
overpassionatenes	s
overpassionateness	e
overpassionatenesse	s
overpat	ir
overpati	e
overpatie	n
overpatien	t
overpatr	i
overpatri	o
overpatrio	t
overpatriot	i
overpatrioti	c
overpatriotic	a
overpatriotica	l
overpatriotical	l
overpatrioticall	y
overpay	ims
overpayi	n
overpayin	g
overpaym	e
overpayme	n
overpaymen	t
overpayment	s
overpe	dnors
overped	a
overpeda	l
overpedal	eils
overpedale	d
overpedali	n
overpedalin	g
overpedall	ei
overpedalle	d
overpedalli	n
overpedallin	g
overpen	a
overpena	l
overpenal	i
overpenali	z
overpenaliz	aei
overpenaliza	t
overpenalizat	i
overpenalizati	o
overpenalizatio	n
overpenalization	s
overpenalize	ds
overpenalizi	n
overpenalizin	g
overpeo	p
overpeop	l
overpeopl	ei
overpeople	ds
overpeopli	n
overpeoplin	g
overper	cfs
overperc	h
overperf	o
overperfo	r
overperfor	m
overperform	eis
overperforme	d
overperformi	n
overperformin	g
overpers	eu
overperse	c
overpersec	u
overpersecu	t
overpersecut	ei
overpersecute	ds
overpersecuti	n
overpersecutin	g
overpersu	a
overpersua	ds
overpersuad	e
overpersuas	i
overpersuasi	o
overpersuasio	n
overpes	s
overpess	i
overpessi	m
overpessim	i
overpessimi	s
overpessimis	m
overpessimism	s
overpi	ct
overpic	t
overpict	u
overpictu	r
overpictur	e
overpit	e
overpite	o
overpiteo	u
overpiteou	s
overpiteous	ln
overpiteousl	y
overpiteousn	e
overpiteousne	s
overpiteousnes	s
overpiteousness	e
overpiteousnesse	s
overpl	aeouy
overpla	nu
overplan	nst
overplann	ei
overplanne	d
overplanni	n
overplannin	g
overplant	eis
overplante	d
overplanti	n
overplantin	g
overplau	s
overplaus	i
overplausi	b
overplausib	l
overplausibl	ey
overplausible	n
overplausiblen	e
overplausiblene	s
overplausiblenes	s
overplausibleness	e
overplausiblenesse	s
overple	an
overplea	s
overpleas	ei
overplease	ds
overpleasi	n
overpleasin	g
overplen	t
overplent	iy
overplenti	ef
overplentie	s
overplentif	u
overplentifu	l
overplentiful	ln
overplentifull	y
overplentifuln	e
overplentifulne	s
overplentifulnes	s
overplentifulness	e
overplentifulnesse	s
overplo	t
overplot	st
overplott	ei
overplotte	d
overplotti	n
overplottin	g
overplu	s
overpo	lnpstw
overpol	eil
overpoli	cst
overpolic	ei
overpolice	ds
overpolici	n
overpolicin	g
overpolis	h
overpolish	ei
overpolishe	ds
overpolishi	n
overpolishin	g
overpolit	i
overpoliti	c
overpolitic	a
overpolitica	l
overpolitical	l
overpoliticall	y
overpoll	i
overpolli	n
overpollin	a
overpollina	t
overpollinat	ei
overpollinate	ds
overpollinati	n
overpollinatin	g
overpon	d
overpond	e
overponde	r
overponder	o
overpondero	u
overponderou	s
overponderous	ln
overponderousl	y
overponderousn	e
overponderousne	s
overponderousnes	s
overponderousness	e
overponderousnesse	s
overpop	u
overpopu	l
overpopul	a
overpopula	rt
overpopular	il
overpopulari	t
overpopularit	iy
overpopulariti	e
overpopularitie	s
overpopularl	y
overpopulat	ei
overpopulate	d
overpopulati	o
overpopulatio	n
overpos	it
overposi	t
overposit	i
overpositi	v
overpositiv	e
overpositive	ln
overpositivel	y
overpositiven	e
overpositivene	s
overpositivenes	s
overpositiveness	e
overpositivenesse	s
overpot	e
overpote	n
overpoten	t
overpotent	i
overpotenti	a
overpotentia	l
overpow	e
overpowe	r
overpower	eis
overpowere	d
overpoweri	n
overpowerin	g
overpowering	l
overpoweringl	y
overpr	aeio
overpra	ci
overprac	t
overpract	i
overpracti	c
overpractic	ei
overpractice	ds
overpractici	n
overpracticin	g
overprai	s
overprais	ei
overpraise	ds
overpraisi	n
overpraisin	g
overpre	acos
overprea	c
overpreac	h
overprec	i
overpreci	s
overprecis	ei
overprecise	ln
overprecisel	y
overprecisen	e
overprecisene	s
overprecisenes	s
overpreciseness	e
overprecisenesse	s
overprecisi	o
overprecisio	n
overprecision	s
overpreo	c
overpreoc	c
overpreocc	u
overpreoccu	p
overpreoccup	aiy
overpreoccupa	t
overpreoccupat	i
overpreoccupati	o
overpreoccupatio	n
overpreoccupation	s
overpreoccupi	e
overpreoccupie	ds
overpreoccupy	i
overpreoccupyi	n
overpreoccupyin	g
overpres	csu
overpresc	r
overprescr	i
overprescri	bp
overprescrib	ei
overprescribe	ds
overprescribi	n
overprescribin	g
overprescrip	t
overprescript	i
overprescripti	o
overprescriptio	n
overprescription	s
overpress	u
overpressu	r
overpressur	e
overpresu	m
overpresum	p
overpresump	t
overpresumpt	u
overpresumptu	o
overpresumptuo	u
overpresumptuou	s
overpresumptuous	ln
overpresumptuousl	y
overpresumptuousn	e
overpresumptuousne	s
overpresumptuousnes	s
overpresumptuousness	e
overpresumptuousnesse	s
overpri	nvz
overprin	t
overprint	eis
overprinte	d
overprinti	n
overprintin	g
overpriv	i
overprivi	l
overprivil	e
overprivile	g
overprivileg	e
overprivilege	d
overpriz	ei
overprize	ds
overprizi	n
overprizin	g
overpro	cdfglmostv
overproc	e
overproce	s
overproces	s
overprocess	ei
overprocesse	ds
overprocessi	n
overprocessin	g
overprod	u
overprodu	c
overproduc	eit
overproduce	ds
overproduci	n
overproducin	g
overproduct	i
overproducti	o
overproductio	n
overproduction	s
overprof	i
overprofi	c
overprofic	i
overprofici	e
overproficie	n
overproficien	t
overproficient	l
overproficientl	y
overprog	r
overprogr	a
overprogra	m
overprogram	eims
overprograme	d
overprogrami	n
overprogramin	g
overprogramm	ei
overprogramme	ds
overprogrammi	n
overprogrammin	g
overprol	i
overproli	f
overprolif	i
overprolifi	c
overprolific	an
overprolifica	l
overprolifical	l
overprolificall	y
overprolificn	e
overprolificne	s
overprolificnes	s
overprolificness	e
overprolificnesse	s
overprom	iop
overpromi	ns
overpromin	e
overpromine	n
overprominen	t
overprominent	l
overprominentl	y
overpromis	ei
overpromise	ds
overpromisi	n
overpromisin	g
overpromo	t
overpromot	ei
overpromote	ds
overpromoti	n
overpromotin	g
overpromp	t
overprompt	ln
overpromptl	y
overpromptn	e
overpromptne	s
overpromptnes	s
overpromptness	e
overpromptnesse	s
overproo	f
overpros	p
overprosp	e
overprospe	r
overprosper	o
overprospero	u
overprosperou	s
overprosperous	ln
overprosperousl	y
overprosperousn	e
overprosperousne	s
overprosperousnes	s
overprosperousness	e
overprosperousnesse	s
overprot	e
overprote	c
overprotec	t
overprotect	eis
overprotecte	d
overprotecti	nov
overprotectin	g
overprotectio	n
overprotection	s
overprotectiv	e
overprotective	n
overprotectiven	e
overprotectivene	s
overprotectivenes	s
overprotectiveness	e
overprotectivenesse	s
overprov	eio
overprove	dns
overprovi	dns
overprovid	ei
overprovide	ds
overprovidi	n
overprovidin	g
overprovin	g
overprovis	i
overprovisi	o
overprovisio	n
overprovision	s
overprovo	ck
overprovoc	a
overprovoca	t
overprovocat	i
overprovocati	o
overprovocatio	n
overprovocation	s
overprovok	ei
overprovoke	ds
overprovoki	n
overprovokin	g
overpu	bmnr
overpub	l
overpubl	i
overpubli	c
overpublic	i
overpublici	tz
overpublicit	iy
overpubliciti	e
overpublicitie	s
overpubliciz	ei
overpublicize	ds
overpublicizi	n
overpublicizin	g
overpum	p
overpump	eis
overpumpe	d
overpumpi	n
overpumpin	g
overpun	ci
overpunc	h
overpuni	s
overpunis	h
overpunish	eim
overpunishe	ds
overpunishi	n
overpunishin	g
overpunishm	e
overpunishme	n
overpunishmen	t
overpunishment	s
overpur	c
overpurc	h
overpurch	a
overpurcha	s
overpurchas	ei
overpurchase	ds
overpurchasi	n
overpurchasin	g
overq	u
overqu	a
overqua	ln
overqual	i
overquali	f
overqualif	iy
overqualifi	ce
overqualific	a
overqualifica	t
overqualificat	i
overqualificati	o
overqualificatio	n
overqualification	s
overqualifie	s
overqualify	i
overqualifyi	n
overqualifyin	g
overquan	t
overquant	i
overquanti	t
overquantit	y
overr	aeiou
overra	npst
overran	k
overrap	i
overrapi	d
overras	h
overrash	l
overrashl	y
overrat	ei
overrate	ds
overrati	no
overratin	g
overratio	n
overration	a
overrationa	l
overrational	il
overrationali	z
overrationaliz	aei
overrationaliza	t
overrationalizat	i
overrationalizati	o
overrationalizatio	n
overrationalization	s
overrationalize	ds
overrationalizi	n
overrationalizin	g
overrationall	y
overre	acdfglnpstw
overrea	cdl
overreac	ht
overreact	eis
overreacte	d
overreacti	nov
overreactin	g
overreactio	n
overreaction	s
overreactiv	e
overread	iy
overreadi	ln
overreadil	y
overreadin	e
overreadine	s
overreadines	s
overreadiness	e
overreadinesse	s
overreal	i
overreali	s
overrealis	mt
overrealism	s
overrealist	i
overrealisti	c
overrealistic	a
overrealistica	l
overrealistical	l
overrealisticall	y
overrec	ko
overreck	o
overrecko	n
overreco	r
overrecor	d
overred	u
overredu	c
overreduc	eit
overreduce	ds
overreduci	n
overreducin	g
overreduct	i
overreducti	o
overreductio	n
overreduction	s
overref	il
overrefi	n
overrefin	e
overrefine	dm
overrefinem	e
overrefineme	n
overrefinemen	t
overrefinement	s
overrefl	e
overrefle	c
overreflec	t
overreflect	i
overreflecti	ov
overreflectio	n
overreflection	s
overreflectiv	e
overreflective	ln
overreflectivel	y
overreflectiven	e
overreflectivene	s
overreflectivenes	s
overreflectiveness	e
overreflectivenesse	s
overreg	iu
overregi	m
overregim	e
overregime	n
overregimen	t
overregiment	eis
overregimente	d
overregimenti	n
overregimentin	g
overregu	l
overregul	a
overregula	t
overregulat	ei
overregulate	ds
overregulati	no
overregulatin	g
overregulatio	n
overregulation	s
overrel	ai
overrela	x
overrelax	ei
overrelaxe	ds
overrelaxi	n
overrelaxin	g
overreli	ag
overrelia	n
overrelian	ct
overrelianc	e
overreliance	s
overrelig	i
overreligi	o
overreligio	u
overreligiou	s
overreligious	l
overreligiousl	y
overren	t
overrep	or
overrepo	r
overrepor	t
overreport	eis
overreporte	d
overreporti	n
overreportin	g
overrepr	ei
overrepre	s
overrepres	es
overreprese	n
overrepresen	t
overrepresent	a
overrepresenta	t
overrepresentat	i
overrepresentati	v
overrepresentativ	e
overrepresentative	ln
overrepresentativel	y
overrepresentativen	e
overrepresentativene	s
overrepresentativenes	s
overrepresentativeness	e
overrepresentativenesse	s
overrepress	ei
overrepresse	d
overrepressi	n
overrepressin	g
overrepri	m
overreprim	a
overreprima	n
overrepriman	d
overreprimand	eis
overreprimande	d
overreprimandi	n
overreprimandin	g
overres	eiopt
overrese	r
overreser	v
overreserv	e
overreserve	d
overreserved	ln
overreservedl	y
overreservedn	e
overreservedne	s
overreservednes	s
overreservedness	e
overreservednesse	s
overresi	s
overresis	t
overresist	eis
overresiste	d
overresisti	n
overresistin	g
overreso	l
overresol	u
overresolu	t
overresolut	e
overresolute	ln
overresolutel	y
overresoluten	e
overresolutene	s
overresolutenes	s
overresoluteness	e
overresolutenesse	s
overresp	o
overrespo	n
overrespon	d
overrespond	eis
overresponde	d
overrespondi	n
overrespondin	g
overrest	r
overrestr	ai
overrestra	i
overrestrai	n
overrestrain	st
overrestraint	s
overrestri	c
overrestric	t
overrestrict	eis
overrestricte	d
overrestricti	no
overrestrictin	g
overrestrictio	n
overrestriction	s
overret	e
overrete	n
overreten	t
overretent	i
overretenti	o
overretentio	n
overretention	s
overrew	a
overrewa	r
overrewar	d
overreward	eis
overrewarde	d
overrewardi	n
overrewardin	g
overri	cdfgps
overric	h
overrich	ln
overrichl	y
overrichn	e
overrichne	s
overrichnes	s
overrichness	e
overrichnesse	s
overrid	dei
overridd	e
overridde	n
override	s
overridi	n
overridin	g
overriding	l
overridingl	y
overrif	e
overrig	ghio
overrigg	e
overrigge	d
overrigh	t
overright	e
overrighte	o
overrighteo	u
overrighteou	s
overrighteous	ln
overrighteousl	y
overrighteousn	e
overrighteousne	s
overrighteousnes	s
overrighteousness	e
overrighteousnesse	s
overrigi	d
overrigid	iln
overrigidi	t
overrigidit	iy
overrigiditi	e
overrigiditie	s
overrigidl	y
overrigidn	e
overrigidne	s
overrigidnes	s
overrigidness	e
overrigidnesse	s
overrigo	r
overrigor	o
overrigoro	u
overrigorou	s
overrigorous	ln
overrigorousl	y
overrigorousn	e
overrigorousne	s
overrigorousnes	s
overrigorousness	e
overrigorousnesse	s
overrip	e
overripe	n
overris	e
overrise	n
overro	adlmu
overroa	s
overroas	t
overroast	eis
overroaste	d
overroasti	n
overroastin	g
overrod	e
overrol	l
overrom	a
overroma	n
overroman	t
overromant	i
overromanti	c
overromantic	i
overromantici	z
overromanticiz	ei
overromanticize	ds
overromanticizi	n
overromanticizin	g
overrou	g
overroug	h
overrough	ln
overroughl	y
overroughn	e
overroughne	s
overroughnes	s
overroughness	e
overroughnesse	s
overru	dln
overrud	e
overrude	ln
overrudel	y
overruden	e
overrudene	s
overrudenes	s
overrudeness	e
overrudenesse	s
overrul	ei
overrule	drs
overruler	s
overruli	n
overrulin	g
overruling	l
overrulingl	y
overrun	ns
overrunn	ei
overrunne	r
overrunni	n
overrunnin	g
overrunning	l
overrunningl	y
overs	acehiklmopqtuwy
oversa	clntuwy
oversac	r
oversacr	i
oversacri	f
oversacrif	i
oversacrifi	c
oversacrific	i
oversacrifici	a
oversacrificia	l
oversacrificial	l
oversacrificiall	y
oversal	et
oversale	s
oversalt	eisy
oversalte	d
oversalti	n
oversaltin	g
oversan	g
oversang	u
oversangu	i
oversangui	n
oversanguin	e
oversat	u
oversatu	r
oversatur	a
oversatura	t
oversaturat	ei
oversaturate	ds
oversaturati	no
oversaturatin	g
oversaturatio	n
oversaturation	s
oversau	c
oversauc	ei
oversauce	ds
oversauci	n
oversaucin	g
oversc	aeoru
oversca	n
overscan	n
overscann	i
overscanni	n
overscannin	g
oversce	np
overscen	t
overscent	e
overscente	d
overscep	t
overscept	i
overscepti	c
oversceptic	i
oversceptici	s
overscepticis	m
overscepticism	s
oversco	l
overscol	l
overscoll	i
overscolli	n
overscollin	g
overscr	u
overscru	p
overscrup	u
overscrupu	l
overscrupul	o
overscrupulo	u
overscrupulou	s
overscrupulous	l
overscrupulousl	y
overscu	t
overscut	c
overscutc	h
overscutch	e
overscutche	d
overse	acelnrtvwx
oversea	s
overseas	o
overseaso	n
overseason	eis
overseasone	d
overseasoni	n
overseasonin	g
oversec	ru
oversecr	e
oversecre	t
oversecret	i
oversecreti	o
oversecretio	n
oversecretion	s
oversecu	r
oversecur	ei
oversecure	dls
oversecurel	y
oversecuri	nt
oversecurin	g
oversecurit	iy
oversecuriti	e
oversecuritie	s
oversee	dinrs
overseed	eis
overseede	d
overseedi	n
overseedin	g
overseei	n
overseein	g
overseer	s
oversel	fl
oversen	st
oversens	i
oversensi	bt
oversensib	l
oversensibl	ey
oversensible	n
oversensiblen	e
oversensiblene	s
oversensiblenes	s
oversensibleness	e
oversensiblenesse	s
oversensit	i
oversensiti	v
oversensitiv	ei
oversensitive	n
oversensitiven	e
oversensitivene	s
oversensitivenes	s
oversensitiveness	e
oversensitivenesse	s
oversensitivi	t
oversensitivit	i
oversensitiviti	e
oversensitivitie	s
oversent	i
oversenti	m
oversentim	e
oversentime	n
oversentimen	t
oversentiment	a
oversentimenta	l
oversentimental	l
oversentimentall	y
overser	eiv
oversere	n
overseren	e
overserene	l
overserenel	y
overseri	o
overserio	u
overseriou	s
overserious	ln
overseriousl	y
overseriousn	e
overseriousne	s
overseriousnes	s
overseriousness	e
overseriousnesse	s
overserv	ei
overserve	ds
overservi	cln
overservic	ei
overservice	ds
overservici	n
overservicin	g
overservil	ei
overservile	ln
overservilel	y
overservilen	e
overservilene	s
overservilenes	s
overservileness	e
overservilenesse	s
overservili	t
overservilit	iy
overserviliti	e
overservilitie	s
overservin	g
overset	t
oversett	l
oversettl	e
oversettle	m
oversettlem	e
oversettleme	n
oversettlemen	t
oversettlement	s
oversev	e
overseve	r
oversever	e
oversevere	ln
overseverel	y
overseveren	e
overseverene	s
overseverenes	s
oversevereness	e
overseverenesse	s
oversex	e
oversexe	d
oversh	aior
oversha	dr
overshad	o
overshado	w
overshadow	eis
overshadowe	dr
overshadower	s
overshadowi	n
overshadowin	g
overshadowing	l
overshadowingl	y
overshar	p
oversharp	n
oversharpn	e
oversharpne	s
oversharpnes	s
overshi	p
overship	m
overshipm	e
overshipme	n
overshipmen	t
overshipment	s
oversho	eort
overshoe	s
overshoo	t
overshor	t
overshort	en
overshorte	n
overshorten	eis
overshortene	d
overshorteni	n
overshortenin	g
overshortn	e
overshortne	s
overshortnes	s
overshortness	e
overshortnesse	s
overshr	aiou
overshra	n
overshran	k
overshri	n
overshrin	k
overshrink	is
overshrinki	n
overshrinkin	g
overshro	u
overshrou	d
overshru	n
overshrun	k
overshrunk	e
overshrunke	n
oversi	glmz
oversig	h
oversigh	t
oversight	s
oversil	e
oversile	n
oversilen	ct
oversilenc	e
oversilence	s
oversilent	ln
oversilentl	y
oversilentn	e
oversilentne	s
oversilentnes	s
oversilentness	e
oversilentnesse	s
oversim	p
oversimp	l
oversimpl	ei
oversimple	n
oversimplen	e
oversimplene	s
oversimplenes	s
oversimpleness	e
oversimplenesse	s
oversimpli	cfs
oversimplic	i
oversimplici	t
oversimplicit	iy
oversimpliciti	e
oversimplicitie	s
oversimplif	iy
oversimplifi	ce
oversimplific	a
oversimplifica	t
oversimplificat	i
oversimplificati	o
oversimplificatio	n
oversimplification	s
oversimplifie	drs
oversimplify	i
oversimplifyi	n
oversimplifyin	g
oversimplis	t
oversimplist	i
oversimplisti	c
oversiz	e
oversize	d
oversk	i
overski	lpr
overskil	l
overskill	e
overskille	d
overskir	t
oversl	aeiou
oversla	v
overslav	i
overslavi	s
overslavis	h
overslavish	ln
overslavishl	y
overslavishn	e
overslavishne	s
overslavishnes	s
overslavishness	e
overslavishnesse	s
oversle	ep
overslee	p
oversleep	is
oversleepi	n
oversleepin	g
overslep	t
oversli	g
overslig	h
oversligh	t
overslo	w
overslow	ln
overslowl	y
overslown	e
overslowne	s
overslownes	s
overslowness	e
overslownesse	s
overslu	n
overslun	g
oversm	o
oversmo	ko
oversmok	ei
oversmoke	ds
oversmoki	n
oversmokin	g
oversmoo	t
oversmoot	h
oversmooth	ln
oversmoothl	y
oversmoothn	e
oversmoothne	s
oversmoothnes	s
oversmoothness	e
oversmoothnesse	s
overso	acflopu
oversoa	kpr
oversoak	eis
oversoake	d
oversoaki	n
oversoakin	g
oversoap	eis
oversoape	d
oversoapi	n
oversoapin	g
oversoc	i
oversoci	a
oversocia	l
oversocial	l
oversociall	y
oversof	t
oversoft	eln
oversofte	n
oversoften	eis
oversoftene	d
oversofteni	n
oversoftenin	g
oversoftl	y
oversoftn	e
oversoftne	s
oversoftnes	s
oversoftness	e
oversoftnesse	s
oversol	ei
oversole	m
oversolem	n
oversolemn	ln
oversolemnl	y
oversolemnn	e
oversolemnne	s
oversolemnnes	s
oversolemnness	e
oversolemnnesse	s
oversoli	cd
oversolic	i
oversolici	t
oversolicit	ou
oversolicito	u
oversolicitou	s
oversolicitu	d
oversolicitud	e
oversolid	i
oversolidi	f
oversolidif	iy
oversolidifi	ce
oversolidific	a
oversolidifica	t
oversolidificat	i
oversolidificati	o
oversolidificatio	n
oversolidification	s
oversolidifie	ds
oversolidify	i
oversolidifyi	n
oversolidifyin	g
oversoo	n
oversop	h
oversoph	i
oversophi	s
oversophis	t
oversophist	i
oversophisti	c
oversophistic	a
oversophistica	t
oversophisticat	e
oversophisticate	d
oversou	lr
oversour	ln
oversourl	y
oversourn	e
oversourne	s
oversournes	s
oversourness	e
oversournesse	s
oversp	aeir
overspa	cr
overspac	i
overspaci	o
overspacio	u
overspaciou	s
overspacious	ln
overspaciousl	y
overspaciousn	e
overspaciousne	s
overspaciousnes	s
overspaciousness	e
overspaciousnesse	s
overspar	i
overspari	n
oversparin	g
oversparing	ln
oversparingl	y
oversparingn	e
oversparingne	s
oversparingnes	s
oversparingness	e
oversparingnesse	s
overspe	cden
overspec	iu
overspeci	af
overspecia	l
overspecial	i
overspeciali	z
overspecializ	aei
overspecializa	t
overspecializat	i
overspecializati	o
overspecializatio	n
overspecialization	s
overspecialize	ds
overspecializi	n
overspecializin	g
overspecif	iy
overspecifi	c
overspecific	a
overspecifica	t
overspecificat	i
overspecificati	o
overspecificatio	n
overspecu	l
overspecul	a
overspecula	t
overspeculat	ei
overspeculate	ds
overspeculati	nov
overspeculatin	g
overspeculatio	n
overspeculation	s
overspeculativ	e
overspeculative	ln
overspeculativel	y
overspeculativen	e
overspeculativene	s
overspeculativenes	s
overspeculativeness	e
overspeculativenesse	s
overspee	cd
overspeec	h
overspeed	eisy
overspeede	d
overspeedi	ln
overspeedil	y
overspeedin	eg
overspeedine	s
overspeedines	s
overspeediness	e
overspeedinesse	s
overspen	d
overspi	cl
overspic	ei
overspice	ds
overspici	n
overspicin	g
overspil	l
overspr	eiu
overspre	a
oversprea	d
overspri	n
oversprin	gk
oversprink	l
oversprinkl	e
overspru	n
oversprun	g
oversq	u
oversqu	ae
oversqua	r
oversquar	e
oversque	a
oversquea	m
oversqueam	i
oversqueami	s
oversqueamis	h
oversqueamish	ln
oversqueamishl	y
oversqueamishn	e
oversqueamishne	s
oversqueamishnes	s
oversqueamishness	e
oversqueamishnesse	s
overst	aeioru
oversta	bfrt
overstab	i
overstabi	l
overstabil	i
overstabili	t
overstabilit	i
overstabiliti	e
overstabilitie	s
overstaf	f
overstaff	is
overstaffi	n
overstaffin	g
overstar	c
overstarc	h
overstarch	ei
overstarche	ds
overstarchi	n
overstarchin	g
overstat	ei
overstate	dms
overstatem	e
overstateme	n
overstatemen	t
overstatement	s
overstati	n
overstatin	g
overste	aep
overstea	d
overstead	fiy
oversteadf	a
oversteadfa	s
oversteadfas	t
oversteadfast	ln
oversteadfastl	y
oversteadfastn	e
oversteadfastne	s
oversteadfastnes	s
oversteadfastness	e
oversteadfastnesse	s
oversteadi	ln
oversteadil	y
oversteadin	e
oversteadine	s
oversteadines	s
oversteadiness	e
oversteadinesse	s
overstee	r
overstep	ps
overstepp	ei
oversteppe	d
oversteppi	n
oversteppin	g
oversti	fmn
overstif	f
overstiff	eln
overstiffe	n
overstiffen	eis
overstiffene	d
overstiffeni	n
overstiffenin	g
overstiffl	y
overstiffn	e
overstiffne	s
overstiffnes	s
overstiffness	e
overstiffnesse	s
overstim	u
overstimu	l
overstimul	a
overstimula	t
overstimulat	ei
overstimulate	ds
overstimulati	no
overstimulatin	g
overstimulatio	n
overstimulation	s
overstin	k
oversto	cru
overstoc	k
overstock	eis
overstocke	d
overstocki	n
overstockin	g
overstocking	s
overstor	ei
overstore	sy
overstori	n
overstorin	g
overstou	t
overstout	ln
overstoutl	y
overstoutn	e
overstoutne	s
overstoutnes	s
overstoutness	e
overstoutnesse	s
overstr	aeio
overstra	i
overstrai	gnt
overstraig	h
overstraigh	t
overstraight	eln
overstraighte	n
overstraighten	eis
overstraightene	d
overstraighteni	n
overstraightenin	g
overstraightl	y
overstraightn	e
overstraightne	s
overstraightnes	s
overstraightness	e
overstraightnesse	s
overstrain	eis
overstraine	d
overstraini	n
overstrainin	g
overstre	anst
overstrea	m
overstren	g
overstreng	t
overstrengt	h
overstrength	e
overstrengthe	n
overstrengthen	eis
overstrengthene	d
overstrengtheni	n
overstrengthenin	g
overstres	s
overstress	ei
overstresse	ds
overstressi	n
overstressin	g
overstret	c
overstretc	h
overstretch	ei
overstretche	ds
overstretchi	n
overstretchin	g
overstri	dkv
overstrid	e
overstride	n
overstriden	ct
overstridenc	eiy
overstridence	s
overstridenci	e
overstridencie	s
overstrident	l
overstridentl	y
overstrik	i
overstriki	n
overstrikin	g
overstriv	ei
overstrive	ns
overstrivi	n
overstrivin	g
overstro	knv
overstrok	e
overstron	g
overstrong	ln
overstrongl	y
overstrongn	e
overstrongne	s
overstrongnes	s
overstrongness	e
overstrongnesse	s
overstrov	e
overstu	d
overstud	iy
overstudi	o
overstudio	u
overstudiou	s
overstudious	ln
overstudiousl	y
overstudiousn	e
overstudiousne	s
overstudiousnes	s
overstudiousness	e
overstudiousnesse	s
oversu	bdfmprs
oversub	st
oversubs	c
oversubsc	r
oversubscr	i
oversubscri	bp
oversubscrib	e
oversubscribe	d
oversubscrip	t
oversubscript	i
oversubscripti	o
oversubscriptio	n
oversubt	l
oversubtl	ey
oversubtle	t
oversubtlet	y
oversud	s
oversuf	f
oversuff	i
oversuffi	c
oversuffic	i
oversuffici	e
oversufficie	n
oversufficien	t
oversufficient	l
oversufficientl	y
oversup	p
oversupp	l
oversuppl	iy
oversuppli	e
oversupplie	ds
oversupply	i
oversupplyi	n
oversupplyin	g
oversur	e
oversure	lnt
oversurel	y
oversuren	e
oversurene	s
oversurenes	s
oversureness	e
oversurenesse	s
oversuret	iy
oversureti	e
oversuretie	s
oversus	cp
oversusc	e
oversusce	p
oversuscep	t
oversuscept	i
oversuscepti	b
oversusceptib	l
oversusceptibl	ey
oversusceptible	n
oversusceptiblen	e
oversusceptiblene	s
oversusceptiblenes	s
oversusceptibleness	e
oversusceptiblenesse	s
oversusp	i
oversuspi	c
oversuspic	i
oversuspici	o
oversuspicio	u
oversuspiciou	s
oversuspicious	ln
oversuspiciousl	y
oversuspiciousn	e
oversuspiciousne	s
oversuspiciousnes	s
oversuspiciousness	e
oversuspiciousnesse	s
oversw	aeiu
overswa	r
overswar	m
overswe	e
overswee	t
oversweet	eln
oversweete	n
oversweeten	eis
oversweetene	d
oversweeteni	n
oversweetenin	g
oversweetl	y
oversweetn	e
oversweetne	s
oversweetnes	s
oversweetness	e
oversweetnesse	s
overswi	mn
overswin	g
overswing	is
overswingi	n
overswingin	g
overswu	n
overswun	g
oversy	s
oversys	t
oversyst	e
oversyste	m
oversystem	a
oversystema	t
oversystemat	i
oversystemati	c
oversystematic	an
oversystematica	l
oversystematical	l
oversystematicall	y
oversystematicn	e
oversystematicne	s
oversystematicnes	s
oversystematicness	e
oversystematicnesse	s
overt	aehilnoruwy
overta	klmx
overtak	aei
overtaka	b
overtakab	l
overtakabl	e
overtake	nrs
overtaker	s
overtaki	n
overtakin	g
overtal	k
overtalk	aeis
overtalka	t
overtalkat	i
overtalkati	v
overtalkativ	e
overtalkative	ln
overtalkativel	y
overtalkativen	e
overtalkativene	s
overtalkativenes	s
overtalkativeness	e
overtalkativenesse	s
overtalke	d
overtalki	n
overtalkin	g
overtam	e
overtame	ln
overtamel	y
overtamen	e
overtamene	s
overtamenes	s
overtameness	e
overtamenesse	s
overtax	aei
overtaxa	t
overtaxat	i
overtaxati	o
overtaxatio	n
overtaxation	s
overtaxe	ds
overtaxi	n
overtaxin	g
overte	cdelnr
overtec	h
overtech	n
overtechn	i
overtechni	c
overtechnic	a
overtechnica	l
overtechnical	il
overtechnicali	t
overtechnicalit	iy
overtechnicaliti	e
overtechnicalitie	s
overtechnicall	y
overted	i
overtedi	o
overtedio	u
overtediou	s
overtedious	ln
overtediousl	y
overtediousn	e
overtediousne	s
overtediousnes	s
overtediousness	e
overtediousnesse	s
overtee	m
overtel	l
overten	ads
overtena	c
overtenac	i
overtenaci	o
overtenacio	u
overtenaciou	s
overtenacious	ln
overtenaciousl	y
overtenaciousn	e
overtenaciousne	s
overtenaciousnes	s
overtenaciousness	e
overtenaciousnesse	s
overtend	e
overtende	r
overtens	i
overtensi	o
overtensio	n
overtension	s
overter	v
overterv	e
overth	eior
overthe	a
overthea	t
overtheat	r
overtheatr	i
overtheatri	c
overtheatric	a
overtheatrica	l
overtheatrical	ln
overtheatricall	y
overtheatricaln	e
overtheatricalne	s
overtheatricalnes	s
overtheatricalness	e
overtheatricalnesse	s
overthi	cn
overthic	k
overthick	ln
overthickl	y
overthickn	e
overthickne	s
overthicknes	s
overthickness	e
overthicknesse	s
overthin	kln
overthink	is
overthinki	n
overthinkin	g
overthinl	y
overthinn	e
overthinne	s
overthinnes	s
overthinness	e
overthinnesse	s
overtho	u
overthou	g
overthoug	h
overthough	t
overthought	f
overthoughtf	u
overthoughtfu	l
overthoughtful	ln
overthoughtfull	y
overthoughtfuln	e
overthoughtfulne	s
overthoughtfulnes	s
overthoughtfulness	e
overthoughtfulnesse	s
overthr	eo
overthre	w
overthro	nw
overthron	g
overthrong	eis
overthronge	d
overthrongi	n
overthrongin	g
overthrow	eins
overthrowe	r
overthrower	s
overthrowi	n
overthrowin	g
overti	glmnp
overtig	h
overtigh	t
overtight	eln
overtighte	n
overtighten	eis
overtightene	d
overtighteni	n
overtightenin	g
overtightl	y
overtightn	e
overtightne	s
overtightnes	s
overtightness	e
overtightnesse	s
overtil	t
overtim	ei
overtime	ds
overtimi	dn
overtimid	iln
overtimidi	t
overtimidit	iy
overtimiditi	e
overtimiditie	s
overtimidl	y
overtimidn	e
overtimidne	s
overtimidnes	s
overtimidness	e
overtimidnesse	s
overtimin	g
overtin	st
overtins	e
overtinse	l
overtinsel	eils
overtinsele	d
overtinseli	n
overtinselin	g
overtinsell	ei
overtinselle	d
overtinselli	n
overtinsellin	g
overtint	eis
overtinte	d
overtinti	n
overtintin	g
overtip	ps
overtipp	ei
overtippe	d
overtippi	n
overtippin	g
overtl	y
overtn	e
overtne	s
overtnes	s
overtness	e
overtnesse	s
overto	ilnoprw
overtoi	l
overtol	e
overtole	r
overtoler	a
overtolera	n
overtoleran	t
overtolerant	l
overtolerantl	y
overton	e
overtone	s
overtoo	k
overtop	p
overtopp	l
overtoppl	e
overtor	t
overtort	u
overtortu	r
overtortur	ei
overtorture	ds
overtorturi	n
overtorturin	g
overtow	e
overtowe	r
overtr	aeiou
overtra	cimpw
overtrac	e
overtrai	n
overtrain	eis
overtraine	d
overtraini	n
overtrainin	g
overtram	p
overtramp	l
overtrampl	e
overtraw	l
overtre	a
overtrea	dt
overtread	s
overtreat	eims
overtreate	d
overtreati	n
overtreatin	g
overtreatm	e
overtreatme	n
overtreatmen	t
overtreatment	s
overtri	mp
overtrim	ms
overtrimm	ei
overtrimme	d
overtrimmi	n
overtrimmin	g
overtro	uw
overtrou	b
overtroub	l
overtroubl	ei
overtrouble	ds
overtroubli	n
overtroublin	g
overtru	mst
overtrum	p
overtrus	t
overtrust	eis
overtruste	d
overtrusti	n
overtrustin	g
overtrut	h
overtruth	f
overtruthf	u
overtruthfu	l
overtruthful	ln
overtruthfull	y
overtruthfuln	e
overtruthfulne	s
overtruthfulnes	s
overtruthfulness	e
overtruthfulnesse	s
overtu	mr
overtum	b
overtumb	l
overtumbl	e
overtur	ein
overture	ds
overturi	n
overturin	g
overturn	aeis
overturna	b
overturnab	l
overturnabl	e
overturne	dr
overturni	n
overturnin	g
overtw	i
overtwi	s
overtwis	t
overtwist	eis
overtwiste	d
overtwisti	n
overtwistin	g
overty	p
overtyp	e
overu	rst
overur	g
overurg	ei
overurge	ds
overurgi	n
overurgin	g
overus	ei
overuse	ds
overusi	n
overusin	g
overut	i
overuti	l
overutil	i
overutili	z
overutiliz	aei
overutiliza	t
overutilizat	i
overutilizati	o
overutilizatio	n
overutilization	s
overutilize	ds
overutilizi	n
overutilizin	g
overv	aeiu
overva	lru
overval	iu
overvali	a
overvalia	n
overvalian	t
overvaliant	ln
overvaliantl	y
overvaliantn	e
overvaliantne	s
overvaliantnes	s
overvaliantness	e
overvaliantnesse	s
overvalu	ae
overvalua	bt
overvaluab	l
overvaluabl	ey
overvaluable	n
overvaluablen	e
overvaluablene	s
overvaluablenes	s
overvaluableness	e
overvaluablenesse	s
overvaluat	i
overvaluati	o
overvaluatio	n
overvar	iy
overvari	ae
overvaria	t
overvariat	i
overvariati	o
overvariatio	n
overvariation	s
overvarie	dst
overvariet	iy
overvarieti	e
overvarietie	s
overvary	i
overvaryi	n
overvaryin	g
overvau	l
overvaul	t
overve	hin
overveh	e
overvehe	m
overvehem	e
overveheme	n
overvehemen	t
overvehement	l
overvehementl	y
overvei	l
overven	t
overvent	i
overventi	l
overventil	a
overventila	t
overventilat	ei
overventilate	ds
overventilati	no
overventilatin	g
overventilatio	n
overvi	eov
overvie	w
overview	eis
overviewe	dr
overviewi	n
overviewin	g
overvio	l
overviol	e
overviole	n
overviolen	t
overviolent	ln
overviolentl	y
overviolentn	e
overviolentne	s
overviolentnes	s
overviolentness	e
overviolentnesse	s
overviv	i
overvivi	d
overvivid	ln
overvividl	y
overvividn	e
overvividne	s
overvividnes	s
overvividness	e
overvividnesse	s
overvu	l
overvul	c
overvulc	a
overvulca	n
overvulcan	i
overvulcani	z
overvulcaniz	e
overw	aehior
overwa	nrt
overwan	d
overwand	e
overwande	r
overwar	dmy
overwarm	e
overwarme	d
overwat	ce
overwatc	h
overwatch	i
overwatchi	n
overwatchin	g
overwate	r
overwater	eis
overwatere	d
overwateri	n
overwaterin	g
overwe	aeilt
overwea	klt
overweak	ln
overweakl	y
overweakn	e
overweakne	s
overweaknes	s
overweakness	e
overweaknesse	s
overweal	t
overwealt	h
overwealth	sy
overweat	h
overweath	e
overweathe	r
overweather	e
overweathere	d
overwee	np
overween	i
overweeni	n
overweenin	g
overwei	g
overweig	h
overweigh	t
overweight	eis
overweighte	d
overweighti	n
overweightin	g
overwel	l
overwet	lnst
overwetl	y
overwetn	e
overwetne	s
overwetnes	s
overwetness	e
overwetnesse	s
overwett	ei
overwette	d
overwetti	n
overwettin	g
overwh	ei
overwhe	l
overwhel	m
overwhelm	eims
overwhelme	dr
overwhelmi	n
overwhelmin	g
overwhelming	ln
overwhelmingl	y
overwhelmingn	e
overwhelmingne	s
overwhelmingnes	s
overwhelmingness	e
overwhelmingnesse	s
overwhelmm	e
overwhelmme	n
overwhelmmen	t
overwhi	p
overwhip	pst
overwhipp	ei
overwhippe	d
overwhippi	n
overwhippin	g
overwi	dlnt
overwid	e
overwide	ln
overwidel	y
overwiden	e
overwidene	s
overwidenes	s
overwideness	e
overwidenesse	s
overwil	dly
overwild	ln
overwildl	y
overwildn	e
overwildne	s
overwildnes	s
overwildness	e
overwildnesse	s
overwill	i
overwilli	n
overwillin	g
overwilling	ln
overwillingl	y
overwillingn	e
overwillingne	s
overwillingnes	s
overwillingness	e
overwillingnesse	s
overwin	dg
overwind	eis
overwinde	dr
overwindi	n
overwindin	g
overwit	h
overwith	eh
overwithe	r
overwither	e
overwithere	d
overwithh	eo
overwithhe	l
overwithhel	d
overwithho	l
overwithhol	d
overwithhold	is
overwithholdi	n
overwithholdin	g
overwo	or
overwoo	d
overwor	k
overwork	eis
overworke	d
overworki	n
overworkin	g
overwr	aio
overwra	p
overwri	t
overwrit	eit
overwrite	s
overwriti	n
overwritin	g
overwritt	e
overwritte	n
overwro	t
overwrot	e
overz	e
overze	a
overzea	l
overzeal	o
overzealo	u
overzealou	s
overzealous	n
overzealousn	e
overzealousne	s
overzealousnes	s
overzealousness	e
overzealousnesse	s
ovf	fv
ovi	dfnp
ovid	u
ovidu	c
oviduc	t
ovif	o
ovifo	r
ovifor	m
ovin	e
ovip	ao
ovipa	r
ovipar	ioy
ovipari	t
oviparit	i
ovipariti	e
oviparitie	s
oviparo	u
oviparou	s
oviparous	ln
oviparousl	y
oviparousn	e
oviparousne	s
oviparousnes	s
oviparousness	e
oviparousnesse	s
ovipo	s
ovipos	i
oviposi	t
ovn	fk
ovo	i
ovoi	d
ovs	ir
ovu	lm
ovul	ae
ovula	t
ovulat	ei
ovulate	ds
ovulati	no
ovulatin	g
ovulatio	n
ovule	s
ow	abdefhijlnopsuvwxz
owa	rv
owe	dns
owen	s
owi	n
owin	g
owj	rv
owl	eilms
owle	st
owles	t
owli	s
owlis	h
owll	i
owlli	k
owllik	e
own	efirsv
owne	drs
owner	s
owners	h
ownersh	i
ownershi	p
ownership	s
ownes	t
owni	n
ownin	g
owo	rsv
owos	v
owp	gt
owu	hv
owv	m
oww	b
owz	p
ox	abcdefhijklmnoprtuvxy
oxa	lrv
oxal	i
oxali	cs
oxb	lo
oxbl	o
oxblo	o
oxbloo	d
oxbo	w
oxbow	s
oxc	ac
oxca	r
oxcar	t
oxd	u
oxe	nrsvy
oxey	e
oxf	o
oxfo	r
oxfor	d
oxford	s
oxfords	h
oxfordsh	i
oxfordshi	r
oxfordshir	e
oxh	ei
oxhe	a
oxhea	r
oxhear	t
oxhi	d
oxhid	e
oxi	d
oxid	aeis
oxida	bnt
oxidab	l
oxidabl	e
oxidan	t
oxidat	i
oxidati	o
oxidatio	n
oxide	s
oxidi	csz
oxidis	ei
oxidise	drs
oxidisi	n
oxidisin	g
oxidiz	aei
oxidiza	b
oxidizab	il
oxidizabi	l
oxidizabil	i
oxidizabili	t
oxidizabilit	iy
oxidizabiliti	e
oxidizabilitie	s
oxidizabl	e
oxidize	dmrs
oxidizem	e
oxidizeme	n
oxidizemen	t
oxidizi	n
oxidizin	g
oxidizing	s
oxj	v
oxl	ei
oxle	y
oxli	kp
oxlik	e
oxm	bw
oxn	afv
oxna	r
oxnar	d
oxo	n
oxon	i
oxoni	a
oxonia	n
oxp	dhmv
oxt	ae
oxta	i
oxtai	l
oxte	r
oxu	brv
oxx	nprv
oxy	aghmt
oxya	c
oxyac	e
oxyace	t
oxyacet	y
oxyacety	l
oxyacetyl	e
oxyacetyle	n
oxyacetylen	e
oxyg	e
oxyge	n
oxygen	ailos
oxygena	nt
oxygenan	t
oxygenat	ei
oxygenate	ds
oxygenati	no
oxygenatin	g
oxygenatio	n
oxygenation	s
oxygeni	c
oxygenic	i
oxygenici	t
oxygenicit	iy
oxygeniciti	e
oxygenicitie	s
oxygenl	e
oxygenle	s
oxygenles	s
oxygeno	u
oxygenou	s
oxyh	y
oxyhy	d
oxyhyd	r
oxyhydr	o
oxyhydro	g
oxyhydrog	e
oxyhydroge	n
oxym	o
oxymo	r
oxymor	ao
oxymoro	n
oxymoron	is
oxymoroni	c
oxymoronic	a
oxymoronica	l
oxymoronical	l
oxymoronicall	y
oxyt	o
oxyto	n
oxyton	e
oy	abdefijnoprsuwxyz
oya	v
oyb	gw
oybg	v
oyd	mo
oye	orsv
oyf	bfp
oyj	v
oyn	d
oyo	ko
oyp	bdfpz
oypd	v
oys	t
oyst	e
oyste	r
oyster	ceiosy
oysterc	a
oysterca	t
oystercat	c
oystercatc	h
oystercatch	e
oystercatche	r
oystere	dr
oysteri	s
oysteris	h
oystero	u
oysterou	s
oyu	f
oyuf	v
oyw	f
oyy	apr
oz	abcdefghijklmnopqrstuvwxyz
oza	efhkmopqrstuvxy
ozak	v
ozao	v
ozar	k
ozark	s
ozb	abdeiklmoprsuvz
ozbk	v
ozbo	v
ozbp	v
ozc	bcfklopvw
ozcl	rv
ozco	v
ozcw	v
ozd	ejkmoqswz
ozdk	v
ozdm	v
ozdo	v
ozdq	v
ozdw	v
oze	dgimqrstuvwz
ozed	v
ozeq	v
ozf	abcdefghmnrtuv
ozfb	v
ozfd	v
ozfe	v
ozfn	v
ozft	v
ozfu	rv
ozg	abnoqvw
ozh	bfgprv
ozi	ux
ozj	bdfjorsuvz
ozjb	v
ozju	v
ozk	ablmrv
ozkb	rv
ozl	abfgiklnopqrstuvxy
ozla	v
ozlb	v
ozlf	v
ozlk	v
ozlo	rsv
ozm	eoqrstuvz
ozms	v
ozmv	v
ozmz	v
ozn	adeflmoprsv
ozne	v
oznf	v
oznp	v
oznr	v
ozns	rv
ozo	bdhlnoqtvz
ozob	v
ozon	eio
ozone	dls
ozonel	e
ozonele	s
ozoneles	s
ozoni	cfsz
ozonif	e
ozonife	r
ozonifer	o
ozonifero	u
ozoniferou	s
ozonis	e
ozonise	r
ozoniz	e
ozonize	r
ozono	s
ozonos	p
ozonosp	h
ozonosph	e
ozonosphe	r
ozonospher	e
ozp	adfoprstuv
ozpu	v
ozq	bfnoqrtuvx
ozr	bdhlnorstuv
ozrb	v
ozrd	rsv
ozrt	v
ozru	rv
ozrv	v
ozs	binorstuvy
ozsb	rv
ozss	v
ozst	v
ozt	deoq
ozu	fioprsv
ozv	morsvz
ozvs	v
ozw	defhilrtu
ozx	v
ozy	adprsvwyz
ozya	v
ozyp	v
ozyy	v
ozyz	v
ozz	fijoqsvz
ozzi	e
