q	abcdefghijklmnopqrstuvwxyz
qa	adejklmnopqtx
qad	fkorv
qadf	v
qaj	a
qak	mv
qam	grt
qan	f
qao	b
qaq	bcdijx
qaqb	rv
qaqd	v
qat	arv
qata	r
qax	f
qb	abdeghijklmnopqrtxy
qba	bs
qbas	i
qbasi	c
qbb	my
qbe	defv
qbg	o
qbh	uv
qbi	t
qbit	et
qbite	e
qbitt	o
qbitto	r
qbittor	r
qbittorr	e
qbittorre	n
qbittorren	t
qbittorrent	e
qbittorrente	e
qbk	ru
qbl	v
qbn	vy
qbo	f
qbp	dglmqswz
qbq	bfj
qbqj	v
qbr	v
qby	o
qc	aefijklmsv
qca	v
qce	q
qck	v
qd	bdefgiklnostvxy
qdb	s
qde	m
qdf	u
qdg	d
qdn	l
qdt	o
qdto	v
qdv	mv
qdx	v
qe	deghkmopqrstuvwx
qed	ei
qedi	t
qee	mrv
qeg	u
qeo	qt
qeq	e
qeqe	v
qer	ersvw
qes	i
qet	r
qew	u
qf	abcdefghjklmnosuvwxyz
qfa	dorvxy
qfb	v
qfc	cy
qfd	dl
qfe	deku
qfek	v
qff	d
qfh	v
qfj	bd
qfk	blrsv
qfl	ds
qfn	chimpr
qfo	o
qfs	v
qfu	mpv
qfv	m
qfw	d
qfx	v
qfy	bmov
qfz	fo
qg	aijnoqrux
qga	rv
qgi	u
qgn	forsv
qgo	v
qgq	f
qh	adnortux
qhd	d
qhn	p
qho	v
qht	b
qhx	v
qi	aefijnov
qia	df
qie	e
qii	v
qin	frv
qj	acegjknoruv
qjc	bt
qje	d
qjg	n
qjj	fqv
qjo	u
qjr	b
qk	abelnwxz
qka	rv
qke	v
qkn	fv
ql	abdhknopqrstuwxz
qlb	i
qld	jr
qlh	z
qlk	v
qln	rv
qlo	kpsz
qlos	v
qlp	sv
qlq	v
qlr	bv
qlrb	v
qls	v
qlw	g
qlz	p
qm	bcefmnqtvx
qmc	sv
qmcs	v
qme	v
qmm	u
qmmu	v
qmn	o
qmq	fmt
qn	abcdefhjlmnoqrstuvy
qna	pv
qnb	rv
qnc	p
qnd	ls
qne	o
qnf	rsv
qnh	t
qnm	grt
qnmt	v
qnn	frv
qno	l
qnq	bcd
qnqb	rv
qnr	s
qns	bv
qnu	bhtw
qo	acfijknoprsuwx
qoc	disv
qof	u
qoj	rv
qon	v
qoo	jpt
qooj	rv
qou	v
qox	v
qp	abdfglmoqxz
qpb	n
qpd	jop
qpdj	v
qpf	d
qpm	j
qpo	rv
qpq	g
qpx	v
qpz	w
qq	eijknoqrtu
qqj	q
qqk	v
qqn	st
qqo	v
qqq	efmostuy
qqqe	v
qqqf	v
qqqm	v
qqqy	v
qqr	jq
qqu	v
qr	abcdejknopqsuvx
qrb	b
qrc	o
qrco	d
qrcod	e
qrd	bdlrv
qrdd	v
qre	bnrv
qreb	v
qrj	fv
qrk	a
qrn	dq
qro	bkv
qrq	v
qrs	s
qrv	u
qrx	v
qs	aefilnopqrtuv
qsf	s
qsi	v
qsn	pqr
qso	s
qsp	a
qspa	c
qspac	e
qsq	j
qsqj	v
qsr	q
qt	acdijkmnotz
qta	m
qtc	c
qtd	epq
qti	v
qtj	u
qtm	p
qtmp	v
qtn	rsv
qto	oq
qtt	ab
qtta	b
qttab	b
qttabb	a
qttabba	r
qtz	gpu
qu	abcdefgijklmnopqrtuvwxyz
qua	acdfghiklnrstvxy
quac	k
quack	eis
quacke	dr
quacker	y
quacki	ns
quackin	g
quackis	hm
quackish	ln
quackishl	y
quackishn	e
quackishne	s
quackishnes	s
quackishness	e
quackishnesse	s
quacks	a
quacksa	l
quacksal	v
quacksalv	e
quacksalve	r
quad	dr
quadd	ei
quadde	d
quaddi	n
quaddin	g
quadr	aeiou
quadra	nt
quadran	gt
quadrang	lu
quadrangl	e
quadrangle	ds
quadrangu	l
quadrangul	a
quadrangula	r
quadrant	als
quadranta	l
quadrantl	i
quadrantli	k
quadrantlik	e
quadrat	eiu
quadrati	c
quadratic	as
quadratica	l
quadratical	l
quadraticall	y
quadratu	r
quadratur	e
quadrature	s
quadre	n
quadren	n
quadrenn	i
quadrenni	a
quadrennia	l
quadri	cdglnptv
quadric	e
quadrice	p
quadricep	s
quadrid	e
quadride	n
quadriden	t
quadrident	a
quadridenta	t
quadridentat	e
quadrig	a
quadriga	m
quadrigam	i
quadrigami	s
quadrigamis	t
quadril	alo
quadrila	t
quadrilat	e
quadrilate	r
quadrilater	a
quadrilatera	l
quadrilateral	lns
quadrilaterall	y
quadrilateraln	e
quadrilateralne	s
quadrilateralnes	s
quadrilateralness	e
quadrilateralnesse	s
quadrill	ei
quadrilli	o
quadrillio	n
quadrilo	cg
quadriloc	u
quadrilocu	l
quadrilocul	a
quadrilocula	r
quadrilog	y
quadrin	o
quadrino	m
quadrinom	i
quadrinomi	a
quadrinomia	l
quadrip	ailu
quadripa	r
quadripar	t
quadripart	i
quadriparti	t
quadripartit	e
quadripi	n
quadripin	n
quadripinn	a
quadripinna	t
quadripinnat	e
quadripl	e
quadriple	g
quadripleg	i
quadriplegi	ac
quadriplegia	s
quadriplegic	s
quadripu	n
quadripun	t
quadripunt	a
quadripunta	l
quadrit	u
quadritu	b
quadritub	e
quadritube	r
quadrituber	c
quadrituberc	u
quadritubercu	l
quadritubercul	a
quadritubercula	t
quadrituberculat	e
quadriv	io
quadrivi	u
quadriviu	m
quadrivo	l
quadrivol	t
quadrivolt	i
quadrivolti	n
quadrivoltin	e
quadro	o
quadroo	n
quadru	p
quadrup	elo
quadrupe	d
quadruped	aeis
quadrupeda	l
quadrupedal	il
quadrupedali	s
quadrupedalis	m
quadrupedall	y
quadrupede	d
quadrupedi	s
quadrupedis	m
quadrupedism	s
quadrupl	eiy
quadruple	dnrstx
quadruplen	e
quadruplene	s
quadruplenes	s
quadrupleness	e
quadruplenesse	s
quadruplet	s
quadrupli	cn
quadruplic	ai
quadruplica	t
quadruplicat	i
quadruplicati	o
quadruplicatio	n
quadruplici	t
quadruplicit	i
quadrupliciti	e
quadruplicitie	s
quadruplin	g
quadrupo	l
quadrupol	e
quaf	f
quag	gm
quagg	ay
quagm	i
quagmi	r
quagmir	e
quagmire	s
quah	o
quaho	g
quai	ln
quail	eils
quaile	dr
quailer	y
quaili	n
quailin	g
quaill	i
quailli	k
quaillik	e
quain	t
quaint	eiln
quainte	rs
quaintes	t
quainti	s
quaintis	h
quaintl	y
quaintn	e
quaintne	s
quaintnes	s
quaintness	e
quaintnesse	s
quak	eiy
quake	drs
quaker	eis
quakere	s
quakeres	s
quakeri	z
quakeriz	ae
quakeriza	t
quakerizat	i
quakerizati	o
quakerizatio	n
quakerization	s
quakerize	s
quaki	n
quakin	g
qual	im
quali	ft
qualif	iy
qualifi	ce
qualific	a
qualifica	t
qualificat	io
qualificati	o
qualificatio	n
qualification	s
qualificato	r
qualificator	y
qualifie	drs
qualified	ln
qualifiedl	y
qualifiedn	e
qualifiedne	s
qualifiednes	s
qualifiedness	e
qualifiednesse	s
qualifier	s
qualify	i
qualifyi	n
qualifyin	g
qualifying	l
qualifyingl	y
qualit	aiy
qualita	t
qualitat	i
qualitati	v
qualitativ	e
qualitative	l
qualitativel	y
qualiti	e
qualitie	s
quality	lo
qualityl	e
qualityle	s
qualityles	s
qualityo	f
qualityof	s
qualityofs	e
qualityofse	r
qualityofser	v
qualityofserv	i
qualityofservi	c
qualityofservic	e
qualm	ilsy
qualmi	es
qualmie	rs
qualmies	t
qualmis	h
qualml	e
qualmle	s
qualmles	s
qualmless	n
qualmlessn	e
qualmlessne	s
qualmlessnes	s
quan	dt
quand	a
quanda	r
quandar	iy
quandari	e
quandarie	s
quant	aiu
quanti	cflstvz
quantic	o
quantif	iy
quantifi	ace
quantifia	b
quantifiab	il
quantifiabi	l
quantifiabil	i
quantifiabili	t
quantifiabilit	y
quantifiabl	ey
quantific	a
quantifica	t
quantificat	i
quantificati	o
quantificatio	n
quantification	s
quantifie	drs
quantifier	s
quantify	i
quantifyi	n
quantifyin	g
quantil	e
quantis	e
quantit	aiy
quantita	t
quantitat	i
quantitati	v
quantitativ	ei
quantitative	ln
quantitativel	y
quantitativen	e
quantitativene	s
quantitativenes	s
quantitativeness	e
quantitativenesse	s
quantitativi	s
quantitativis	t
quantiti	ev
quantitie	s
quantitiv	e
quantitive	ln
quantitivel	y
quantitiven	e
quantitivene	s
quantitivenes	s
quantitiveness	e
quantitivenesse	s
quantiv	a
quantiva	l
quantival	e
quantivale	n
quantivalen	c
quantivalenc	e
quantiz	aei
quantiza	t
quantizat	i
quantizati	o
quantizatio	n
quantize	ds
quantizi	n
quantizin	g
quantu	m
quantum	u
quantumu	l
quantumul	t
quantumult	x
quar	akrt
quara	n
quaran	t
quarant	i
quaranti	n
quarantin	ei
quarantine	drs
quarantiner	s
quarantini	n
quarantinin	g
quark	dx
quarkd	o
quarkdo	w
quarkdow	n
quarkdown	l
quarkdownl	o
quarkdownlo	a
quarkdownloa	d
quarkdownload	s
quarkx	p
quarkxp	r
quarkxpr	e
quarkxpre	s
quarkxpres	s
quarr	eiy
quarre	l
quarrel	eils
quarrele	dr
quarreler	s
quarreli	n
quarrelin	g
quarreling	l
quarrelingl	y
quarrell	ei
quarrelle	dr
quarreller	s
quarrelli	n
quarrellin	g
quarrels	o
quarrelso	m
quarrelsom	e
quarrelsome	ln
quarrelsomel	y
quarrelsomen	e
quarrelsomene	s
quarrelsomenes	s
quarrelsomeness	e
quarrelsomenesse	s
quarri	ae
quarria	b
quarriab	l
quarriabl	e
quarrie	ds
quarry	ai
quarrya	b
quarryab	l
quarryabl	e
quarryi	n
quarryin	g
quart	aeiosz
quarta	nt
quartat	i
quartati	o
quartatio	n
quarte	rt
quarter	befilms
quarterb	a
quarterba	c
quarterbac	k
quartere	dr
quarterer	s
quarterf	i
quarterfi	n
quarterfin	a
quarterfina	l
quarterfinal	i
quarterfinali	s
quarterfinalis	t
quarteri	n
quarterin	g
quarterl	iy
quarterli	e
quarterlie	s
quarterm	a
quarterma	s
quartermas	t
quartermast	e
quartermaste	r
quarters	a
quartersa	w
quartet	st
quartett	e
quartette	s
quarti	cl
quartil	e
quartz	eioy
quartze	s
quartzi	t
quartzit	e
quartzo	u
quartzou	s
quas	ahis
quasa	r
quasar	s
quash	ei
quashe	ds
quashi	n
quashin	g
quasi	eflmprsw
quasie	q
quasieq	u
quasiequ	i
quasiequi	v
quasiequiv	a
quasiequiva	l
quasiequival	e
quasiequivale	n
quasiequivalen	t
quasif	e
quasife	du
quasifed	e
quasifede	r
quasifeder	a
quasifedera	l
quasifeu	d
quasifeud	a
quasifeuda	l
quasil	e
quasile	g
quasileg	ai
quasilega	l
quasilegi	s
quasilegis	l
quasilegisl	a
quasilegisla	t
quasilegislat	i
quasilegislati	v
quasilegislativ	e
quasim	aeo
quasima	d
quasimad	l
quasimadl	y
quasime	d
quasimed	i
quasimedi	c
quasimedic	a
quasimedica	l
quasimo	dr
quasimod	o
quasimor	a
quasimora	l
quasimoral	l
quasimorall	y
quasip	r
quasipr	i
quasipri	v
quasipriv	a
quasipriva	t
quasiprivat	e
quasir	e
quasire	l
quasirel	i
quasireli	g
quasirelig	i
quasireligi	o
quasireligio	u
quasireligiou	s
quasis	op
quasiso	v
quasisov	e
quasisove	r
quasisover	e
quasisovere	i
quasisoverei	g
quasisovereig	n
quasisp	i
quasispi	r
quasispir	i
quasispiri	t
quasispirit	e
quasispirite	d
quasispirited	l
quasispiritedl	y
quasiw	i
quasiwi	c
quasiwic	k
quasiwick	e
quasiwicke	d
quasiwicked	l
quasiwickedl	y
quass	i
quassi	a
quat	er
quate	r
quater	n
quatern	ai
quaterna	r
quaternar	y
quaterni	ot
quaternio	n
quaternit	y
quatr	ae
quatra	i
quatrai	n
quatre	f
quatref	o
quatrefo	i
quatrefoi	l
quav	e
quave	r
quaver	eiosy
quavere	dr
quaverer	s
quaveri	n
quaverin	g
quavering	l
quaveringl	y
quavero	u
quaverou	s
quay	afls
quaya	g
quayag	e
quayf	u
quayfu	l
quayl	i
quayli	k
quaylik	e
quays	i
quaysi	d
quaysid	e
quayside	s
qub	ikpr
qubi	t
qubit	s
qubp	v
quc	disv
qud	k
que	abeglmnrsuvz
quea	ns
queas	iy
queasi	ln
queasil	y
queasin	e
queasine	s
queasines	s
queb	er
quebe	c
quebr	a
quebra	c
quebrac	h
quebrach	o
quee	nr
queen	eils
queene	d
queeni	nt
queenin	g
queenit	e
queenl	iy
queenli	n
queenlin	e
queenline	s
queenlines	s
queens	l
queensl	a
queensla	n
queenslan	d
queer	deilns
queerd	o
queerdo	m
queere	drs
queeres	t
queeri	enst
queerin	g
queeris	h
queerish	n
queerishn	e
queerishne	s
queerishnes	s
queerit	y
queerl	y
queern	e
queerne	s
queernes	s
queerness	e
queernesse	s
quel	l
quell	aeis
quella	b
quellab	l
quellabl	e
quelle	dr
queller	s
quelli	n
quellin	g
quen	c
quenc	h
quench	aeil
quencha	b
quenchab	l
quenchabl	e
quenchable	n
quenchablen	e
quenchablene	s
quenchablenes	s
quenchableness	e
quenchablenesse	s
quenche	drs
quencher	s
quenchi	n
quenchin	g
quenchl	e
quenchle	s
quenchles	s
quer	cinuy
querc	e
querce	t
quercet	i
querceti	n
queri	ems
querie	drs
querier	s
querim	o
querimo	n
querimon	i
querimoni	o
querimonio	u
querimoniou	s
queris	t
queru	l
querul	o
querulo	u
querulou	s
query	i
queryi	n
queryin	g
querying	l
queryingl	y
ques	t
quest	aeis
questa	n
questan	t
queste	dr
quester	s
questi	no
questin	g
questing	l
questingl	y
questio	n
question	aeilns
questiona	b
questionab	l
questionabl	ey
questione	der
questioner	s
questioni	n
questionin	g
questioning	ls
questioningl	y
questionl	e
questionle	s
questionles	s
questionn	a
questionna	i
questionnai	r
questionnair	e
questionnaire	s
queu	ei
queue	dirs
queuei	n
queuein	g
queuer	s
queui	n
queuin	g
quez	o
quezo	n
quf	cdfo
qug	v
qui	abcdelnprstvxz
quib	bi
quibb	l
quibbl	ei
quibble	drs
quibbler	s
quibbli	n
quibblin	g
quibbling	l
quibblingl	y
quibi	n
quibin	a
quibina	r
quibinar	y
quic	hk
quich	eu
quiche	s
quichu	a
quick	eilnst
quicke	nrs
quicken	eis
quickene	dr
quickener	s
quickeni	n
quickenin	g
quickes	t
quicki	es
quickie	s
quickis	h
quickl	iy
quickli	km
quicklik	e
quicklim	e
quickn	e
quickne	s
quicknes	s
quickness	e
quicknesse	s
quicks	aeit
quicksa	n
quicksan	d
quicksand	sy
quickse	t
quicksi	l
quicksil	v
quicksilv	e
quicksilve	r
quickst	e
quickste	p
quickt	i
quickti	m
quicktim	e
quicktime	p
quicktimep	l
quicktimepl	a
quicktimepla	y
quicktimeplay	e
quicktimeplaye	r
quid	dlns
quidd	i
quiddi	t
quiddit	y
quidl	e
quidle	t
quidn	u
quidnu	n
quidnun	c
quie	st
quies	c
quiesc	e
quiesce	n
quiescen	ct
quiescenc	e
quiet	eilnsu
quiete	dnrs
quieten	eis
quietene	dr
quietener	s
quieteni	n
quietenin	g
quieter	s
quietes	t
quieti	ns
quietin	g
quietis	hmt
quietl	iy
quietli	k
quietlik	e
quietn	e
quietne	s
quietnes	s
quietness	e
quietnesse	s
quiets	o
quietso	m
quietsom	e
quietu	ds
quietud	e
quil	lt
quill	eisy
quille	d
quilli	n
quillin	g
quilt	eis
quilte	dr
quilter	s
quilti	n
quiltin	g
quin	acinoqst
quinc	euy
quincu	n
quincun	x
quini	dn
quinid	i
quinidi	n
quinidin	e
quinin	e
quinine	s
quino	l
quinol	i
quinoli	n
quinolin	e
quinq	u
quinqu	i
quinqui	n
quinquin	a
quins	y
quint	aeiu
quinta	inr
quintai	n
quinte	st
quintes	s
quintess	e
quintesse	n
quintessen	ct
quintessenc	e
quintessent	i
quintessenti	a
quintessentia	l
quintet	st
quintett	e
quintette	s
quinti	l
quintil	l
quintill	i
quintilli	o
quintillio	n
quintu	p
quintup	l
quintupl	ei
quintuple	t
quintuplet	s
quintupli	c
quintuplic	a
quintuplica	t
quintuplicat	e
quip	ps
quipp	eiy
quippe	dr
quipper	sy
quippi	ns
quippin	g
quippis	h
quippish	n
quippishn	e
quippishne	s
quippishnes	s
quippishness	e
quippishnesse	s
quir	ikt
quiri	n
quirin	a
quirina	l
quirk	eisy
quirke	drs
quirkes	t
quirki	eln
quirkie	rs
quirkies	t
quirkil	y
quirkin	eg
quirkine	s
quirkines	s
quirkiness	e
quirkinesse	s
quis	l
quisl	i
quisli	n
quislin	g
quit	ceiorst
quitc	hl
quitcl	a
quitcla	i
quitclai	m
quite	d
quiti	n
quitin	g
quitr	e
quitre	n
quitren	t
quits	e
quitse	rs
quitses	t
quitt	aei
quitta	bn
quittab	l
quittabl	e
quittan	c
quittanc	e
quitte	dr
quitter	s
quitti	n
quittin	g
quiv	e
quive	r
quiver	efisy
quivere	dr
quiverer	s
quiverf	u
quiverfu	l
quiveri	n
quiverin	g
quivering	l
quiveringl	y
quix	o
quixo	t
quixot	ei
quixoti	cs
quixotis	m
quiz	z
quizz	aei
quizza	b
quizzab	l
quizzabl	e
quizze	drs
quizzer	s
quizzi	cn
quizzic	a
quizzica	l
quizzical	iln
quizzicali	t
quizzicalit	iy
quizzicaliti	e
quizzicalitie	s
quizzicall	y
quizzicaln	e
quizzicalne	s
quizzicalnes	s
quizzicalness	e
quizzicalnesse	s
quizzin	g
quizzing	l
quizzingl	y
quj	o
qul	fhortx
qum	g
qun	abflov
quo	dinrt
quod	l
quodl	i
quodli	b
quodlib	e
quodlibe	t
quoi	nt
quon	ds
quond	a
quonda	m
quons	e
quonse	t
quor	au
quoru	m
quorum	s
quot	aehi
quota	bst
quotab	l
quotabl	e
quotat	i
quotati	o
quotatio	n
quotation	ais
quotationa	l
quotationi	s
quotationis	t
quote	dsw
quotew	o
quotewo	r
quotewor	t
quotewort	h
quoteworth	y
quoth	a
quoti	den
quotid	i
quotidi	a
quotidia	n
quotie	n
quotien	t
quotient	s
quotin	g
qup	gov
quq	tu
qur	adpruv
qurp	v
quru	s
qurus	h
qut	bervx
quu	ruv
quw	u
qux	evw
quxw	v
quy	rv
quz	fv
quzf	v
qv	adejnosz
qvo	mv
qvs	btv
qw	adeinsv
qwe	nr
qwer	t
qwi	k
qwn	v
qx	epux
qxu	p
qxx	n
qy	acdefoprvxy
qya	v
qyc	a
qye	en
qyf	p
qyo	fk
qyp	df
qypd	v
qyy	ar
qz	aeflopqrstux
qza	s
qze	s
qzo	f
qzp	s
qzq	f
qzt	p
