r	abcdefghijklmnopqrstuvwxyz
ra	abcdeijklmnopqrtuvwxyz
raa	rv
rab	mt
rac	c
rad	bkoru
rae	rv
raj	aqw
rak	p
ran	f
rao	bimpr
raor	v
rap	rv
raq	abdegjnopqrvx
raqb	v
raqo	v
raqr	v
rat	frvw
rau	r
rax	ruvx
ray	horv
rb	abcdefghijklmnopqrstuvwxy
rba	tuv
rbat	v
rbb	bfhmpqrtuwy
rbbu	v
rbbw	v
rbc	bsv
rbd	ftv
rbe	dfhru
rbef	v
rbf	lv
rbg	gn
rbh	firv
rbi	brsvy
rbj	s
rbk	fgirv
rbl	ps
rbn	lpv
rbo	hlr
rboh	rv
rbp	dst
rbr	fu
rbt	v
rbu	eh
rbue	v
rbuh	v
rbw	fps
rbwf	v
rbx	rv
rby	p
rc	abcdefghijklmnopqrstuvwxyz
rca	dfhlorsuvwxy
rcad	v
rcb	erv
rcc	blrsvw
rcd	abefhjklmnoqrsvwz
rcda	v
rcdf	v
rcdk	v
rcdr	v
rcds	v
rce	bdefgmqrsvw
rceb	v
rceg	v
rceq	v
rcew	v
rcf	fy
rcff	rv
rcg	orsuv
rcgo	v
rch	bfv
rci	v
rcj	lrsvy
rck	hrvx
rcl	bfovz
rcm	bgrstv
rcn	abfgilmrv
rcni	rv
rcnl	v
rco	dfklqtuv
rcoq	v
rcp	fghostuvx
rcq	bhinquv
rcr	abcfhmnoqsuv
rcra	v
rcrb	v
rcrq	v
rcrs	rv
rcs	orstuvy
rcsu	v
rct	bvx
rcu	achos
rcua	v
rcv	bhvz
rcvb	v
rcw	bdsv
rcwd	v
rcx	v
rcy	bmosvwy
rcyo	v
rcyw	v
rcz	o
rd	abcdefgijklmnopqrtuvwxy
rda	fhv
rdb	v
rdc	ad
rdd	bcdfhimnqrsvy
rddd	frsv
rddf	v
rddh	v
rde	uv
rdf	ruvy
rdi	l
rdj	r
rdk	v
rdl	v
rdm	b
rdn	cflv
rdo	rv
rdp	rsv
rdq	l
rdr	ekrsuv
rdu	kpv
rdv	f
rdx	rv
rdy	av
re	abcdefghijklmnopqrstuvwxz
rea	pv
reb	q
rec	fy
red	efhrv
ree	mrsv
reev	v
ref	fl
reg	uv
rei	a
rej	v
rek	rv
rel	v
ren	bcfnprsv
renn	v
reo	fqtv
reof	v
req	bdefhkoqrswy
reqd	v
reqk	v
reqr	v
reqy	v
rer	u
res	di
ret	l
reu	bev
rev	f
rew	df
rewf	v
rex	v
rez	fv
rf	abcdefhiklmnoprstuvxy
rfa	aberv
rfb	b
rfd	dgvw
rfe	adpruv
rff	defkrsv
rfh	brtv
rfi	dr
rfk	a
rfl	fgkrv
rfm	br
rfn	bcdfhmnqrtuvw
rfnb	v
rfnc	v
rfnq	v
rfo	bcfglo
rfof	v
rfp	rv
rfr	brt
rfs	uv
rft	b
rfu	frv
rfv	adez
rfvz	v
rfy	d
rg	abcefgijlnopqruwxy
rgc	a
rge	a
rgf	a
rgg	gr
rgi	uv
rgj	ovy
rgl	v
rgn	fhorsv
rgnf	v
rgo	hrsv
rgq	df
rgqf	rv
rgr	v
rgu	a
rgw	o
rgy	rv
rh	abdefghjklmnoprstuvxyz
rha	rsv
rhb	p
rhd	bdlrstvw
rhf	m
rhg	uv
rhh	ht
rhk	a
rhl	k
rhm	b
rhmb	v
rhn	lpx
rho	v
rhp	g
rhr	btv
rhs	u
rhu	fv
rhx	v
rhy	p
ri	adefghijmnoqrstvwxyz
rid	bfl
rie	pu
rig	u
rih	rv
rim	b
rin	rv
rio	t
riq	bkox
rir	agu
ris	t
riv	u
rix	v
riy	d
riz	gv
rj	abcdefgijlmnopqrsuvz
rja	qrsvx
rjc	bipw
rjd	o
rje	dgz
rjed	v
rjf	ghy
rjfh	v
rjg	no
rjgn	v
rji	q
rjj	fqvz
rjm	bv
rjn	dglprsvz
rjns	v
rjo	fuv
rjp	u
rjq	abhnsu
rjqs	v
rjr	bs
rjv	v
rjz	tv
rjzt	v
rk	abeijklnortvwxyz
rka	kv
rkb	lsu
rkbu	v
rke	v
rkj	hv
rkk	rv
rkl	bfrsuv
rkn	v
rko	o
rkr	luv
rkt	u
rkw	rv
rkx	rv
rky	y
rkz	v
rl	abdefghijklnopqrtuvwx
rla	d
rlb	dfikmuvy
rlbf	v
rld	hjkl
rle	bno
rlf	t
rlh	fiotz
rlht	rv
rlk	f
rll	v
rln	fhinortvw
rlnf	v
rlno	rsv
rlnt	rv
rlo	bfhikotv
rlok	v
rloo	v
rlot	rv
rlp	sv
rlq	uv
rlqu	v
rlr	dfkn
rlt	hkorst
rlu	klr
rlv	v
rlw	qv
rlx	ev
rm	abcdeghijklmnopqrtuvwxy
rma	bt
rmb	gr
rmc	s
rmd	rsv
rmg	pv
rmi	ehipstvz
rmii	rv
rmip	rsv
rmit	rsv
rmiz	rv
rmj	ds
rml	v
rmn	fv
rmo	v
rmp	dv
rmr	afrsvw
rmt	bv
rn	abcdefghijklmnopqrstuvwxyz
rna	qrv
rnb	bdfioqrtv
rnbb	v
rnc	adprv
rnd	alrsv
rnds	v
rne	abeoqrvz
rnee	v
rnf	cfhlprsvw
rng	fv
rnh	ceht
rnht	v
rni	rv
rnj	hrsv
rnk	a
rnl	iov
rnli	v
rnm	brv
rnn	afp
rno	cfhiloprtv
rnoh	v
rnop	v
rnp	d
rnq	hv
rnqh	rv
rnr	adfimpqrsuv
rnrq	v
rns	bcrv
rnt	frstv
rnv	v
rnw	u
rny	rv
rnz	ov
ro	abcdfhijklmnopqrvwxyz
roa	ery
rob	fnprv
robf	v
roc	c
rod	hr
rof	bfguw
roff	v
roh	rv
rok	bdrv
rol	fg
rom	b
ron	br
roo	bcdfijkortv
roob	rv
rook	rv
rop	ov
roq	b
ror	bcdfklnpqrstvw
rorb	rv
rorc	v
rord	v
rorl	v
rorp	v
rov	v
rox	v
roy	ks
roz	o
rp	abcdefghijklmnopqrtuvyz
rpa	dfqrsv
rpb	glmntz
rpbn	v
rpbz	v
rpc	au
rpca	v
rpcu	v
rpd	acdfhkloprtuvw
rpdf	v
rpdk	v
rpdt	v
rpe	uv
rpf	dfvw
rpg	gv
rph	u
rpi	mptuv
rpj	rv
rpl	orv
rpm	hp
rpn	d
rpo	bhktv
rpob	v
rpoh	v
rpq	gu
rpqg	v
rpqu	v
rpr	rsuv
rpru	v
rpt	ov
rpu	p
rpv	fi
rpz	w
rq	abdefhijkmnopqrstuy
rqa	drv
rqb	beorsv
rqe	rv
rqh	v
rqi	p
rqj	qv
rqk	rv
rqm	m
rqn	cdfruvwz
rqo	crvw
rqq	qsty
rqr	jqv
rqt	rv
rqu	cv
rqy	d
rr	abcdefijklnopqrstuvwxyz
rra	v
rrb	b
rrc	mrv
rrd	r
rre	knrsvy
rrf	dv
rri	bfrsv
rrj	frv
rrl	dv
rrn	rv
rro	dfk
rrq	k
rrr	brtv
rrs	ehs
rrse	v
rrss	v
rrt	b
rru	bfkoqrv
rrub	v
rrv	fv
rrx	v
rs	abcdefghijklmnopqrstuvwxyz
rsa	adfmorstvx
rsb	defhjprvw
rsbh	v
rsbj	v
rsbr	v
rsbw	v
rsc	jqwy
rscw	v
rsd	bceflmotuz
rsdf	v
rse	defpqrsuvw
rsep	v
rseq	v
rseu	rv
rsew	v
rsf	adekuv
rsfd	v
rsfk	v
rsg	nt
rsgn	v
rsh	dp
rsi	airstv
rsii	v
rsj	bejmotv
rsjb	v
rsk	bvy
rsl	knoruvw
rslo	rv
rsm	bfrv
rsn	abcdelnoprsuvx
rsna	v
rsnc	v
rsnp	v
rso	bdfjlnortv
rsob	v
rsof	v
rsp	abdgw
rsq	bhoptuv
rsqb	v
rsr	bdkrsuvw
rss	bcdeghjkmnorstvwx
rssb	v
rssc	v
rssd	v
rsse	v
rssj	v
rssr	v
rst	v
rsu	r
rsv	fks
rsw	bs
rsx	eov
rsy	adopsuv
rsyo	rv
rsz	b
rt	abdefiklmnopqrtvwxyz
rta	flrsvw
rtb	u
rtd	p
rte	v
rtf	o
rti	v
rtk	v
rtm	bop
rtmb	rsv
rtmp	v
rtn	frsvw
rtnr	rv
rto	elov
rtq	boxy
rtqy	v
rtr	rv
rtv	f
rty	y
rtz	p
rtzp	v
ru	abcdefghijklmnopqrstuvwxyz
rua	prtv
rub	dfpvw
ruc	lv
rud	flmv
ruf	hqrv
rufh	v
rug	v
rui	v
rul	orv
rum	bk
rumb	v
run	o
ruo	otv
ruoo	v
rup	bu
rupb	v
ruq	bqrv
rur	pv
rut	brv
ruu	clmrsv
ruv	f
ruw	s
rux	frsvw
ruy	rsv
rv	adefgjnosuxz
rva	acfhirv
rvaa	v
rvar	v
rvd	v
rve	acfhirv
rvea	v
rver	v
rvf	fv
rvj	f
rvn	o
rvo	cjmosvx
rvs	biw
rvu	r
rvz	f
rvzf	v
rw	abcdefghijklmnopqrstuvwxy
rwa	abkqrtv
rwb	ehk
rwc	js
rwd	bfmov
rwdf	rv
rwe	fruv
rwef	v
rweu	v
rwf	fltu
rwg	o
rwh	luv
rwi	av
rwk	t
rwl	kot
rwm	q
rwn	lruv
rwo	fost
rwof	rv
rwp	dfglortv
rwq	u
rwr	befuv
rws	t
rwt	os
rwu	jov
rww	dfhrvwz
rwwf	rsv
rwwz	v
rwx	v
rwy	p
rx	acdefgijklmnoprtuvwx
rxa	du
rxc	s
rxd	q
rxf	f
rxg	u
rxi	yz
rxm	b
rxn	f
rxo	bchqrvw
rxt	u
rxu	opv
rxv	v
rxx	nrv
ry	abdefhiklmnoprsuvwxyz
ryb	afptuwz
ryba	v
rybz	v
ryd	u
rydu	v
rye	nv
ryf	bp
ryk	t
ryl	k
ryn	bnr
ryo	puvw
ryp	dfu
rypd	v
ryr	afptz
rys	rv
ryu	f
ryv	v
ryw	f
ryy	ar
ryya	v
ryz	fstv
rz	acefgjlmopqrsvwxz
rza	s
rzc	m
rze	nrsvwz
rzj	v
rzl	v
rzo	fx
rzof	v
rzp	ps
rzpp	v
rzq	fh
rzr	u
rzs	btv
rzz	tz
