t	abcdefghijklmnopqrstuvwxyz
ta	abcdefgijklmnopqstuvxy
tac	bv
tad	bjkouv
tadk	rv
tae	u
tai	v
taj	aw
tak	v
tal	v
tam	j
tao	bp
taq	degoqrs
tas	e
tat	v
tau	r
taur	v
tax	birvx
tay	ho
tb	abcdeghijklnopqstuvwxyz
tbb	ey
tbc	s
tbd	t
tbe	adefrvw
tbed	v
tbef	v
tbg	n
tbh	iorv
tbi	rsv
tbj	s
tbk	fioruvw
tbki	rv
tbku	v
tbkw	v
tbl	uv
tbn	dlpv
tbo	rsv
tbor	v
tbp	dtv
tbq	dp
tbt	w
tbu	h
tbw	puv
tbx	u
tc	bcdefghjlmnoprstuvwyz
tcc	hrv
tcd	jw
tce	bcqw
tcj	o
tcm	bv
tcn	sv
tco	l
tcp	v
tcr	krs
tcs	tuv
tcu	ah
tcw	cs
tcy	o
tcz	z
td	abcdefgijklnoprstuvxyz
tda	hv
tdb	s
tdc	l
tdd	bdeq
tde	efmprsuv
tdf	ouv
tdl	rv
tdn	blpq
tdo	rsv
tdp	v
tdr	gku
tds	r
tdt	do
tdu	aekp
tduk	v
tdv	m
tdx	frsvx
tdy	afrsvy
tdz	p
te	abdefghijklmnopqrstuvwxz
tea	fvy
teb	d
ted	eo
tee	defmrsv
teee	rv
tef	deq
teg	uv
teh	v
tei	ah
tel	v
ten	bcfruv
teo	qrtv
teq	aev
ter	fquv
tes	i
tet	r
teu	d
tev	o
tew	drsuv
tez	v
tf	abcdefjklmnopqrsuvwxy
tfa	drv
tfb	buv
tfc	blv
tfd	dg
tfe	dkltu
tff	defhkorstvw
tffo	v
tfk	av
tfl	hrv
tfm	b
tfn	cdghnq
tfnd	v
tfo	clo
tfp	rv
tfr	su
tfrs	v
tfs	uv
tfv	aov
tfw	w
tfx	rv
tfy	grv
tg	abeijlnoqrtvy
tge	sv
tgi	rv
tgj	rvy
tgn	orv
tgo	rv
tgq	f
tgy	uv
th	adefhijmnoprsuwx
tha	v
thd	d
thh	h
thm	b
thp	fv
ti	abehimnqrvxy
tie	v
tim	b
tiq	ikx
tir	p
tiy	d
tj	abcdefghjlmnopqruvx
tja	q
tjb	bgv
tjc	bikrs
tjd	gqr
tje	dgv
tjg	n
tjm	bel
tjmb	v
tjn	gsvyz
tjo	glu
tjq	abhsu
tjqs	v
tjr	b
tjx	b
tk	abcdehijklmnoprtwxz
tka	rv
tkb	lsy
tkd	v
tke	b
tkk	bd
tkl	brv
tko	eoz
tkp	d
tkr	l
tkx	v
tl	abcdefghjklnopqrstuvwxyz
tla	dv
tlb	adi
tlc	k
tld	ahjkrv
tlda	v
tle	bnoqw
tlf	k
tlh	bopqtz
tlhz	v
tlj	u
tlk	w
tll	bv
tln	fnoqrstv
tlno	v
tlo	behkmopqstvwz
tlp	amsu
tlq	l
tlr	bfu
tls	v
tlt	r
tlu	l
tlw	qw
tlx	uv
tly	ap
tlya	v
tlz	bpr
tm	abcdefghijklmnopqrtuvxyz
tma	q
tmb	grv
tmc	s
tmcs	v
tmd	rv
tme	bprv
tmg	pv
tmgp	v
tmi	itz
tmii	v
tmit	v
tmj	sv
tmm	muv
tmn	bgopqv
tmo	ov
tmp	orsv
tmt	hvy
tmz	p
tn	abcdefghijklmnopqrstuvwxyz
tna	ev
tnb	befiorstv
tnbe	v
tnbf	rv
tnbi	v
tnc	blpqrv
tnd	losv
tne	eoqrsvz
tnf	hlrv
tnh	cehqty
tnj	rsv
tnk	b
tnl	iprv
tnm	v
tnn	efv
tnne	v
tno	alv
tnp	bdo
tnq	dhw
tnqd	v
tnqh	v
tnr	adefghimrstv
tnrf	rv
tnrr	v
tns	b
tnu	rv
tnv	v
tnw	v
tny	ov
to	abcdefhijkmnopqrtuvx
toa	erv
tob	fg
tobf	v
toc	a
tod	rv
tof	u
toh	bcdlnqrsv
toj	ao
tok	arv
tom	b
tomb	v
ton	bov
too	ejloprtv
tooo	v
top	o
toq	v
tor	qv
tot	ioq
tox	brv
tp	abcdefgijklmnoqrstuvxz
tpa	dqrvz
tpb	vw
tpc	u
tpd	cfjknoprtvw
tpdj	v
tpdk	rv
tpdt	v
tpf	jrvw
tpi	ptu
tpj	rv
tpm	fj
tpo	bht
tpq	dgu
tpqu	v
tpr	u
tpru	v
tpt	bvx
tpu	v
tpx	v
tpz	w
tq	abdefhijklmnoqrstuvxy
tqa	brv
tqb	br
tqe	r
tqk	v
tqm	m
tqn	brv
tqo	vw
tqq	qs
tqu	rv
tqx	bsv
tr	abcdefijklmnopqrstuvwxz
tra	orv
trb	bcv
trc	rvw
trd	du
tre	bhv
trf	abdorv
tri	rv
trj	fhoqrsv
trk	v
trl	rv
trm	rs
trmr	v
trn	bdhoqrv
tro	bdkrtv
trok	v
trp	afhvx
trq	b
trr	jqrv
trs	bistvw
trt	v
tru	fpvy
trv	fgru
trvf	v
trw	a
trx	orsv
trz	v
ts	abcegilnopqrstuv
tsc	q
tse	hqrv
tsi	v
tsn	fqtxy
tsny	v
tso	v
tsp	nv
tsq	t
tsr	b
tst	v
tsu	v
tsuv	v
tt	abcdefgijlmnopqrstuvwxyz
tta	vyz
ttb	d
ttc	v
ttd	ep
tte	u
ttf	bkv
ttfk	v
ttl	b
ttm	bpv
ttmp	v
ttn	bqrvw
ttnr	v
tto	el
ttq	x
ttr	acpsu
tts	f
ttt	z
tty	z
tu	abdefijmnopqrstuwxy
tua	fv
tub	dp
tud	jm
tudm	v
tue	rv
tuf	dh
tuj	v
tum	v
tun	qv
tuo	ovw
tup	u
tur	kpu
tut	er
tuu	mstuv
tuw	su
tv	acdefjlmnorsuvxyz
tva	rv
tvd	op
tve	rv
tvf	fv
tvj	v
tvn	ekl
tvo	jmvx
tvs	bir
tvv	u
tvx	v
tw	abdhjlnopsuvw
twd	t
twj	v
twl	m
twn	rsv
two	eos
twp	ft
twu	mu
twv	v
tww	b
tx	abdegijkmnopqtux
txa	u
txau	v
txb	d
txe	v
txi	uz
txo	ov
txt	u
txtu	v
txu	p
txx	acdfhmnot
txxa	rv
txxm	v
ty	abdefhmopqrsuwxyz
tyb	apwz
tyd	ao
tye	ov
tyf	bfq
tyo	akop
typ	dfk
typd	v
tyr	apz
tyu	f
tyx	v
tyy	ary
tyz	iu
tz	abdefghjklmnopqrwyz
tza	kps
tzb	ar
tzd	jpt
tzdp	v
tze	s
tzf	s
tzj	v
tzk	b
tzm	bp
tzn	d
tzo	fx
tzp	s
tzq	fh
tzy	d
