u	abcdefghijklmnopqrstuvwxyz
ua	acdehijklmnopqstuvxyz
uaa	rsv
uac	v
uad	fkv
uaj	aqw
uak	p
uakp	v
ual	rv
uan	f
uao	b
uap	v
uaq	dv
uas	e
uat	brv
uau	r
uax	bhvx
uay	h
uaz	r
ub	abcdefghijklmnoprtv
uba	v
ubb	puy
ubd	rv
ube	df
ubef	v
ubf	u
ubg	gn
ubh	o
ubi	rv
ubj	v
ubk	orv
ubn	bcdfgilmnpstwy
ubnf	rv
ubo	r
ubor	v
ubp	fpsw
ubr	u
uc	acefgijlnoprsuvw
uca	rsv
uce	bq
ucj	o
ucl	c
ucn	v
uco	l
ucr	as
ucu	a
ud	abcdefikmnoqrsvxy
uda	v
udb	s
udc	lrv
udd	dmq
ude	mrsv
udf	v
udi	l
udil	v
udk	w
udm	bmrv
udq	l
udql	v
udr	k
uds	frsv
udv	m
udx	rv
udy	rv
ue	aegklmnopqrstuvwz
uee	djmrv
uek	v
uel	v
uen	b
ueo	qtv
ueq	qw
uer	uv
ues	i
uet	r
ueu	v
uew	d
uf	abcdefghijklmnopqrstuvwxyz
ufa	dghkmnopqrstuvwxy
ufah	v
ufao	v
ufat	v
ufb	adefhkoprsuvwx
ufbd	v
ufbe	rv
ufbh	v
ufbr	v
ufc	ajsw
ufcs	rv
ufd	abdefhkmopqrsuvz
ufdd	v
ufde	v
ufdf	v
ufdm	v
ufds	v
ufe	abcdefghklnopqrsuvw
ufee	v
ufen	v
ufep	rv
ufeu	rv
ufew	v
uff	bdfghklmoqrsvw
uffb	v
uffd	frsvw
uffk	v
uffo	v
ufg	aforsv
ufgr	v
ufh	bfgprsuvz
ufi	dqv
ufj	aborsuv
ufjb	v
ufjs	rv
ufju	v
ufk	bfhorsv
ufl	abefgijmoqrstuvwxz
ufle	rv
uflu	v
uflw	v
ufm	cfjoqrstvx
ufn	abcdefglmopqrsvw
ufnc	v
ufnf	v
ufno	rsv
ufnp	v
ufnr	rsv
ufo	bfjkoqrstuvx
ufoo	rv
ufp	abdfknorstuvwx
ufpd	rv
ufpo	v
ufpt	rv
ufpw	v
ufpx	v
ufq	abhikmruv
ufr	abdefilnorsuvwy
ufrb	rv
ufrd	rv
ufru	v
ufrv	v
ufs	bdoqrstuv
ufss	v
uft	elnoqrsvx
ufu	cefmopqru
ufue	v
ufv	fprv
ufw	bfhost
ufx	fnprsuvw
ufxu	v
ufy	dfkoprsuvyz
ufyd	v
ufyy	v
ufz	bcefkoprsw
ufzc	v
ufzf	v
ufzo	v
ug	abeijlnoqrtuxy
ugi	u
ugj	y
ugn	v
ugq	f
ugr	v
uh	agjkrsuvx
uha	v
uhx	v
ui	adefgijnopqrtvw
uid	bflv
uie	v
uif	d
uig	u
uin	frv
uip	w
uiq	ilr
uiql	v
uit	bsv
uitb	v
uj	acdegjnpqruvz
ujc	s
ujd	v
uje	gz
ujj	v
ujn	gz
ujq	abs
ujr	b
uk	aeilmwxz
ukw	v
ul	abdefghjknopqrtuwxyz
ula	dy
ulb	fj
ulbf	v
uld	hv
ule	o
ulh	bwz
ulk	v
uln	fno
ulo	bemvwz
ulp	au
ulq	rv
ulr	v
ulu	l
ulul	v
ulw	jv
ulx	ruv
uly	v
ulz	b
um	bcdgiklmnpqrtvw
umc	s
umi	ipt
umm	mv
umn	o
ump	dfmrsv
umr	rv
un	abcefgjklmnoprsvxyz
una	v
unb	bip
unbi	v
unc	blpqrv
une	oz
unf	klv
unfl	v
unk	b
unl	ikpv
unm	o
unn	v
uno	klrv
unol	v
unp	v
unr	aipqrs
uns	b
unv	f
unx	u
uny	o
uo	abdefghklmoqrtvwxz
uoa	e
uob	fv
uobf	v
uoe	d
uof	u
uofu	v
uog	n
uoh	v
uok	av
uol	v
uom	b
uoo	abgklotw
uoow	v
uor	q
uow	v
uox	v
uoz	o
up	abdefgjloqsuvz
upb	w
upd	vw
upf	w
upg	g
upj	v
upo	b
upq	g
upu	fv
upz	w
uq	abdefghiklmnopqrtuyz
uqa	rv
uqb	ef
uqd	ghkoy
uqe	deru
uqee	v
uqf	ox
uqg	rw
uqgr	v
uql	v
uqm	gu
uqn	aboruv
uqnb	v
uqo	cjrsuvw
uqp	bdgortw
uqpr	v
uqq	q
uqqq	v
uqr	bcdqv
uqt	d
uqu	cq
ur	abcdfijklnoprstuvxz
ura	rv
urb	bu
urbb	rv
urc	uv
urcu	v
urd	bdflrsv
urf	ef
uri	rv
urj	j
urk	bv
url	rv
urn	fq
urnq	v
uro	bdfk
urp	fpw
urs	s
urss	v
urt	bv
urtb	v
uru	bp
urv	u
us	adefijlnopruwx
usa	v
use	rsv
usf	s
usl	v
usn	fy
uso	s
usp	ox
usr	bq
usw	u
usx	u
ut	abehkmnotvw
uta	vy
utb	w
ute	pw
utew	v
utk	m
utm	bfv
utn	bdrt
utnb	v
utnr	v
utt	km
utv	b
uu	abefilnopqrtuvwxy
uua	v
uub	p
uubp	v
uue	sv
uuf	cfh
uuff	rv
uul	k
uun	dfv
uunf	v
uup	s
uuq	q
uur	cp
uurp	v
uut	r
uuu	befhimprstuvwy
uuuf	v
uuui	v
uuum	frsvw
uuur	rv
uuus	v
uuut	v
uuuu	rsv
uuuw	v
uuuy	v
uuv	v
uux	v
uv	adefhjmnosuvxz
uvd	impw
uve	rsv
uvf	fv
uvn	f
uvo	m
uvom	v
uvs	v
uvv	v
uvx	v
uw	abefghjklnpqrtuvxz
uwa	bkpt
uwb	u
uwe	k
uwf	o
uwh	v
uwj	n
uwk	lrv
uwl	fnz
uwn	oruv
uwq	u
uwr	b
uwu	cfsw
uwz	o
ux	aefiklmtuvx
uxi	w
uxl	v
uxu	p
uxx	n
uy	denortuwy
uyd	mu
uye	frsv
uyn	f
uyo	mu
uyr	v
uyt	bsv
uytb	v
uyu	p
uyup	v
uyy	r
uz	aelnoqvxz
uze	q
uzl	v
uzq	f
uzz	v
