v	abcdefghijklmnopqrstuvwxyz
va	acdegijlmnopqrstuwxy
vaa	v
vac	aciu
vaca	int
vacai	o
vacaio	n
vacaion	s
vacan	ct
vacanc	iy
vacanci	e
vacancie	s
vacant	ln
vacantl	y
vacantn	e
vacantne	s
vacantnes	s
vacantness	e
vacantnesse	s
vacat	aei
vacata	b
vacatab	l
vacatabl	e
vacate	ds
vacati	no
vacatin	g
vacatio	n
vacation	eils
vacatione	dr
vacationer	s
vacationi	n
vacationin	g
vacationl	e
vacationle	s
vacationles	s
vacc	i
vacci	n
vaccin	aei
vaccina	lt
vaccinat	eio
vaccinate	ds
vaccinati	no
vaccinatin	g
vaccinatio	n
vaccinato	r
vaccinator	s
vaccine	s
vaccini	a
vaci	l
vacil	l
vacill	a
vacilla	t
vacillat	ei
vacillati	o
vacillatio	n
vacu	iou
vacui	t
vacuit	y
vacuo	lu
vacuol	aei
vacuola	t
vacuolat	e
vacuolate	d
vacuole	s
vacuoli	z
vacuoliz	ae
vacuoliza	t
vacuolizat	i
vacuolizati	o
vacuolizatio	n
vacuolize	d
vacuou	s
vacuous	l
vacuousl	y
vacuu	m
vacuum	eis
vacuume	d
vacuumi	nsz
vacuumin	g
vacuumis	e
vacuumiz	e
vad	uv
vadu	z
vag	airu
vaga	br
vagab	o
vagabo	n
vagabon	d
vagabond	s
vagar	iy
vagari	eo
vagarie	s
vagario	u
vagariou	s
vagi	n
vagin	a
vagina	elst
vaginal	l
vaginall	y
vaginat	e
vagr	a
vagra	n
vagran	ct
vagranc	y
vagrant	ilns
vagranti	z
vagrantiz	e
vagrantl	y
vagrantn	e
vagrantne	s
vagrantnes	s
vagrantness	e
vagrantnesse	s
vagu	eis
vague	dlnrs
vaguel	y
vaguen	e
vaguene	s
vaguenes	s
vagueness	e
vaguenesse	s
vagues	t
vagui	s
vaguis	h
vai	lnor
vain	efgln
vaine	rs
vaines	t
vainf	u
vainfu	l
vaing	l
vaingl	o
vainglo	r
vainglor	iy
vainglori	o
vainglorio	u
vaingloriou	s
vainl	y
vainn	e
vainne	s
vainnes	s
vainness	e
vainnesse	s
vaj	q
val	aehikloprsuv
vala	n
valan	c
valanc	e
vale	dnrst
valed	i
valedi	c
valedic	t
valedict	io
valedicti	o
valedictio	n
valedicto	r
valedictor	y
valen	ct
valenc	eiy
valence	s
valenci	ae
valencie	s
valent	i
valenti	n
valentin	eo
valentine	s
valer	iy
valeri	ae
valeria	n
valet	su
valetu	d
valetud	i
valetudi	n
valetudin	a
valetudina	r
valetudinar	i
valetudinari	a
valetudinaria	n
valh	a
valha	l
valhal	l
valhall	a
vali	abdnu
valia	n
valian	t
valiant	lns
valiantl	y
valiantn	e
valiantne	s
valiantnes	s
valiantness	e
valiantnesse	s
valid	ailn
valida	t
validat	eio
validate	ds
validati	no
validatin	g
validatio	n
validato	r
validator	sy
validi	t
validit	iy
validiti	e
validitie	s
validl	y
validn	e
validne	s
validnes	s
validness	e
validnesse	s
valin	e
valiu	m
valk	y
valky	r
valkyr	i
valkyri	e
vall	e
valle	ty
vallet	t
vallett	a
valley	efls
valleye	d
valleyf	u
valleyfu	l
valleyl	i
valleyli	k
valleylik	e
valo	iru
valoi	s
valor	io
valori	sz
valoris	ae
valorisa	t
valorisat	i
valorisati	o
valorisatio	n
valoriz	ae
valoriza	t
valorizat	i
valorizati	o
valorizatio	n
valoro	u
valorou	s
valou	r
valp	a
valpa	r
valpar	a
valpara	i
valparai	s
valparais	o
vals	e
valu	aeit
valua	bt
valuab	l
valuabl	ey
valuable	ns
valuablen	e
valuablene	s
valuablenes	s
valuableness	e
valuablenesse	s
valuat	io
valuati	o
valuatio	n
valuation	as
valuationa	l
valuational	l
valuationall	y
valuato	r
value	dlrs
valuel	e
valuele	s
valueles	s
valueless	n
valuelessn	e
valuelessne	s
valuelessnes	s
valuelessness	e
valuelessnesse	s
valuer	s
valui	n
valuin	g
valut	a
valv	aeiu
valva	t
valvat	e
valve	dls
valvel	ei
valvele	s
valveles	s
valveli	k
valvelik	e
valvi	f
valvif	o
valvifo	r
valvifor	m
valvu	l
valvul	a
valvula	r
vam	op
vamo	o
vamoo	s
vamoos	e
vamp	ei
vampe	r
vampi	r
vampir	ei
vampire	ds
vampired	o
vampiredo	m
vampires	u
vampiresu	r
vampiresur	v
vampiresurv	i
vampiresurvi	v
vampiresurviv	o
vampiresurvivo	r
vampiresurvivor	s
vampiri	cnz
vampiric	a
vampirica	l
vampirical	l
vampiricall	y
vampirin	eg
vampiriz	e
van	acdeginqstuw
vana	d
vanad	iy
vanadi	au
vanadia	nt
vanadiat	e
vanadiu	m
vanadium	s
vanady	l
vanc	eo
vance	m
vancem	e
vanceme	n
vancemen	t
vanco	u
vancou	v
vancouv	e
vancouve	r
vand	aey
vanda	l
vandal	is
vandali	sz
vandalis	ehm
vandaliz	ei
vandalize	ds
vandalizi	n
vandalizin	g
vande	nr
vanden	b
vandenb	e
vandenbe	r
vandenber	g
vander	bp
vanderb	iu
vanderbi	l
vanderbil	t
vanderbu	r
vanderbur	g
vanderburg	h
vanderp	o
vanderpo	e
vanderpoe	l
vandy	k
vandyk	e
vane	s
vanes	s
vaness	a
vang	u
vangu	a
vangua	r
vanguar	d
vanguard	is
vanguardi	s
vanguardis	mt
vanguardism	s
vanguardist	s
vani	lst
vanil	l
vanill	a
vanilla	s
vanis	h
vanish	eim
vanishe	drs
vanisher	s
vanishi	n
vanishin	g
vanishing	ls
vanishingl	y
vanishm	e
vanishme	n
vanishmen	t
vanishment	s
vanit	iy
vaniti	e
vanitie	ds
vann	ei
vanne	d
vanni	n
vannin	g
vanq	u
vanqu	i
vanqui	s
vanquis	h
vanquish	ei
vanquishe	ds
vanquishi	n
vanquishin	g
vant	a
vanta	g
vantag	e
vanu	a
vanua	t
vanuat	u
vanw	a
vanwa	r
vanwar	d
vao	b
vap	io
vapi	d
vapid	i
vapidi	t
vapidit	y
vapo	ru
vapor	is
vapori	nsz
vaporin	g
vaporis	ei
vaporise	ds
vaporisi	n
vaporisin	g
vaporiz	aei
vaporiza	bt
vaporizab	l
vaporizabl	e
vaporizat	i
vaporizati	o
vaporizatio	n
vaporization	s
vaporize	ds
vaporizi	n
vaporizin	g
vapou	r
vapour	aelsy
vapoura	b
vapourab	l
vapourabl	e
vapoure	d
vapourl	ei
vapourle	s
vapourles	s
vapourli	k
vapourlik	e
vaq	deir
vaqd	v
var	ilmnsvy
vari	acefost
varia	bnt
variab	il
variabi	l
variabil	i
variabili	t
variabilit	iy
variabiliti	e
variabilitie	s
variabl	ey
variable	ns
variablen	e
variablene	s
variablenes	s
variableness	e
variablenesse	s
varian	ct
varianc	e
variance	s
variant	ls
variantl	y
variat	i
variati	ov
variatio	n
variation	as
variationa	l
variational	l
variationall	y
variativ	e
variative	l
variativel	y
varic	ao
varica	p
varico	cls
varicoc	e
varicoce	l
varicocel	e
varicol	o
varicolo	r
varicolor	e
varicolore	d
varicos	i
varicosi	t
varicosit	y
varie	dgst
varied	ln
variedl	y
variedn	e
variedne	s
variednes	s
variedness	e
variednesse	s
varieg	a
variega	t
variegat	ei
variegate	d
variegati	o
variegatio	n
variet	aiy
varieta	l
varieti	e
varietie	s
varif	o
varifo	r
varifor	m
vario	ru
varior	u
varioru	m
variou	s
various	ln
variousl	y
variousn	e
variousne	s
variousnes	s
variousness	e
variousnesse	s
varis	t
varist	o
varisto	r
varit	y
varity	p
varityp	ei
varitypi	n
varitypin	g
varl	e
varle	t
varm	i
varmi	n
varmin	t
varn	i
varni	s
varnis	h
varnish	eiy
varnishe	drs
varnisher	s
varnishi	n
varnishin	g
vars	i
varsi	t
varsit	y
varv	e
vary	i
varyi	n
varyin	g
varying	ls
varyingl	y
vas	ceoqst
vasc	u
vascu	l
vascul	aou
vascula	r
vascular	il
vasculari	t
vascularit	iy
vasculariti	e
vascularitie	s
vascularl	y
vasculo	su
vasculos	e
vasculou	s
vasculu	m
vase	cdfls
vasec	t
vasect	o
vasecto	m
vasectom	iy
vasectomi	e
vasectomie	s
vasef	u
vasefu	l
vasel	i
vaseli	kn
vaselik	e
vaselin	e
vaso	cdm
vasoc	o
vasoco	n
vasocon	s
vasocons	t
vasoconst	r
vasoconstr	i
vasoconstri	c
vasoconstric	t
vasoconstrict	o
vasoconstricto	r
vasod	i
vasodi	l
vasodil	a
vasodila	t
vasodilat	o
vasodilato	r
vasom	o
vasomo	t
vasomot	o
vasomoto	r
vasq	u
vasqu	e
vasque	z
vass	a
vassa	lr
vast	eilns
vaste	rs
vastes	t
vasti	t
vastit	u
vastitu	d
vastitud	e
vastl	y
vastn	e
vastne	s
vastnes	s
vastness	e
vastnesse	s
vat	ist
vati	c
vatic	ai
vatica	n
vatican	i
vaticani	z
vaticaniz	ae
vaticaniza	t
vaticanizat	i
vaticanizati	o
vaticanizatio	n
vaticanization	s
vaticanize	s
vatici	n
vaticin	a
vaticina	t
vaticinat	i
vaticinati	o
vaticinatio	n
vatt	ei
vatte	d
vatti	n
vattin	g
vau	dglnrx
vaud	eo
vaude	v
vaudev	i
vaudevi	l
vaudevil	l
vaudevill	ei
vaudevilli	a
vaudevillia	n
vaudo	i
vaudoi	s
vaug	h
vaugh	an
vaugha	n
vaul	t
vault	eilsy
vaulte	dr
vaulti	en
vaultie	rs
vaulties	t
vaultin	g
vaultl	i
vaultli	k
vaultlik	e
vaun	t
vaunt	ei
vaunte	d
vaunti	n
vauntin	g
vaux	h
vauxh	a
vauxha	l
vauxhal	l
vax	ersuvx
vaxe	s
vaxu	v
vaxx	rv
vb	bdehijkmnoqruvx
vbb	eoy
vbe	frw
vbh	i
vbk	i
vbn	lp
vbnl	v
vbnp	v
vbo	r
vbq	djp
vbr	v
vbu	l
vbul	l
vbull	e
vbulle	t
vbullet	i
vbulleti	n
vc	acdehijnrsw
vcd	lp
vce	q
vch	i
vchi	p
vcj	o
vcr	s
vcrs	v
vd	bcdefghijklnopqrstuvxyz
vdb	dvy
vdc	l
vdd	v
vde	eouvz
vdf	ftu
vdff	v
vdfu	v
vdg	nor
vdh	g
vdi	l
vdk	w
vdn	flm
vdnm	v
vdo	drsvx
vdp	dforsv
vdq	il
vdr	kuw
vdru	v
vdt	do
vdx	v
vdy	v
ve	abcdeghijlnopqrstuvx
vea	l
veal	eisy
veale	d
veali	n
vealin	g
veb	rv
vec	t
vect	o
vecto	r
vector	gis
vectorg	r
vectorgr	a
vectorgra	p
vectorgrap	h
vectori	az
vectoria	l
vectorial	l
vectoriall	y
vectoriz	ai
vectoriza	t
vectorizat	i
vectorizati	o
vectorizatio	n
vectorizi	n
vectorizin	g
ved	ae
vede	t
vedet	t
vedett	e
vee	drv
veer	aeisy
veera	b
veerab	l
veerabl	e
veere	d
veeri	n
veerin	g
veering	l
veeringl	y
veg	aegisu
vega	ns
vegan	is
vegani	cs
veganis	m
veganism	s
vege	st
veget	a
vegeta	blrt
vegetab	l
vegetabl	e
vegetable	s
vegetar	i
vegetari	a
vegetaria	n
vegetarian	is
vegetariani	s
vegetarianis	m
vegetat	ei
vegetate	ds
vegetati	nov
vegetatin	g
vegetatio	n
vegetation	als
vegetationa	l
vegetational	l
vegetationall	y
vegetationl	e
vegetationle	s
vegetationles	s
vegetativ	e
vegg	ei
vegge	ds
veggi	en
veggie	s
veggin	g
vegi	e
vegie	s
veh	ei
vehe	m
vehem	e
veheme	n
vehemen	ct
vehemenc	e
vehement	l
vehementl	y
vehi	c
vehic	lu
vehicl	e
vehicle	s
vehicu	l
vehicul	a
vehicula	r
vei	aln
veil	eils
veile	d
veiled	ln
veiledl	y
veiledn	e
veiledne	s
veilednes	s
veili	n
veilin	g
veill	ei
veille	s
veilles	s
veilli	k
veillik	e
vein	eilsy
veine	d
veini	n
veinin	g
veinl	ei
veinle	s
veinles	s
veinli	k
veinlik	e
vej	v
vel	acdlouv
vela	mrst
velam	e
velame	n
velas	q
velasq	u
velasqu	e
velasque	z
velat	e
velc	r
velcr	o
veld	st
veldt	s
vell	aeiu
velle	i
vellei	t
velleit	y
velli	c
vellic	a
vellica	t
vellicat	ei
vellicati	o
vellicatio	n
vellu	m
velo	cdu
veloc	i
veloci	pt
velocip	e
velocipe	d
velociped	e
velocit	iy
velociti	e
velocitie	s
velod	r
velodr	o
velodro	m
velodrom	e
velou	r
velour	s
velu	mr
velur	e
velv	e
velve	t
velvet	eilsy
velvete	e
velvetee	n
velveti	en
velvetie	rs
velveties	t
velvetin	e
velvetine	s
velvetines	s
velvetiness	e
velvetinesse	s
velvetl	i
velvetli	k
velvetlik	e
ven	abdeginotu
vena	lt
venal	i
venali	t
venalit	y
venat	i
venati	o
venatio	n
venb	rv
vend	eio
vende	ert
vender	s
vendet	t
vendett	ai
vendetta	s
vendetti	s
vendettis	t
vendettist	s
vendi	bn
vendib	il
vendibi	l
vendibil	i
vendibili	t
vendibilit	y
vendibl	e
vendin	g
vendo	r
vendor	s
vene	enrtz
venee	r
veneer	eis
veneere	dr
veneerer	s
veneeri	n
veneerin	g
venen	a
venena	t
venenat	e
vener	aey
venera	bt
venerab	il
venerabi	l
venerabil	i
venerabili	t
venerabilit	y
venerabl	e
venerat	ei
venerati	o
veneratio	n
venere	a
venerea	l
venet	aio
veneti	a
venetia	n
venez	u
venezu	e
venezue	l
venezuel	a
venezuela	n
veng	e
venge	af
vengea	n
vengean	c
vengeanc	e
vengeance	s
vengef	u
vengefu	l
veni	acprs
venia	l
venial	i
veniali	t
venialit	y
venic	e
venip	u
venipu	n
venipun	c
venipunc	t
venipunct	u
venipunctu	r
venipunctur	e
venir	e
venire	m
venirem	a
venirema	n
venis	o
veniso	n
venison	s
veno	mu
venom	eilnosy
venome	dr
venomi	n
venomin	g
venoml	e
venomle	s
venomles	s
venomn	e
venomne	s
venomnes	s
venomo	u
venomou	s
venomous	l
venomousl	y
venoms	o
venomso	m
venomsom	e
venou	s
vent	aeirsu
venta	g
ventag	e
vente	dr
venti	ln
ventil	a
ventila	bt
ventilab	l
ventilabl	e
ventilat	eio
ventilate	ds
ventilati	nov
ventilatin	g
ventilatio	n
ventilativ	e
ventilato	r
ventilator	s
ventin	g
ventr	ai
ventra	l
ventral	ls
ventrall	y
ventri	cl
ventric	lou
ventricl	e
ventricle	s
ventrico	s
ventricos	i
ventricosi	t
ventricosit	y
ventricu	l
ventricul	a
ventricula	r
ventril	o
ventrilo	q
ventriloq	u
ventriloqu	i
ventriloqui	as
ventriloquia	l
ventriloquis	t
ventu	r
ventur	aeio
venture	drs
venturer	s
ventures	o
ventureso	m
venturesom	e
venturi	n
venturin	g
venturing	s
venturo	u
venturou	s
venu	es
venue	s
venus	ei
venuse	s
venusi	a
venusia	n
venusian	s
veo	q
vep	v
ver	abcdgilmnorstvyz
vera	cn
verac	i
veraci	ot
veracio	u
veraciou	s
veracit	y
veran	d
verand	a
veranda	hs
verandah	s
verb	aeilos
verba	lt
verbal	ils
verbali	sz
verbalis	eit
verbalise	ds
verbalisi	n
verbalisin	g
verbalist	i
verbalisti	c
verbalistic	a
verbalistica	l
verbalistical	l
verbalisticall	y
verbaliz	aei
verbaliza	bt
verbalizab	il
verbalizabi	l
verbalizabil	i
verbalizabili	t
verbalizabilit	y
verbalizabl	e
verbalizat	i
verbalizati	o
verbalizatio	n
verbalization	s
verbalize	drs
verbalizer	s
verbalizi	n
verbalizin	g
verball	eiy
verballe	d
verballi	n
verballin	g
verbat	i
verbati	m
verbe	n
verben	a
verbi	af
verbia	g
verbiag	e
verbif	y
verbl	e
verble	s
verbles	s
verbo	s
verbos	ei
verbosi	t
verbosit	y
verc	e
verce	l
verd	aeiu
verda	n
verdan	ct
verdanc	y
verde	r
verder	e
verdere	r
verdi	cg
verdic	t
verdict	s
verdig	r
verdigr	i
verdigri	s
verdu	r
verdur	e
verg	ei
verge	drs
vergi	ln
vergin	g
veri	deflstz
verid	i
veridi	c
veridic	a
veridica	l
veridical	i
veridicali	t
veridicalit	y
verie	rs
veries	t
verif	iy
verifi	ace
verifia	b
verifiab	il
verifiabi	l
verifiabil	i
verifiabili	t
verifiabilit	y
verifiabl	e
verific	a
verifica	t
verificat	i
verificati	o
verificatio	n
verification	s
verifie	drs
verifier	s
verify	i
verifyi	n
verifyin	g
veril	y
veris	im
verisi	gm
verisig	n
verisim	i
verisimi	l
verisimil	ai
verisimila	r
verisimili	t
verisimilit	u
verisimilitu	d
verisimilitud	e
verit	ay
verita	bs
veritab	l
veritabl	ey
veritable	n
veritablen	e
veritablene	s
veritablenes	s
veritableness	e
veritablenesse	s
veriz	o
verizo	n
verl	a
verla	g
verm	eio
verme	i
vermei	l
vermi	cfln
vermic	eiu
vermice	l
vermicel	l
vermicell	i
vermici	d
vermicid	e
vermicu	l
vermicul	i
vermiculi	t
vermiculit	e
vermif	ou
vermifo	r
vermifor	m
vermifu	g
vermifug	e
vermil	i
vermili	o
vermilio	n
vermin	eo
vermine	dr
vermino	u
verminou	s
vermo	n
vermon	t
vern	aeio
verna	clt
vernac	u
vernacu	l
vernacul	a
vernacula	r
vernacular	ils
vernaculari	t
vernacularit	y
vernacularl	y
vernal	i
vernali	sz
vernalis	ae
vernalisa	t
vernalisat	i
vernalisati	o
vernalisatio	n
vernaliz	ae
vernaliza	t
vernalizat	i
vernalizati	o
vernalizatio	n
vernat	i
vernati	o
vernatio	n
verni	e
vernie	r
verno	n
vero	n
veron	ai
veroni	c
veronic	a
verr	u
verru	c
verruc	o
verruco	u
verrucou	s
vers	aeiou
versa	cint
versac	e
versai	l
versail	l
versaill	e
versaille	s
versan	t
versat	ei
versate	c
versati	l
versatil	ei
versatile	ln
versatilel	y
versatilen	e
versatilene	s
versatilenes	s
versatileness	e
versatilenesse	s
versatili	t
versatilit	y
verse	dlms
versel	e
versele	s
verseles	s
versem	o
versemo	n
versemon	g
versemong	e
versemonge	r
versi	cfno
versic	l
versicl	e
versif	iy
versifi	ce
versific	a
versifica	t
versificat	i
versificati	o
versificatio	n
versifie	r
versin	g
versio	n
version	ais
versiona	l
versioni	s
versionis	t
versu	s
vert	ei
verte	bx
verteb	r
vertebr	a
vertebra	elst
vertebrat	ei
vertebrate	ds
vertebrati	o
vertebratio	n
verti	cg
vertic	aei
vertica	l
vertical	ilns
verticali	st
verticalis	m
verticalism	s
verticalit	iy
verticaliti	e
verticalitie	s
verticall	y
verticaln	e
verticalne	s
verticalnes	s
verticalness	e
verticalnesse	s
vertice	s
vertici	l
verticil	l
verticill	a
verticilla	t
verticillat	e
vertig	io
vertigi	n
vertigin	o
vertigino	u
vertiginou	s
verv	e
verve	st
verz	e
verze	i
verzei	c
verzeic	h
verzeich	n
verzeichn	i
verzeichni	s
ves	ipstu
vesi	c
vesic	alu
vesica	n
vesican	t
vesicl	e
vesicu	l
vesicul	a
vesicula	r
vesp	aei
vespe	r
vesper	at
vespera	l
vespert	i
vesperti	n
vespertin	e
vespi	n
vespin	e
vess	e
vesse	l
vessel	efls
vessele	d
vesself	u
vesselfu	l
vessell	ei
vesselle	d
vesselli	k
vessellik	e
vest	aeilmrsu
vesta	l
veste	de
vesti	bgn
vestib	u
vestibu	l
vestibul	ae
vestibula	r
vestig	ei
vestige	s
vestigi	a
vestigia	l
vestigial	l
vestigiall	y
vestin	g
vestl	ei
vestle	s
vestles	s
vestli	k
vestlik	e
vestm	e
vestme	n
vestmen	t
vestr	y
vestry	m
vestrym	a
vestryma	n
vestu	r
vestur	e
vesu	v
vesuv	i
vesuvi	au
vesuvia	n
vesuvian	i
vesuviani	t
vesuvianit	e
vesuviu	s
vet	ceorst
vetc	h
vete	r
veter	ai
vetera	n
veteran	s
veteri	n
veterin	a
veterina	r
veterinar	iy
veterinari	ae
veterinaria	n
veterinarian	s
veterinarie	s
veto	ei
vetoe	drs
vetoer	s
vetoi	ns
vetoin	g
vetois	mt
vetoist	i
vetoisti	c
vetoistic	a
vetoistica	l
vett	ei
vette	dr
vetter	s
vetti	n
vettin	g
vex	aei
vexa	t
vexat	i
vexati	o
vexatio	nu
vexatiou	s
vexe	ds
vexed	ln
vexedl	y
vexedn	e
vexedne	s
vexednes	s
vexedness	e
vexednesse	s
vexi	n
vexin	g
vf	abcdefhklmnorstuvwxy
vfa	tv
vfc	s
vfd	dg
vfe	adk
vff	bfkuvw
vffk	v
vfk	av
vfl	b
vfm	b
vfn	cdf
vft	bt
vfu	fv
vfy	guv
vg	ajnoq
vgn	rv
vgo	v
vh	adefikmopr
vhd	d
vhm	b
vho	v
vhp	v
vi	abcdefgijklmnopqrstvxz
via	bdglnst
viab	il
viabi	l
viabil	i
viabili	t
viabilit	iy
viabiliti	e
viabilitie	s
viabl	ey
viable	rs
viables	t
viad	u
viadu	c
viaduc	t
viaduct	s
viag	r
viagr	a
vial	s
vian	d
viat	i
viati	c
vib	eoru
vibr	a
vibra	npt
vibran	ct
vibranc	y
vibrant	ls
vibrantl	y
vibrap	h
vibraph	o
vibrapho	n
vibraphon	ei
vibraphoni	s
vibraphonis	t
vibrat	eio
vibrate	ds
vibrati	no
vibratin	g
vibrating	l
vibratingl	y
vibratio	n
vibration	as
vibrationa	l
vibrato	lrs
vibratol	e
vibratole	s
vibratoles	s
vibrator	sy
vibu	r
vibur	n
viburn	u
viburnu	m
vic	aehikotu
vica	r
vicar	agils
vicara	g
vicarag	e
vicarage	s
vicarg	e
vicarge	n
vicargen	e
vicargene	r
vicargener	a
vicargenera	l
vicargeneral	s
vicargenerals	h
vicargeneralsh	i
vicargeneralshi	p
vicari	aios
vicaria	l
vicarii	s
vicariis	m
vicariism	s
vicario	u
vicariou	s
vicarious	ln
vicariousl	y
vicariousn	e
vicariousne	s
vicariousnes	s
vicariousness	e
vicariousnesse	s
vicaris	h
vicarl	y
vicars	h
vicarsh	i
vicarshi	p
vicarship	s
vice	dglrs
viceg	e
vicege	r
viceger	e
vicegere	n
vicegeren	ct
vicegerenc	y
vicel	e
vicele	s
viceles	s
vicer	eo
vicere	gi
vicereg	a
vicerega	l
vicerei	n
vicerein	e
vicero	y
viceroy	a
viceroya	l
viceroyal	t
viceroyalt	y
vich	y
vichy	s
vichys	s
vichyss	o
vichysso	i
vichyssoi	s
vichyssois	e
vici	nos
vicin	agi
vicina	gl
vicinag	e
vicini	t
vicinit	iy
viciniti	e
vicinitie	s
vicio	u
viciou	s
vicious	ln
viciousl	y
viciousn	e
viciousne	s
viciousnes	s
viciousness	e
viciousnesse	s
vicis	s
viciss	i
vicissi	t
vicissit	u
vicissitu	d
vicissitud	ei
vicissitude	s
vicissitudi	n
vicissitudin	o
vicissitudino	u
vicissitudinou	s
vick	eisy
vicke	r
vicker	s
vicks	b
vicksb	u
vicksbu	r
vicksbur	g
vico	d
vicod	i
vicodi	n
vict	ioru
victi	m
victim	ahis
victima	g
victimag	e
victimh	o
victimho	o
victimhoo	d
victimhood	s
victimi	sz
victimis	ei
victimise	drs
victimisi	n
victimisin	g
victimiz	aei
victimiza	t
victimizat	i
victimizati	o
victimizatio	n
victimization	s
victimize	drs
victimizer	s
victimizi	n
victimizin	g
victo	r
victor	eisy
victore	s
victores	s
victori	aeno
victoria	n
victorian	ils
victoriani	sz
victorianis	t
victorianiz	e
victorianize	s
victorianl	y
victorie	s
victorin	eo
victorino	x
victorio	u
victoriou	s
victorious	l
victoriousl	y
victory	l
victoryl	e
victoryle	s
victoryles	s
victr	eo
victre	s
victres	s
victro	l
victrol	a
victu	a
victua	l
victual	es
victuale	r
vicu	g
vicug	n
vicugn	a
vid	aei
vida	l
vide	o
video	ceipst
videoc	ad
videoca	ms
videocam	e
videocame	r
videocamer	a
videocamera	s
videocas	t
videoe	ds
videoi	n
videoin	g
videop	h
videoph	o
videopho	n
videophon	e
videot	ae
videota	p
videotap	ei
videotape	drs
videotaper	s
videotapi	n
videotapin	g
videote	x
videotex	t
vidi	c
vidic	o
vidico	n
vie	dnrstw
vien	nt
vienn	ae
vienne	s
viennes	e
vient	i
vienti	a
vientia	n
vientian	e
viet	n
vietn	a
vietna	m
vietnam	e
vietname	s
vietnames	e
view	adefipsy
viewa	b
viewab	il
viewabi	l
viewabil	i
viewabili	t
viewabilit	y
viewabl	e
viewd	a
viewda	t
viewdat	a
viewdata	s
viewe	dr
viewer	s
viewf	i
viewfi	n
viewfin	d
viewfind	e
viewfinde	r
viewfinder	s
viewi	n
viewin	g
viewp	io
viewpi	c
viewpic	t
viewpict	u
viewpictu	r
viewpictur	e
viewpo	i
viewpoi	n
viewpoin	t
viewpoint	s
views	o
viewso	n
viewson	i
viewsoni	c
vig	ino
vigi	l
vigil	as
vigila	n
vigilan	ct
vigilanc	e
vigilant	eiln
vigilante	is
vigilantei	s
vigilanteis	m
vigilanteism	s
vigilanti	s
vigilantis	m
vigilantism	s
vigilantl	y
vigilantn	e
vigilantne	s
vigilantnes	s
vigilantness	e
vigilantnesse	s
vign	e
vigne	t
vignet	t
vignett	e
vignette	s
vigo	ru
vigor	o
vigoro	u
vigorou	s
vigorous	l
vigorousl	y
vigou	r
vigour	l
vigourl	e
vigourle	s
vigourles	s
vii	v
vik	ir
viki	n
vikin	g
viking	is
vikingi	s
vikingis	m
vikr	a
vikra	m
vil	eil
vile	lnrs
vilel	y
vilen	e
vilene	s
vilenes	s
vileness	e
vilenesse	s
viles	t
vili	f
vilif	iy
vilifi	ce
vilific	a
vilifica	t
vilificat	i
vilificati	o
vilificatio	n
vilification	s
vilifie	ds
vilify	i
vilifyi	n
vilifyin	g
vill	aeiou
villa	efgiklrs
villae	d
villaf	y
villag	ey
village	dfhlrsty
villaged	o
villagedo	m
villagef	u
villagefu	l
villageh	o
villageho	o
villagehoo	d
villagel	ei
villagele	s
villageles	s
villageli	k
villagelik	e
villager	es
villagere	s
villageres	s
villai	n
villain	diosy
villaind	o
villaindo	m
villaini	ez
villainie	s
villainiz	e
villainize	r
villaino	u
villainou	s
villainous	ln
villainousl	y
villainousn	e
villainousne	s
villainousnes	s
villak	i
villaki	n
villal	ei
villale	s
villales	s
villali	k
villalik	e
villar	e
villare	t
villaret	t
villarett	e
ville	i
villei	n
villi	f
villif	o
villifo	r
villifor	m
villo	s
villos	e
villu	s
vim	eilrs
vime	o
vimi	nu
vimin	e
vimine	o
vimineo	u
vimineou	s
vimiu	m
vims	c
vimsc	r
vimscr	i
vimscri	p
vimscrip	t
vimscript	s
vin	acdeorstvy
vina	i
vinai	g
vinaig	r
vinaigr	e
vinaigre	t
vinaigret	t
vinaigrett	e
vinaigrette	s
vinc	eiu
vince	n
vincen	t
vinci	b
vincib	l
vincibl	e
vincu	l
vincul	u
vinculu	m
vind	i
vindi	c
vindic	at
vindica	bt
vindicab	l
vindicabl	e
vindicat	eio
vindicate	d
vindicati	ov
vindicatio	n
vindicativ	e
vindicato	r
vindict	i
vindicti	v
vindictiv	e
vindictive	ln
vindictivel	y
vindictiven	e
vindictivene	s
vindictivenes	s
vindictiveness	e
vindictivenesse	s
vine	dglrsy
vineg	a
vinega	r
vinegar	lsy
vinegarl	i
vinegarli	k
vinegarlik	e
vinel	ei
vinele	s
vineles	s
vineli	k
vinelik	e
viner	y
viney	a
vineya	r
vineyar	d
vineyard	es
vineyarde	d
vino	su
vinos	i
vinosi	t
vinosit	y
vinou	s
vins	o
vinso	n
vint	an
vinta	g
vintag	ei
vintage	drs
vintagi	n
vintagin	g
vintn	e
vintne	r
viny	l
vinyl	is
vinyli	c
vio	lx
viol	aeio
viola	bcst
violab	l
violabl	e
violac	e
violace	o
violaceo	u
violaceou	s
violat	eio
violate	drs
violater	s
violati	no
violatin	g
violatio	n
violation	s
violato	r
violator	sy
viole	nt
violen	ct
violenc	ey
violence	s
violent	ln
violentl	y
violentn	e
violentne	s
violentnes	s
violet	ist
violeti	s
violetis	h
violett	ae
violetta	s
violette	s
violi	ns
violin	is
violini	s
violinis	t
violinist	s
violis	t
violist	s
violo	n
violon	c
violonc	e
violonce	l
violoncel	l
violoncell	o
viox	x
vip	es
vipe	r
viper	ilos
viperi	ns
viperin	e
viperis	h
viperish	l
viperishl	y
viperl	i
viperli	kn
viperlik	e
viperlin	g
vipero	u
viperou	s
vir	aegiotu
vira	gl
virag	o
viral	l
virall	y
vire	lo
virel	a
virela	y
virg	iou
virgi	ln
virgin	ails
virgina	l
virgini	at
virginia	n
virginian	s
virginit	iy
virginiti	e
virginitie	s
virginl	y
virgo	as
virgoa	n
virgoan	s
virgu	l
virgul	ae
virgula	t
virgulat	e
viri	dl
virid	ei
viride	s
virides	c
viridesc	e
viridesce	n
viridescen	t
viridi	a
viridia	n
viril	ei
virile	ls
virilel	y
viriles	c
virilesc	e
virilesce	n
virilescen	t
virili	st
virilis	m
virilit	iy
viriliti	e
virilitie	s
viro	l
virol	o
virolo	g
virolog	iy
virologi	s
virologis	t
virt	u
virtu	aeo
virtua	l
virtual	bl
virtualb	o
virtualbo	x
virtuall	y
virtue	dls
virtuel	e
virtuele	s
virtueles	s
virtueless	n
virtuelessn	e
virtuelessne	s
virtuelessnes	s
virtuelessness	e
virtuelessnesse	s
virtuo	su
virtuos	io
virtuosi	ct
virtuosit	y
virtuoso	s
virtuosos	h
virtuososh	i
virtuososhi	p
virtuou	s
virtuous	ln
virtuousl	y
virtuousn	e
virtuousne	s
virtuousnes	s
virtuousness	e
virtuousnesse	s
viru	ls
virul	e
virule	n
virulen	ct
virulenc	e
virulent	ln
virulentl	y
virulentn	e
virulentne	s
virulentnes	s
virus	eilt
viruse	s
virusi	i
virusii	k
virusiik	e
virusl	i
virusli	k
viruslik	e
virust	a
virusta	t
virustat	i
virustati	c
vis	acehiotu
visa	egis
visae	d
visag	e
visai	n
visain	g
visc	eio
visce	r
viscer	a
viscera	l
visci	d
viscid	i
viscidi	t
viscidit	y
visco	cmsu
viscoc	i
viscoci	t
viscocit	y
viscom	e
viscome	t
viscomet	e
viscomete	r
viscos	ei
viscosi	t
viscosit	y
viscou	ns
viscoun	t
viscount	s
viscous	ln
viscousl	y
viscousn	e
viscousne	s
viscousnes	s
viscousness	e
viscousnesse	s
vish	n
vishn	u
visi	bgot
visib	il
visibi	l
visibil	i
visibili	t
visibilit	iy
visibiliti	e
visibilitie	s
visibl	ey
visible	n
visiblen	e
visiblene	s
visiblenes	s
visibleness	e
visiblenesse	s
visig	o
visigo	t
visigot	h
visigoth	s
visio	n
vision	aeips
visiona	lr
visional	l
visionall	y
visionar	iy
visionari	eln
visionarie	s
visionaril	y
visionarin	e
visionarine	s
visionarines	s
visionariness	e
visionarinesse	s
visione	r
visioni	ns
visionin	g
visionis	t
visionp	r
visionpr	o
visit	aeios
visita	t
visitat	io
visitati	ov
visitatio	n
visitation	as
visitationa	l
visitativ	e
visitato	r
visitator	i
visitatori	a
visitatoria	l
visite	der
visiti	n
visitin	g
visito	r
visitor	s
visitors	h
visitorsh	i
visitorshi	p
viso	r
visor	eils
visore	d
visori	n
visorin	g
visorl	e
visorle	s
visorles	s
vist	a
vista	els
vistae	d
vistal	e
vistale	s
vistales	s
visu	a
visua	l
visual	ils
visuali	stz
visualis	eit
visualise	dr
visualisi	n
visualisin	g
visualist	s
visualit	y
visualiz	aei
visualiza	bt
visualizab	il
visualizabi	l
visualizabil	i
visualizabili	t
visualizabilit	y
visualizabl	e
visualizat	i
visualizati	o
visualizatio	n
visualize	drs
visualizi	n
visualizin	g
visuall	y
visuals	t
visualst	u
visualstu	d
visualstud	i
visualstudi	o
visualstudio	c
visualstudioc	o
visualstudioco	d
visualstudiocod	e
vit	aeiortu
vita	elms
vital	ilns
vitali	stz
vitalis	emt
vitalit	iy
vitaliti	e
vitalitie	s
vitaliz	ae
vitaliza	t
vitalizat	i
vitalizati	o
vitalizatio	n
vitall	y
vitaln	e
vitalne	s
vitalnes	s
vitalness	e
vitalnesse	s
vitam	i
vitami	n
vitamin	eios
vitamine	s
vitamini	csz
vitaminis	a
vitaminisa	t
vitaminisat	i
vitaminisati	o
vitaminisatio	n
vitaminiz	a
vitaminiza	t
vitaminizat	i
vitaminizati	o
vitaminizatio	n
vitamino	l
vitaminol	o
vitaminolo	g
vitaminolog	y
vitas	c
vitasc	o
vitasco	p
vitascop	e
vite	ps
vitep	r
vitepr	e
vitepre	s
vitepres	s
vites	st
viti	ac
vitia	bt
vitiab	l
vitiabl	e
vitiat	eio
vitiati	o
vitiatio	n
vitiato	r
vitic	u
viticu	l
viticul	t
viticult	u
viticultu	r
viticultur	ai
viticultura	l
viticulturi	s
viticulturis	t
vitr	ei
vitre	o
vitreo	u
vitreou	s
vitri	cfo
vitrif	io
vitrifi	ac
vitrifia	b
vitrifiab	l
vitrifiabl	e
vitrific	a
vitrifica	t
vitrificat	i
vitrificati	o
vitrificatio	n
vitrifo	r
vitrifor	m
vitrio	l
vitriol	i
vitrioli	csz
vitriolis	e
vitrioliz	e
vitt	al
vittl	e
vitu	lps
vitul	i
vituli	n
vitulin	e
vitup	e
vitupe	r
vituper	a
vitupera	t
vituperat	ei
vituperati	ov
vituperatio	n
vituperativ	e
viv	aeios
viva	clr
vivac	ei
vivaci	ot
vivacio	u
vivaciou	s
vivacious	ln
vivaciousl	y
vivaciousn	e
vivaciousne	s
vivaciousnes	s
vivaciousness	e
vivaciousnesse	s
vivacit	y
vival	d
vivald	i
vivar	i
vivari	u
vivariu	m
vive	r
viver	r
viverr	i
viverri	n
viverrin	e
vivi	adfps
vivia	n
vivid	eiln
vivide	rs
vivides	t
vividi	t
vividit	iy
vividiti	e
vividitie	s
vividl	y
vividn	e
vividne	s
vividnes	s
vividness	e
vividnesse	s
vivif	iy
vivifi	c
vivific	a
vivifica	t
vivificat	i
vivificati	o
vivificatio	n
vivip	a
vivipa	r
vivipar	ioy
vivipari	st
viviparis	m
viviparism	s
viviparit	y
viviparo	u
viviparou	s
viviparous	ln
viviparousl	y
viviparousn	e
viviparousne	s
viviparousnes	s
viviparousness	e
viviparousnesse	s
vivis	e
vivise	c
vivisec	t
vivisect	i
vivisecti	ov
vivisectio	n
vivisection	ais
vivisectiona	l
vivisectional	l
vivisectionall	y
vivisectioni	s
vivisectionis	t
vivisectionist	s
vivisectiv	e
vix	e
vixe	n
vixen	ils
vixeni	s
vixenis	h
vixenish	n
vixenishn	e
vixenishne	s
vixenishnes	s
vixenl	y
viz	i
vizi	e
vizie	r
vj	abcegjmnoqtu
vja	b
vjc	br
vje	g
vjj	v
vjm	b
vjn	fsvy
vjo	u
vjq	u
vjt	b
vju	rv
vk	beilnv
vkb	v
vke	b
vkl	v
vl	acelnorstuvwxz
vla	dnv
vlad	i
vladi	mv
vladim	i
vladimi	r
vladiv	o
vladivo	s
vladivos	t
vladivost	o
vladivosto	k
vle	s
vles	s
vll	bm
vln	n
vlo	egkmo
vlog	g
vlogg	e
vlogge	r
vloo	k
vlook	u
vlooku	p
vlr	n
vls	i
vlt	r
vlu	l
vlx	u
vlxu	v
vlz	r
vm	abcdegijlnpqrtuwxy
vmb	b
vmc	s
vme	s
vmes	s
vmg	v
vmi	itz
vmj	s
vmp	rv
vmr	v
vmt	b
vmu	v
vmw	a
vmwa	r
vmwar	e
vmware	f
vmwaref	u
vmwarefu	s
vmwarefus	i
vmwarefusi	o
vmwarefusio	n
vmwarefusion	p
vmwarefusionp	lr
vmwarefusionpl	a
vmwarefusionpla	y
vmwarefusionplay	e
vmwarefusionplaye	r
vmwarefusionpr	o
vn	abcefhiklnoprsvwy
vna	e
vnb	fkorv
vnc	blqv
vne	c
vnec	k
vnf	lv
vnfl	v
vnh	t
vnk	bv
vnl	cirtv
vno	cklv
vnol	v
vnp	bt
vnr	rsv
vns	b
vnw	u
vny	ov
vo	abcdgijklmnorstuvwxy
vob	fs
voc	aio
voca	blt
vocab	lu
vocabl	e
vocabu	l
vocabul	aei
vocabula	r
vocabular	iy
vocabulari	aez
vocabularia	n
vocabularie	ds
vocabulariz	e
vocabule	r
vocabuli	s
vocabulis	t
vocal	ilnos
vocali	cstz
vocalis	eimt
vocalise	ds
vocalisi	n
vocalisin	g
vocalist	is
vocalisti	c
vocalit	iy
vocaliti	e
vocalitie	s
vocaliz	aei
vocaliza	t
vocalizat	i
vocalizati	o
vocalizatio	n
vocalization	s
vocalize	drs
vocalizer	s
vocalizi	n
vocalizin	g
vocall	y
vocaln	e
vocalne	s
vocalnes	s
vocalness	e
vocalnesse	s
vocalo	i
vocaloi	d
vocat	i
vocati	ov
vocatio	n
vocation	als
vocationa	l
vocational	l
vocationall	y
vocationl	e
vocationle	s
vocationles	s
vocativ	e
vocative	ls
vocativel	y
voci	f
vocif	e
vocife	r
vocifer	ao
vocifera	nt
vociferan	t
vociferat	ei
vociferati	o
vociferatio	n
vocifero	su
vociferos	i
vociferosi	t
vociferosit	y
vociferou	s
vociferous	ln
vociferousl	y
vociferousn	e
vociferousne	s
vociferousnes	s
vociferousness	e
vociferousnesse	s
voco	d
vocod	e
vocode	r
vod	ak
voda	f
vodaf	o
vodafo	n
vodafon	e
vodk	a
vodka	s
vog	aeu
voga	d
voge	l
vogu	ei
vogue	dirs
voguei	n
voguein	g
voguer	s
vogui	ns
voguin	g
voguis	h
voi	cdlp
voic	ei
voice	dlmoprs
voicel	e
voicele	s
voiceles	s
voicem	a
voicema	i
voicemai	l
voiceo	v
voiceov	e
voiceove	r
voicep	r
voicepr	i
voicepri	n
voiceprin	t
voicer	s
voici	n
voicin	g
void	aeilns
voida	bn
voidab	l
voidabl	e
voidan	c
voidanc	e
voide	drs
voider	s
voides	t
voidi	n
voidin	g
voidl	ey
voidle	s
voidles	s
voidn	e
voidne	s
voidnes	s
voidness	e
voidnesse	s
voil	e
voj	psv
vojs	v
vol	abceiklstuv
vola	nrt
volan	t
volat	i
volati	l
volatil	ei
volatile	ns
volatilen	e
volatilene	s
volatilenes	s
volatileness	e
volatilenesse	s
volatili	stz
volatilis	e
volatilit	iy
volatiliti	e
volatilitie	s
volatiliz	ae
volatiliza	t
volatilizat	i
volatilizati	o
volatilizatio	n
volc	a
volca	n
volcan	io
volcani	cs
volcanic	a
volcanica	l
volcanical	l
volcanicall	y
volcanis	m
volcano	els
volcanoe	s
volcanol	o
volcanolo	g
volcanolog	y
vole	s
voli	t
volit	ai
volita	n
volitan	t
voliti	ov
volitio	n
volition	als
volitiona	l
volitionl	e
volitionle	s
volitionles	s
volitiv	e
volk	s
volks	w
volksw	a
volkswa	g
volkswag	e
volkswage	n
volkswagen	s
voll	ei
volle	y
volley	beis
volleyb	a
volleyba	l
volleybal	l
volleyball	es
volleyballe	r
volleye	dr
volleyer	s
volleyi	n
volleyin	g
volli	e
vollie	s
vols	ct
volsc	a
volsca	n
volst	e
volste	a
volstea	d
volt	aems
volta	gi
voltag	e
voltage	s
voltai	cr
voltair	e
volte	r
volter	r
volterr	a
voltm	e
voltme	t
voltmet	e
voltmete	r
voltmeter	s
volu	bmnpt
volub	il
volubi	l
volubil	i
volubili	t
volubilit	y
volubl	e
volum	ei
volume	st
volumet	r
volumetr	i
volumetri	c
volumi	n
volumin	go
volumino	u
voluminou	s
voluminous	ln
voluminousl	y
voluminousn	e
voluminousne	s
voluminousnes	s
voluminousness	e
voluminousnesse	s
volun	t
volunt	ae
volunta	r
voluntar	iy
voluntari	elns
voluntarie	s
voluntaril	y
voluntarin	e
voluntarine	s
voluntarines	s
voluntariness	e
voluntarinesse	s
voluntaris	m
voluntary	i
voluntaryi	s
voluntaryis	m
volunte	e
voluntee	r
volunteer	eis
volunteere	d
volunteeri	n
volunteerin	g
volup	t
volupt	u
voluptu	ao
voluptua	r
voluptuar	y
voluptuo	u
voluptuou	s
volut	ei
voluti	o
volutio	n
volv	o
vom	dfhipsvw
vomi	t
vomit	eiosu
vomite	dr
vomiter	s
vomiti	nv
vomitin	g
vomitiv	e
vomito	ru
vomitor	y
vomitou	s
vomitous	l
vomitousl	y
vomitu	r
vomitur	i
vomituri	t
vomiturit	i
vomituriti	o
vomituritio	n
voms	rv
von	a
vona	g
vonag	e
voo	djt
vood	o
voodo	o
vor	at
vora	c
vorac	i
voraci	ot
voracio	u
voraciou	s
voracious	ln
voraciousl	y
voraciousn	e
voraciousne	s
voraciousnes	s
voraciousness	e
voraciousnesse	s
voracit	y
vort	ei
vorte	x
vortex	e
vortexe	s
vorti	c
vortic	ae
vortica	l
vortice	s
vos	s
vot	aei
vota	br
votab	l
votabl	e
votar	ey
votare	s
votares	s
vote	drs
voter	s
voti	nv
votin	g
votiv	e
vou	cg
vouc	h
vouch	eis
vouche	ders
voucher	aeis
vouchera	b
voucherab	l
voucherabl	e
vouchere	d
voucheri	n
voucherin	g
vouchi	n
vouchin	g
vouchs	a
vouchsa	f
vouchsaf	e
voug	h
vough	t
vow	eils
vowe	dlrs
vowel	is
voweli	sz
vowelis	at
vowelisa	t
vowelisat	i
vowelisati	o
vowelisatio	n
voweliz	ae
voweliza	t
vowelizat	i
vowelizati	o
vowelizatio	n
vower	s
vowes	s
vowi	fn
vowif	i
vowin	g
vowl	e
vowle	s
vowles	s
vox	ps
voxs	v
voy	aeu
voya	g
voyag	ei
voyage	drs
voyager	s
voyagi	n
voyagin	g
voyaging	s
voye	u
voyeu	r
voyeur	isw
voyeuri	s
voyeuris	mt
voyeurism	s
voyeurist	i
voyeuristi	c
voyeuristic	a
voyeuristica	l
voyeuristical	l
voyeuristicall	y
voyeurw	e
voyeurwe	b
voyu	e
voyue	r
vp	adfgklmnoqstuvx
vpa	dv
vpd	rv
vpf	bdvw
vpl	v
vpm	r
vpn	d
vpo	bt
vpob	v
vpq	g
vpx	v
vq	bejnortu
vqb	v
vqj	q
vqn	rv
vqo	c
vqr	j
vqu	c
vr	abdefijlmnoprstvxyz
vra	mo
vrd	d
vre	be
vree	l
vreel	a
vreela	n
vreelan	d
vrf	abdev
vri	rsv
vrm	s
vrn	bc
vrnb	v
vro	dkr
vrok	v
vrr	r
vrs	s
vrt	b
vrv	f
vry	t
vs	abcdefijlmnopqrstuwx
vsa	fv
vsaf	e
vsc	o
vsco	d
vscod	e
vsd	bfv
vsf	s
vsi	w
vsl	rsv
vsm	r
vsn	befpqv
vsne	t
vsnf	v
vso	s
vsp	fhwz
vsq	j
vsqj	v
vsr	bh
vst	bv
vsu	v
vsw	v
vt	abdlmnopstux
vtb	u
vtl	y
vtm	b
vtn	brv
vtnr	v
vtt	s
vtu	b
vtub	e
vtube	r
vtx	h
vu	adefijlmrtuxy
vud	m
vudm	v
vue	pv
vuep	r
vuepr	e
vuepre	s
vuepres	s
vul	cgnptv
vulc	a
vulca	n
vulcan	i
vulcani	stz
vulcanis	emt
vulcanise	d
vulcanit	e
vulcaniz	ae
vulcaniza	t
vulcanizat	i
vulcanizati	o
vulcanizatio	n
vulcanize	d
vulg	au
vulga	rt
vulgar	eilns
vulgare	rs
vulgares	t
vulgari	astz
vulgaria	n
vulgaris	em
vulgarit	y
vulgariz	ae
vulgariza	t
vulgarizat	i
vulgarizati	o
vulgarizatio	n
vulgarl	y
vulgarn	e
vulgarne	s
vulgarnes	s
vulgarness	e
vulgarnesse	s
vulgat	e
vulgu	s
vuln	e
vulne	r
vulner	a
vulnera	b
vulnerab	il
vulnerabi	l
vulnerabil	i
vulnerabili	t
vulnerabilit	iy
vulnerabiliti	e
vulnerabilitie	s
vulnerabl	ey
vulnerable	n
vulnerablen	e
vulnerablene	s
vulnerablenes	s
vulnerableness	e
vulnerablenesse	s
vulp	i
vulpi	n
vulpin	e
vult	ru
vultu	r
vultur	ei
vulture	ls
vulturel	i
vultureli	k
vulturelik	e
vulturi	n
vulturin	e
vulv	a
vum	v
vut	r
vuu	fmtu
vuum	v
vux	v
vv	acdeijnostuvx
vvd	p
vve	v
vvo	v
vvs	br
vvv	tv
vw	abdjnosuw
vwn	v
vwo	s
vwu	u
vwuu	v
vww	b
vx	efiklrsuvx
vxi	uz
vxu	p
vxv	ir
vxx	v
vy	befikmoprsuvxyz
vyb	apz
vyf	b
vyi	n
vyin	g
vyk	a
vyo	bktv
vyp	d
vypd	v
vyr	apz
vys	rv
vyy	pr
vz	floruwz
vzf	e
vzr	v
vzu	v
