w	abcdefghijklmnopqrstuvwxyz
wa	abcdefijklmnopqrstuvxy
waa	rv
wab	cdox
wac	p
wad	bcdkovx
wadb	v
wadk	rv
wado	v
wae	rv
waf	v
waj	aqvw
wak	mpvz
wal	rv
wam	v
wan	rv
wao	bemprv
wap	v
waq	defhioq
was	p
wat	pruvy
wau	r
wax	uvx
waxu	v
waxx	v
way	ho
wayo	v
wb	abcdefghijklmnopqrstuvwxyz
wba	v
wbb	behou
wbc	b
wbd	frv
wbe	adefhruvw
wbed	v
wbef	v
wbew	v
wbg	nor
wbh	aikpuvy
wbi	bfrsv
wbk	bdfinrsuvwx
wbku	rv
wbn	prsvw
wbo	drsv
wbor	v
wbp	ds
wbq	dp
wbr	i
wbs	v
wbt	m
wbu	efv
wbv	v
wbw	f
wbwf	v
wbx	aew
wby	o
wc	acdefghijklmnoprstuwyz
wca	frsv
wcc	h
wcd	j
wce	bequw
wcew	rv
wcf	y
wcg	b
wch	v
wci	bv
wcj	o
wck	gruvy
wcl	em
wcm	rv
wcn	rv
wco	glrv
wcr	su
wcs	tv
wct	rv
wcu	ah
wcuh	v
wcw	cs
wcy	d
wcz	z
wd	abcdefghijklnopqrstuvwxyz
wda	hmtvz
wdb	mst
wdc	r
wdd	qr
wddq	v
wde	adefmrvz
wdea	v
wdef	v
wdf	efruv
wdg	nv
wdi	l
wdj	r
wdl	brstv
wdn	fl
wdnf	v
wdo	frsv
wdq	l
wdr	kw
wds	r
wdt	o
wdu	abdkox
wdub	v
wduk	v
wdv	fmv
wdvf	v
wdw	bft
wdx	vx
wdy	adrv
we	abcdefghijklmnopqrstuvwxyz
wea	bvyz
web	eo
wed	befhoq
wee	bcdfjmopqrsvw
weec	v
weem	v
weep	v
weev	v
wef	adflqrv
weg	ruv
wei	ahv
wek	aprsv
wel	fvy
wem	rv
wen	rsuvy
wenu	v
weo	clqrtv
wep	qrv
weq	adehnv
wer	pq
wes	i
wet	r
weu	duv
wev	v
wew	dfuvy
wewd	v
wewf	rv
wex	fv
wez	fv
wf	abdefhijklmnopqrstuvxy
wfa	drsv
wfad	v
wfb	buv
wfd	cflsv
wfdc	rsv
wfdf	v
wfdl	v
wfe	akltu
wfeu	v
wff	acdfklostvw
wffa	v
wffc	v
wffd	v
wfff	v
wfft	v
wfk	aoruv
wfl	borv
wfn	cdhnqw
wfnc	v
wfnd	v
wfnh	v
wfnn	v
wfo	aclorvz
wfp	bv
wfq	v
wfr	u
wfs	uv
wft	v
wfu	az
wfua	v
wfuz	v
wfv	avz
wfvz	v
wfx	o
wfy	dgv
wg	aefijklnoqrtuwxy
wgf	s
wgi	uv
wgj	rvy
wgk	f
wgl	v
wgn	afhrv
wgnf	v
wgo	rv
wgr	y
wh	abcdefgijlmnoprsuvxy
wha	rv
whb	w
whd	s
whe	rv
whf	rsv
whg	o
whi	v
whl	o
whm	b
whmb	v
whn	celp
whnl	v
who	v
whp	v
whr	bertv
whs	ruv
whu	celv
whx	o
why	u
wi	acefghjnqrstuvwx
wig	u
win	f
wiq	kx
wir	p
wirp	v
wis	qt
wit	b
wiw	u
wix	v
wj	abcdegjklmnopqruvxy
wja	beot
wjao	v
wjb	deg
wjc	bikprst
wjcb	v
wjd	deguz
wje	dgrv
wjg	n
wjj	rv
wjk	v
wjm	belv
wjn	dgrsvyz
wjns	v
wjny	v
wjo	u
wjq	abhsu
wjqh	v
wjqs	v
wjr	bs
wju	v
wjv	z
wjx	b
wjy	d
wk	abehijklmnortvwxyz
wka	rsv
wkb	klsu
wke	brsv
wkk	cdhltx
wkl	brsv
wkn	v
wkr	l
wkx	rv
wkz	v
wl	abdefghiklmnopqrstuvwxyz
wla	rv
wlb	fkr
wlbf	v
wlbk	v
wld	bhjkrv
wle	oqw
wleo	v
wlf	dkqtv
wlfq	v
wlh	bopqrtz
wlhz	rv
wli	l
wlk	uv
wll	bv
wlm	btvw
wln	fnoqrstv
wlno	rv
wlo	bdehkmopqrstvwz
wlok	v
wlor	v
wlos	v
wloz	v
wlp	fqsu
wlps	v
wlq	lprsvy
wlr	bkruv
wlru	v
wls	rv
wlt	krs
wlu	klrv
wluk	v
wlul	v
wlv	v
wlw	hqvw
wlx	puv
wly	y
wlz	bpv
wm	abcdefgijklmnopqrstvwx
wma	d
wmb	efgikmqr
wmc	s
wmcs	rv
wmd	v
wmg	o
wmgo	v
wmi	iptuvz
wmip	v
wmiz	v
wmj	s
wmjs	v
wmm	v
wmn	orv
wmo	jrsv
wmp	w
wmq	b
wmr	frsv
wmt	rv
wmv	v
wn	abcdefghijklmnoprstuvwxyz
wna	dmrv
wnb	dgioprstvy
wnbg	v
wnbi	v
wnbo	rv
wnc	bpqrv
wncb	v
wnd	ls
wne	beoruvz
wnez	v
wnf	bfhlrsuvw
wng	fv
wnh	ehpqt
wni	irv
wnj	z
wnk	be
wnkb	v
wnl	impv
wnm	hqv
wnn	drv
wno	ablrv
wnp	b
wnpb	v
wnr	dgiopqrstuvy
wnrg	v
wnri	v
wnro	v
wns	bv
wnsb	v
wnt	brv
wnu	frv
wnw	u
wnx	u
wnxu	v
wny	o
wo	abcdefghjklmnopqrstuvwxz
woa	er
wob	fv
wobf	rv
woc	l
woe	dq
wof	u
wog	n
woj	o
wok	dvy
wol	b
wom	b
won	b
woo	efjkrstvw
wop	v
woq	v
wor	qv
wos	abcfghjkmoqstuvwxyz
wosa	rsv
wosb	rv
wosc	rv
wosj	rv
wosq	rv
wost	rv
wosx	v
wosy	v
wou	efu
wow	sv
wox	dv
woz	o
wp	abcdefgijlmnoqrstuvwxyz
wpa	dmrvz
wpb	n
wpc	u
wpd	abfhjknoptuvw
wpdj	v
wpdk	rv
wpe	sv
wpf	bdkqrsvw
wpfb	v
wpfk	v
wpfq	rsv
wpg	v
wpi	hptuv
wpj	rv
wpl	orv
wpm	dr
wpn	dk
wpo	bhkt
wpob	v
wpq	gu
wpr	u
wps	v
wpw	l
wpx	rv
wpz	w
wq	abdefhjkmnoqrstuvwxy
wqa	bdv
wqb	bprsv
wqd	o
wqe	krv
wqer	v
wqf	y
wqh	v
wqj	qrv
wqjq	v
wqk	v
wqm	m
wqn	bdsu
wqnd	v
wqo	cfrsvw
wqq	y
wqr	bjpqv
wqrj	v
wqu	crsv
wqv	rv
wqy	d
wqyd	v
wr	abcdefijklmnopqrstuvwxyz
wra	forv
wrao	v
wrb	ablprv
wrc	frsvw
wrd	dnorv
wre	bhnv
wrf	abderv
wrfa	v
wrfb	v
wrfv	v
wri	bflrsvw
wrj	qv
wrjq	v
wrk	rv
wrl	fq
wrm	rsv
wrn	abdefhqtuv
wrnh	v
wrnt	v
wro	bcdfklrv
wroc	v
wrod	rv
wrof	v
wrp	q
wrq	bu
wrr	befjqrsv
wrrf	rv
wrrq	v
wrrs	v
wrs	ersv
wrt	bo
wru	fpv
wrv	foru
wrw	huw
wrx	orsv
wry	f
ws	abeghijklmnopqrstuvwz
wsb	b
wse	qr
wsg	v
wsi	qtv
wsj	v
wsl	ko
wsm	b
wsn	fmnopqrsy
wsnn	v
wsnr	v
wso	v
wsq	t
wsr	abd
wst	rv
wsu	fv
wsv	v
wt	abdehijklmnopqrstuvwxy
wta	v
wtb	uw
wtd	epv
wtj	v
wtl	y
wtm	bprv
wtn	dhqrvy
wtnd	v
wtnh	v
wtnr	rv
wto	ho
wtp	d
wtq	dhx
wtr	ps
wtrp	v
wts	a
wtsa	v
wtt	adkstuyz
wttz	v
wtu	p
wtw	m
wtx	v
wty	y
wu	abcdefijmnopqrstuvwxyz
wua	cprstv
wub	ackp
wuc	jl
wud	mt
wudm	v
wue	d
wuf	dorv
wufd	v
wui	cflrsvw
wuj	v
wum	v
wun	euv
wuo	bv
wur	bprsuv
wus	h
wut	bemrtv
wutb	v
wuu	muv
wuum	v
wuv	drv
wuw	u
wux	rv
wuz	fh
wv	abdefijlmnostuvxz
wva	v
wvd	dm
wve	v
wvf	fv
wvj	rv
wvm	r
wvn	k
wvo	jmsvxy
wvs	biprtv
wvsb	v
wvx	v
ww	abdefhjlmnopruvwx
wwa	bq
wwb	u
wwd	v
wwe	cfkrsv
wwf	ck
wwh	v
wwj	v
wwl	s
wwm	b
wwn	frsvw
wwo	orsv
wwp	t
wwr	bv
wwu	uv
www	cv
wx	abdefijklnopqux
wxb	d
wxe	v
wxi	z
wxl	v
wxn	v
wxo	v
wxu	frsv
wxx	npuv
wy	abdefjmnoprsuvwxyz
wya	v
wyb	fgpwy
wyd	am
wye	orsv
wyf	bpq
wyfb	rv
wym	rv
wyn	dru
wynu	rv
wyo	akmv
wyp	dfkpz
wyr	py
wys	rv
wyu	f
wyw	f
wyx	v
wyy	arvy
wyya	v
wyz	u
wz	abcdefhijmnopqrsvwxz
wza	sv
wzb	b
wzc	em
wzd	jp
wze	qv
wzh	v
wzj	rv
wzm	b
wzn	m
wzo	adfhx
wzq	fh
wzr	fmv
wzs	btv
wzx	v
wzz	z
