y	abcdefghijklmnopqrstuvwxyz
ya	abdefijlmnopqtuvwxy
yaa	v
yad	k
yae	v
yaj	q
yal	rv
yan	v
yao	q
yaq	efnosy
yau	r
yax	ux
yay	hv
yb	abdefghijknopqruy
yba	v
ybb	ou
ybd	v
ybe	af
ybea	v
ybf	u
ybg	abcfghiksuwxyz
ybgf	rv
ybgh	v
ybgw	v
ybh	ow
ybhw	v
ybi	v
ybk	o
ybn	lpy
ybo	v
ybp	d
ybq	d
ybqd	v
ybu	e
yby	dfhtwyz
ybyd	rv
ybyf	rsv
yc	bcdefmnoprstuvwy
ycb	k
ycd	j
yce	bequw
ycn	v
yco	l
ycp	v
ycr	adeghiorsuw
ycra	v
ycrd	v
ycro	v
ycru	v
ycs	v
ycu	a
ycw	s
yd	abcdefgijklmnopqrtuvxyz
ydc	a
ydd	oq
yde	emrvz
ydf	fuv
ydg	v
ydi	l
ydj	bcdghkmouy
ydm	crw
ydn	lm
ydo	efhilouv
ydoo	v
ydq	l
ydr	ku
ydt	o
ydu	t
ydv	m
ydx	x
ydy	a
ydz	u
ydzu	v
ye	adefgijlnopqrtuvwz
yea	vy
yed	e
yee	rsv
yef	f
yej	rv
yel	g
yen	nu
yenn	v
yeo	qrtz
yep	v
yeq	e
yer	u
yeu	u
yev	v
yez	f
yf	abcdefhilmnopstvxyz
yfa	v
yfb	ruv
yfbu	v
yfd	cgl
yfe	dz
yff	qrsv
yfl	fo
yfm	bpr
yfmb	v
yfn	cdlnq
yfnc	v
yfo	ouv
yfoo	v
yfp	abcdefghioruvwx
yfpc	v
yfpf	rsv
yfs	u
yft	b
yfx	v
yfy	dfgv
yfz	b
yg	aefjklnoqrxy
yga	v
ygf	s
ygj	y
ygk	w
ygn	ov
ygno	v
ygo	rv
ygq	f
yh	adejlmosux
yha	rsv
yhd	e
yhj	rv
yhm	r
yi	ijnoqsvz
yiq	i
yis	q
yiz	g
yj	abdefjlmnqrvx
yjb	v
yjd	z
yjf	k
yjfk	v
yjm	bel
yjmb	v
yjn	rv
yjq	asu
yjqs	v
yjr	b
yjv	z
yjx	b
yk	abdeilorv
yka	dfrsv
ykb	dl
ykl	bdr
ykr	dl
yl	bdefhjklnopqruyz
yld	jrv
yle	oq
ylf	ko
ylh	bopqz
ylhz	v
ylj	k
yljk	v
ylk	w
yll	v
yln	foq
ylno	rv
ylo	behkmopqrvz
ylp	s
ylq	y
ylr	bf
ylu	lv
yly	y
ylz	bp
ym	abdegimnpqrvxy
ymb	v
ymd	g
yme	bv
ymi	it
ymm	r
ymn	g
ymy	m
yn	abcdefghijklmnopqrstvw
yna	ev
ynb	adeiotv
ynbo	v
ync	apu
ynd	fhlp
yndl	v
yne	acehloqruvxz
ynee	rv
yneq	v
yneu	bcfklrsvw
ynf	eflrsvw
ynfe	v
yng	rv
ynh	u
ynhu	v
ynk	u
ynl	cpt
ynm	u
ynmu	v
ynn	u
ynnu	v
yno	flrsuv
ynou	v
ynq	u
ynqu	v
ynr	acdefhioqrstuvw
ynrh	v
ynru	rv
yns	u
ynt	u
yo	bdeijklmnopqrtuvwxy
yob	abcefghiklmouwy
yobe	v
yobf	rv
yobh	v
yobm	v
yobo	frsv
yobu	v
yoe	e
yoj	o
yok	rvw
yokw	v
yom	b
yon	bfp
yoo	jkp
yor	efhilou
yoro	rsv
yot	b
you	v
yox	rv
yoy	o
yoyo	v
yp	abdefgijklmnopqruxz
ypa	bdefkrv
ypad	v
ypaf	v
ypb	jw
ypd	befkopruz
ypdb	v
ypdf	v
ypdk	v
ypdr	v
ypf	dmoprsvw
ypfd	v
ypj	v
ypk	o
ypn	do
ypno	v
ypo	btv
ypp	v
ypq	gu
ypr	u
ypu	v
ypx	rv
ypz	pw
yq	abefinotvw
yqa	v
yqb	r
yqn	u
yqo	v
yr	abcdefghjklnoprstuvwxy
yra	o
yrb	bfhlpu
yrc	rv
yrd	d
yre	be
yrf	s
yrj	q
yrl	v
yrn	v
yro	v
yrp	f
yrr	j
yrs	itw
yrsw	v
yrt	brv
yrtb	v
yrv	f
yrw	f
yrx	v
yry	dfhtwyz
yryd	rv
yryf	frsv
ys	aeinoptv
ysa	b
yse	r
ysi	q
ysn	oqv
yso	f
ysp	dglmoqswxz
yt	aijmnoqux
yta	v
ytm	b
ytn	dqrv
yto	h
ytq	x
yu	abdfijkmoprtuvx
yua	v
yub	p
yud	blmnrv
yuk	w
yuo	f
yup	uv
yur	pruv
yut	r
yuu	m
yuv	d
yv	adefjnoqz
yva	v
yvd	m
yve	rv
yvf	f
yvo	f
yvof	v
yw	dfnoux
ywd	t
ywf	b
ywn	rsuv
ywo	o
ywx	v
yx	aeijklnouvx
yxi	u
yxo	v
yxu	p
yy	abcdehiloprsvwxyz
yya	cnpsvy
yyan	v
yyb	pw
yyc	a
yye	rv
yyi	aefuv
yyl	d
yyo	clo
yyp	d
yyr	pv
yyx	v
yyy	aberstvw
yyyr	v
yyz	u
yz	abcdefghijklmnopqrstuvwxyz
yza	fhiprvy
yzb	eimoy
yzc	cmvw
yzd	egorvz
yze	eqruvw
yzee	v
yzf	el
yzg	orsv
yzgo	v
yzh	v
yzi	v
yzj	rsv
yzjs	v
yzk	v
yzl	kt
yzm	bf
yzmf	v
yzn	befmorsv
yzne	v
yzns	v
yzo	fltxz
yzq	bfv
yzr	bdiotuv
yzrb	v
yzs	bnorsuv
yzsb	v
yzt	s
yzv	fs
yzvs	rv
yzx	frsv
yzy	or
yzz	jo
