z	abcdefghijklmnopqrstuvwxyz
za	acdefgjklnopqstvy
zaa	q
zac	w
zad	kop
zadk	v
zado	v
zaf	v
zag	q
zaj	f
zak	p
zal	v
zan	v
zao	bimprt
zaob	v
zap	rv
zaq	benoqrsty
zaqs	v
zas	e
zat	rsv
zay	hov
zb	abehiklnopqtux
zba	t
zbb	eh
zbe	fr
zbh	iv
zbi	v
zbk	i
zbki	v
zbl	v
zbn	p
zbq	j
zbt	m
zbu	v
zc	abcdeijlmoprtuxy
zca	rv
zcb	gk
zcbg	v
zcbk	v
zcd	j
zce	bqw
zci	v
zcj	goq
zcl	v
zcm	v
zcp	gkorv
zcpg	v
zcpk	v
zcr	s
zcu	aemx
zcy	w
zd	abegijkmoprstuxy
zda	q
zdb	s
zde	v
zdj	fw
zdk	f
zdm	r
zdo	v
zdp	v
zdr	k
zdu	cop
zdx	rv
zdy	rv
ze	adefhijmnoqrstuvwxz
zee	rsv
zeev	v
zef	f
zeh	v
zei	v
zej	rv
zem	r
zen	n
zeo	dtuw
zeq	drvw
zeqw	v
zer	m
zes	hw
zet	r
zex	v
zez	frv
zf	abcdefgiklmnopqrstuvwxy
zfa	abnrv
zfb	b
zfc	b
zfe	bfiqrsv
zfeq	rv
zff	de
zfg	v
zfk	ab
zfl	bov
zfm	brv
zfmb	v
zfn	bdfn
zfo	clorvz
zfp	r
zfq	iu
zfr	s
zfrs	v
zfs	v
zfu	afxz
zfua	v
zfuz	v
zfv	abdz
zfw	k
zg	acegijnoquxy
zga	v
zgi	uv
zgj	y
zgn	orsv
zgo	rv
zgq	v
zgu	v
zgy	v
zh	acfijmopru
zha	v
zhc	c
zhj	v
zhm	b
zhmb	v
zho	v
zi	befgmpqrz
zie	v
zig	u
zim	b
ziq	v
zir	aht
ziz	ht
zj	abcdefgijnopqruvwz
zja	abe
zjb	g
zjc	bcil
zjd	gqv
zje	qz
zjf	gny
zji	a
zjj	rvy
zjn	frsy
zjo	quv
zjoq	v
zjp	g
zjq	a
zjr	d
zk	abejkorwx
zka	v
zkb	kpy
zkj	rv
zkk	d
zkw	v
zl	abdehiklnopqruvwxz
zla	rv
zlb	f
zld	k
zle	o
zlh	oq
zli	l
zlk	k
zll	b
zln	foqv
zlnf	rv
zlo	boq
zlp	qs
zlq	lv
zlr	dkuv
zlu	l
zlx	uv
zlz	r
zm	abcdefgijlmnprsuw
zmb	grvw
zmc	s
zmd	akprsuvw
zmdu	v
zme	v
zmg	pv
zmi	ehipstz
zmiz	v
zmj	s
zml	v
zmm	ru
zmr	rv
zmu	v
zn	bcdefjlmorstuvwy
znb	bimruvy
znbb	v
znbi	v
znby	v
znc	p
znd	z
zne	emopuvy
znee	v
zney	v
znf	rv
znj	y
znl	iv
znm	pv
zno	al
znol	v
znr	iprsu
znv	v
znw	y
zny	m
zo	abdefghijklmopqrtuvwxz
zoa	eqr
zoaq	v
zob	b
zod	rv
zoe	d
zoed	v
zof	orvw
zog	fn
zogn	v
zoh	v
zoj	o
zok	bdf
zol	b
zom	br
zoo	j
zop	ov
zor	q
zot	b
zou	t
zox	abcfikopqtuy
zoxf	v
zoxo	v
zoz	ou
zp	abcdfghijlmnopqrstuvxz
zpa	qx
zpb	ln
zpd	knorv
zpdk	v
zpf	dw
zph	u
zpi	pt
zpm	w
zpo	bv
zpp	g
zpq	g
zpr	av
zps	hvw
zpt	vx
zpv	f
zpz	w
zq	abdefhijmnoprux
zqa	dv
zqb	b
zqe	r
zqf	bft
zqh	d
zqi	pv
zqj	qv
zqm	m
zqn	d
zqo	rvw
zqr	jq
zr	abcefgiklmnoprsuvxz
zra	qrv
zrb	b
zrc	d
zre	bn
zrf	dv
zri	v
zrm	r
zrn	mq
zro	drv
zrp	f
zrs	w
zru	acfghknostv
zruc	v
zrv	fu
zrvf	v
zrvu	v
zrx	o
zrz	br
zs	aeglmnopqrtuw
zsn	aq
zsnq	v
zso	rsvw
zsp	v
zsq	j
zsr	b
zst	bgv
zsu	rv
zt	adefjkmnopqstvx
zta	v
ztd	q
zte	v
ztf	n
ztk	b
ztm	b
ztmb	v
ztn	q
zto	qv
ztq	x
ztt	m
zu	abcdefgijklmnopqrstuvwxyz
zua	pt
zub	frsw
zuc	p
zud	kmo
zudo	v
zue	v
zuf	dk
zug	r
zui	rvx
zuj	b
zul	mx
zum	v
zun	celo
zuo	bkrstvz
zup	gu
zupu	v
zuq	ux
zur	duv
zut	rsz
zuu	mo
zuv	fvz
zuw	mo
zux	v
zuz	f
zv	defjorsuv
zve	k
zvf	v
zvr	k
zvs	bi
zvv	u
zw	abdehilmnoprsuwx
zwa	a
zwb	o
zwd	imty
zwe	fv
zwi	a
zwl	s
zwm	q
zwn	rv
zwo	o
zwp	dv
zwr	b
zws	r
zwu	ouv
zww	k
zx	acjknpruvwx
zxc	c
zxu	p
zxv	n
zy	adenopuy
zya	v
zye	no
zyn	br
zyo	p
zyp	d
zyu	f
zyy	a
zyya	v
zz	aefgjnoqrwxz
zze	wz
zzf	b
zzj	rv
zzq	df
zzqf	v
zzr	bv
zzz	dv
