八	捌 巴 疤 芭 笆 粑 叭 扒 豝 吧 仈 朳
拔	跋 钹 魃 茇 鼥 𫐈 犮 菝 胈 詙
把	靶 钯
罢	爸 霸 坝 耙 弝 灞 伯 猈
吧	罢 琶 杷
玻	拨 剥 菠 钵 嶓 砵 碆 袚 袯 鱍 啵 柭 𫏆 岥
伯	博 柏 泊 勃 搏 渤 驳 薄 脖 帛 舶 箔 荸 卜 膊 钹 饽 铂 欂 鹁 踣 浡 襮 踄 镈 駮 僰 馎 髆 桲 謈 檗 馞 胉 挬 猼 葧 鋍 懪 簙 礡 鑮 郣 鸔 糪
跛	簸 蚾
播	擘 簸 亳 薜 譒 薄 檗 蘗 繴 挀
百	摆 佰 摆 粨 捭 矲 絔
败	拜 呗 粺 椑 矲 庍
背	杯 悲 卑 碑 俾 揹 偝 杯 裨 萆 桮 椑 伓 綼 鹎 藣
被	备 背 贝 辈 倍 臂 狈 惫 悖 孛 焙 蓓 褙 邶 琲 誖 钡 哱 糒 𪱷 𫞥 鄁 牬 郥 犕 奰 俻 偹 僃 坝 昁 紴 蛽 鞴 備 憊 愂 狽 瞶 貝 軰 輩 鋇 鱫
包	胞 苞 褒 枹 笣 蕔 孢
雹	窇 瓝
保	宝 饱 堡 褓 葆 鸨 怉 駂 鳵 媬
报	抱 暴 爆 豹 鲍 刨 趵 铇 虣 鑤 儤 菢 煲 袌 嚗 犦 忁
班	般 搬 斑 颁 扳 瘢 虨 斒 攽 褩
板	版 板 阪 舨 昄 钣 粄 蝂
半	办 伴 扮 拌 绊 姅 瓣 爿 怑 湴 鉡 靽
奔	贲 锛 泍 渀
本	畚 苯
笨	體 坌
帮	邦 傍 梆 鞤 𫄰 垹
榜	绑 牓 膀 氆
棒	磅 谤 蚌 傍 镑 旁 甏 塝 艕
崩	绷 伻 弸 祊 𨸂 塴 絣
菶	玤 琫 埲 誁
蹦	搒 洴 迸 跰
逼	屄 偪 稫 豍
憋	鳖 虌
别	蹩 咇 徶 襒 蟞
瘪	蛂
别	縪
标	彪 镳 镖 飙 膘 熛 麃 罴 嘌 杓 滮 瀌 猋 瘭 穮 飑 骉 摽 儦 臕 颩 髟 謤 墂 贆 蔈 爂 藨 𩙪 飇 飚 飊 飍 麅 幖 徱 標 矋 磦 脿 鏢 鑣 閊 颮 飆 驃
表	表 婊 裱 俵 褾 檦 諘
边	编 鞭 蝙 砭 笾 箯 稨 猵 甂 柉 楄 煸
扁	贬 匾 褊 窆 萹 惼 碥
便	变 遍 辨 辩 汴 辫 忭 弁 釆 抃 缏 艑 卞 揙 汳 鴘 𫔰
宾	滨 彬 槟 傧 斌 缤 豳 濒 邠 瑸 𧏖 镔 豩 汃 椕 霦 𪾸 驞
殡	鬓 傧 摈 膑 髌 鶣
兵	冰 掤 栟
饼	丙 禀 柄 秉 炳 昺 邴 怲 鞞 鉼 蛃 陃 苪 窉 屏 庰
并	病 并 並 摒 寎 𫛨 偋
比	笔 彼 鄙 匕 沘 秕 屄 蚍 妣 疕 滗 柀 朼 貏
必	敝 毕 壁 避 璧 闭 鄙 臂 币 弊 婢 毙 碧 泌 俾 蔽 庇 哔 愎 闢 弼 裨 陛 埤 箄 篦 畀 比 嬖 睥 贲 赑 襞 毖 荜 跸 髀 怭 庳 愊 楅 湢 狴 獘 筚 苾 薜 觱 诐 躄 邲 閟 柲 梐 珌 痺 𫗣 馝 駜 𫔇 𫜁 皕 堛 铋 痹 腷 骳 坒 滭 𤇹 疪 妼 鏎 鷝 柫 佖 蜌 𪪼 箅 蓖 鄪 罼 𫚑 襒 鵖 襣 驆 鼊 芘 粊 稗 嫳 獙 廦 鄨 縪 吡 夶 弻 煏 畁 睤 箆 聛 肶 袐 貱 閇 鞸 魓 嗶 朇 畢 斃 篳 蓽 慮 賁 蹕 軣 輌 鐴 鐾 鉍 閉 𫖒 饆 鲾
逋	晡 𫗦 峬 𬷕
补	捕 埔 哺 卜 鳪 獛
不	部 布 步 怖 布 簿 埠 钸 蔀 篰 捗 咘
趴	葩 啪 蚆 舥
爬	扒 琶 耙 杷 跁
怕	帕 帊 袙
波	泼 坡 陂 䥽 癹 翍
婆	鄱 皤 櫇
颇	剖 叵 笸
破	迫 魄 珀 泊 樸 粕 酦 岶 烞 蒪
拍	啪
排	牌 徘 俳 簰 棑
矲	俖
派	湃 鎃 蒎
胚	呸 壞 醅 柸 岯 垺 衃
培	赔 陪 裴 邳 碚 毰 陫 荖
琣	昢
配	佩 沛 珮 霈 帔 旆 𬇙 辔 姵 翇 伂
抛	脬
袍	咆 刨 匏 庖 麃 炰 龅 鞄 炮 瓟
泡	砲 炮 疱 奅 麭 髱
剖	吥
掊	裒 抔 捊
剖	瓿 棓 婄
潘	攀 眅
盘	磐 蟠 般 胖 槃 蹒 磻 踫 鞶 幋 縏 柈 瀊 蒰 媻 搫 跘
判	叛 盼 畔 拚 袢 泮 襻 𫟟 頄 溿 沜 牉 頖
喷	歕
盆	湓 葐
呠	翸 翉
乓	磅 滂
旁	庞 膀 螃 徬 蒡 厖 尨 雱 逄 庬 篣 舽
嗙	耪
砰	烹 抨 怦 漰 澎 匉 閛 恲 軯 駍 磞
朋	彭 澎 蓬 膨 硼 棚 鹏 篷 蟛 芃 淜 鬅 痭 錋 倗 輣 傰 韸 髼 憉 樥 鑝
捧	皏
碰	堋 掽 椪
批	披 匹 劈 霹 砒 被 丕 坯 壞 伾 狉 纰 秠 铍 鴄 怌 翍 釽 憵 銔 𬳵 髬 怶 抷 旇 炋 狓 磇 礕 秛 耚 豾 钚 鉟 噼 悂 紕 鈹
瞥	撇 氕
飘	漂 慓 螵 薸 僄 旚 翲 魒
瓢	嫖 淲
漂	莩 缥 瞟 殍 皫 摽 醥 犥 𫛽
票	漂 剽 骠 彯 篻 顠 蔈
篇	偏 扁 翩 萹 媥 貵 頨 鶣
便	胼 骈 谝 蹁 楩 骿
片	骗 遍
拼	姘 礗 涄
贫	濒 频 颦 嫔 嚬 𪾸
聘	牝
乒	娉 砯 頩 覮
平	瓶 凭 评 屏 苹 萍 坪 枰 泙 帡 洴 缾 𫐌 俜 玶 甹 蘋 郱 呯 竮 艵 蛢 冯 荓 蓱 炾 憑 凴 屛 幈 甁 箳 簈 胓 蚲 輧 鲆 馮 慿 評 鱰 鮃
皮	疲 脾 琵 枇 裨 啤 毗 埤 沘 貔 陂 罴 罢 纰 郫 陴 鼙 铍 膍 毘 阰 蚽 蜱 玭 笓 鈚 錍 魾 螷 犤 毞 猈 藣 蠯 壀 焷 篺 豼 朇 羆 螕 軣 輌 鈹 隦 騤 魮
否	匹 疋 痞 嚭 苤 仳 庀 圮 崥 諀
譬	辟 僻 媲 屁 闢 癖 甓 擗 澼 濞 淠 揊 潎 𬸯 髲 礔
扑	僕 铺 噗 撲 痡 醭 抪 瞨
仆	朴 葡 蒲 菩 樸 蹼 脯 濮 璞 匍 莆 蒱 襆 酺 钋 镤 𫐗 纀 墣
普	浦 埔 谱 圃 溥 烳 氆 镨 潽 誧
暴	铺 瀑 曝 舖
妈	吗 嬷
麻	痲 嘛 么 蟆 犘
马	蚂 码 玛 溤 吗 𨰾 鷌 唛
骂	祃 㐷 杩
嘛	吗 蟆
模	磨 摩 膜 糢 魔 摹 谟 蘑 劘 嫫 藦 髍
末	莫 默 漠 没 膜 寞 陌 殁 脉 沫 秣 茉 蓦 墨 貊 磨 瘼 靺 歾 馍 鄚 𬙊 霡 嚜 眽 瞙 藦 暯 枺 爅 妺 萬 銆 镆 貘 粖 蛨 袹 嗼 塻 慔 蟔 鬕 莈 𫌪 𫄲 唛
埋	霾 薶
买	𪡃 鷶
卖	麦 迈 脉 劢 蝐
没	煤 眉 枚 梅 媒 莓 黴 玫 霉 楣 湄 嵋 苺 禖 郿 堳 瑂 脢 𰾄 呅 腜 塺 徾 攗
美	每 镁 浼 媺 渼 媄 挴 燘
妹	媚 寐 昧 眛 魅 瑁 沬 袂 痗 韎 煝 蝞
毛	茅 矛 髦 锚 旄 蟊 芼 蝥 髳 媌 堥 罞 酕 嫹 鶜 枆 軞 渵
卯	昴 泖 茆
帽	冒 貌 贸 茂 瑁 懋 旄 耄 媢 楙 眊 瞀 芼 袤 毷 艒 萺 鄮
谋	眸 缪 牟 侔 蝥 鍪 蛑 麰 洠 𫓴 鴾 呣 哞
某	冇 踇
蛮	馒 瞒 蹒 漫 颟 谩 鳗 𫞩 悗 慲 槾 鬘 鬗
满	屘 矕
慢	漫 曼 蔓 幔 嫚 镘 缦 墁 熳 𬇕 僈 獌
门	们 扪 𣗊 钔 穈 菛 虋
闷	焖 懑
忙	芒 茫 盲 氓 尨 硭 邙 哤 奀 杗 盳 铓 娏 牻 痝 蛖 駹 蘉 鼆 笀
莽	蟒 漭 汒 庬 硥 茻 壾
蒙	盟 萌 蒙 朦 蒙 檬 懵 幪 甍 瞢 艨 虻 曚 甿 礞 氋 雺 莔 儚 蕄 𫑡 鄸 饛 鹲
猛	蜢 艋 锰 懵 蠓 蒙 瓾
梦	孟 霿 霥
咪	瞇
咩	乜 芈
灭	蔑 蔑 篾 蠛 幭 覕 搣 薎 懱 瀎 礣 鱴
苗	描 瞄 鱙
秒	渺 藐 邈 缈 杳 眇 淼 杪 篎
妙	庙 缪 玅
棉	绵 眠 媔 婂 蝒 櫋 矊 矏
免	勉 缅 冕 娩 腼 湎 沔 偭 眄 絻 丏 俛 愐 喕 𩾃
面	面
民	岷 玟 缗 痻 苠 忞 旻 鈱 旼 錉 罠 閺 怋 崏 暋
敏	悯 闵 闽 抿 泯 皿 湣 愍 黾 渑 笢 敃 刡 僶 𫂃 敯 𫞗
明	名 鸣 铭 螟 冥 瞑 暝 茗 酩 溟 蓂 鄍 洺 榠 嫇 覭 詺 熐
眳	姳 慏
命	暝
迷	弥 谜 弥 靡 糜 麋 縻 猕 蘼 冞 麛 醚 醾 檷 蘪 攠 𤦀 爢 麊 鸍
米	靡 弭 敉 眯 銤 渳 葞 蔝 濔 灖
密	蜜 祕 秘 觅 泌 汨 谧 宓 幂 塓 幦 鼏 羃 幎 漞 糸 峚 榓 滵 蔤 蠠 嘧
模	氁
母	亩 牡 姆 拇 牳 𬭁 姥 峔 砪
木	目 幕 牧 慕 墓 募 穆 睦 暮 沐 苜 鹜 楘 霂 钼 炑 坶 毣 蚞 幙 鞪 莯
发	伐 瞂
乏	伐 罚 阀 筏 砝 茷 疺 藅
法	发
法	珐
佛	坲
非	飞 菲 扉 啡 妃 绯 霏 馡 𬴂 鲱 騛 婓 裶
肥	淝 腓 萉 蜰
匪	翡 斐 蜚 诽 悱 菲 朏 棐 榧 篚 奜 餥
废	费 肺 沸 吠 痱 怫 疿 芾 屝 剕 狒 砩 濷 癈 昲 胇 俷 厞 𪰶 鼣 𪲮 蟦 镄
罘	芣 紑 剻
否	缶 殕 缹 𫛜
番	翻 蕃 繙 幡 帆 旛 籓 僠 嬏 轓 鱕
凡	烦 繁 帆 蕃 矾 藩 樊 蘩 璠 籵 墦 燔 膰 蠜 蹯 颿 笲 钒 瀿 𫔍 勫 橎 薠 羳 𬸪 杋 柉 瀪
反	返 魬
范	範 犯 泛 泛 饭 贩 泛 梵 畈 笵 鄤 奿 軓 𫐊 滼 嬔
分	纷 芬 氛 吩 棻 玢 酚 雰 昐 𫟴 砏 翂 衯 饙 梤 鳻
坟	焚 汾 枌 棼 蚡 豮 鼖 𪩸 𣸣 轒 鼢 妢 炃 羒 蒶 黂 弅 蕡 𫔁
粉	黺
份	忿 奋 愤 分 粪 偾 瀵 坋 秎 𫚍 橨 𪱥 𫅗
方	芳 坊 枋 邡 淓 钫 匚 汸
房	防 妨 肪 坊 鲂
访	彷 仿 纺 倣 舫 昉 瓬 髣 𫛯
风	蜂 封 丰 疯 峯 锋 豐 烽 枫 讽 酆 葑 沣 犎 捀 桻 妦 檒 㐽 崶 蘴 飌 𫜑 猦 仹 僼 凨 凬 堼 寷 峰 盽 肨 莑 蠭 鄷 鏠 凮 楓 瘋 碸 笂 篈 鋒 靊 風
逢	缝 冯 夆 沨 堸 艂 摓
唪	覂
奉	凤 俸 讽 缝 赗 焨
夫	肤 敷 孵 伕 麸 跗 趺 柎 砆 鄜 𫓧 箙 罦 衭 稃 邞 泭 怤 尃 荴 綒 鳺 姇 糐 璷 紨
服	福 扶 浮 符 伏 佛 缚 幅 俘 拂 苻 弗 孚 袱 芙 辐 蝠 匐 蜉 罘 涪 夫 郛 莩 怫 蚨 桴 绋 茯 菔 绂 咈 洑 綍 艴 芾 茀 艀 刜 帗 笰 葍 袚 氟 棴 澓 烰 枹 玸 岪 枎 垘 昲 柫 琈 虙 踾 凫 巿 沷 祓 翇 韨 諨 𫛡 黻 𫛳 鶝 炥 畉 畐 畗 鉜 髴 𫚒 凫 乀 鳧 栿 甶 𫄢 紱 紼 輻 鉘 𫖔 颫 𩙥 餖 驌
府	腐 抚 辅 甫 斧 俯 釜 脯 腑 莆 滏 呒 拊 黼 簠 𫖯 郙 弣 𫚙 暊 冹 蜅 蚥 軵 父
父	负 妇 付 附 富 复 副 傅 覆 复 腹 咐 赴 赋 驸 阜 讣 馥 赙 蝮 鲋 祔 偩 輹 鳆 鍑 榑 復 胕 蚹 萯 蝜 褔 姇 峊 蛗 𫄭 蕧 僅 冨 坿 婏 媍 椱 稪 詂 鍢 圑 婦 疈 癁 竎 簹 縛 袝 訃 負 賦 賻 駙 鮒 鰒 䲁
搭	褡 答 撘 咑 耷
答	达 鞑 靼 瘩 怛 𫄤 哒 妲 笪 荅 荙 褟 𫟼 匒 呾 畣 炟 𨱏
得	德 淂
的	得
呆	呆
歹	逮
代	带 待 袋 戴 怠 殆 黛 贷 迨 大 玳 岱 逮 襶 埭 叇 绐 廗 汏 忕 瀻 軩 跢 艜 蹛 柋 酨 亣 侢 帯 忲 摕 曃 瑇 簤 緿 隸 霴 黱 帶 甙 紿 貸 軚 駘
刀	叨 忉 舠 氘 幍 鱽
倒	岛 导 祷 捣 捣 捯 壔 禂
到	道 倒 稻 盗 蹈 悼 导 纛 翿 檤 菿 瓙
都	兜 郖
鬥	抖 陡 蚪 枓 唗 敨
斗	豆 逗 痘 窦 荳 脰 饾 鋀 梪 浢 读
单	担 丹 耽 箪 郸 眈 聃 酖 砃 甔 襌 匰 聸 勯 嚪
胆	疸 撢 亶 𬘘 刐 掸 玬 衴 黵 丼 澸
但	旦 淡 蛋 诞 担 弹 惮 氮 啖 澹 憺 儋 啗 噉 石 瘅 窞 𫢸 幨 霮 髧 萏 钽 暺 柦 帎 潬 沊 狚 觛 啿 舕 蜑 嘾 鴠 癚 殚
当	当 铛 裆 珰 筜 儅 蟷 澢 艡 嵣
档	党 挡 谠 攩 𣗋 黨
当	荡 挡 荡 砀 宕 菪 逿 𬍡 愓 瓽 礑 簜 闣
登	灯 镫 簦 豋 璒 嬁
等	戥
邓	瞪 蹬 凳 嶝 磴 墱 邆 霯
低	滴 氐 羝 鞮 彽 䃅 𫔂 袛 菂 墑 熵
跌	蝶 谍 碟 叠 迭 牒 喋 瓞 耋 绖 咥 垤 堞 蜨 蹀 鲽 跕 昳 峌 挕 胅 苵 眣 聑 臷 詄 镻 艓 褋 惵 楪 嶀 疊 呋 曡 疉 眰 趃 戜 褺 諜 鰈 鱂
雕	凋 刁 貂 雕 碉 叼 雕 瞗 雕 鲷 扚 蛁 鳭 虭 殦
调	掉 钓 吊 吊 窎 𦰏 𫍥 伄 魡
丢	铥
颠	巅 癫 滇 掂 傎 瘨 敁 蹎 槙 齻 厧
点	典 碘 錪 婰 琠 蕇
电	店 殿 甸 奠 垫 淀 惦 靛 佃 澱 玷 钿 簟 坫 痁 癜 磹 阽 扂 婝 踮 壂
丁	钉 叮 疔 酊 盯 仃 玎 帄 靪 虰
顶	鼎 酊 嵿 濎 薡
定	订 钉 锭 碇 饤 娗 椗 掟 碠 顁 萣 啶
的	敌 迪 狄 笛 涤 翟 荻 嫡 嘀 镝 蹢 芽 犒 籴 觌 篴 蔋 靮 梑 潪 苖 嚁 鸐 藋 藡
底	抵 邸 诋 牴 砥 氐 坻 柢 弤 觝 呧 阺 聜 菧 軧 扺
地	第 弟 帝 递 蒂 的 缔 谛 娣 睇 棣 杕 玓 禘 蔕 䗖 踶 楴 渧 碲 虳 釱 樀 旳 轪 梊 焍 馰 墆 𫶇 珶 甋 偙 坔 埊 媂 嶳 祶 肑 遞 逓 僀 啇 奃 怟 綈 締 諦
都	督 嘟 阇 醏
多	哆 柁 茤
夺	铎 掇 裰 剟 敪 椯 剫 敚 莌 毲 腏 𫚛 𫋷
躲	朵 埵 垛 亸 鬌 痑 趓
惰	堕 舵 跺 剁 咄 踱 驮 垛 墯 嶞 柮 陏 陊 度 袉 貀 鵽
堆	頧 痽
对	队 兑 碓 怼 譈 㳔 薱 轛 濻 瀩 憝
端	耑 偳 剬 媏
段	断 缎 锻 毈 腶 簖 椴 葮 碫 躖
敦	蹲 墩 惇 礅 驐 蜳 撉 镦
盹	趸
顿	吨 盾 钝 遁 盹 炖 沌 囤 遯 燉 坉 扽 伅 庉 潡 崸 鶨 腞
东	冬 咚 冬 苳 𬟽 𪣆 崠 氡 炵 涷 菄 鸫
懂	董 嬞 墥
动	洞 冻 栋 恫 胴 挏 戙 𩧲 霘
读	独 毒 牍 纛 渎 犊 髑 讟 黩 椟 儥 碡 㱩 蝳 贕 韇 韥 皾
赌	堵 睹 笃 肚 錖 裻 帾
度	渡 肚 妒 镀 杜 蠹 秺 喥
它	他 她 牠 塌 褟 祂 禢
塔	榙 𨱏
踏	榻 蹋 獭 搨 遢 嚃 跶 沓 嗒 挞 遝 闼 鎉 阘 錔 鞜 鞳 鳎 羍 涾 傝 毾 誻 𫠁 漯 迖 濌 龘 崉 橽 溻 㳠 蟽 躢 達 迏 鮙 撻 眔 譶 蹹 闥 闠 龖
特	慝 忒 忑 铽 貣 𫋌
胎	苔
臺	台 抬 台 苔 邰 跆 台 苔 炱 骀 鲐 儓 嬯 籉 旲 秮
太	态 泰 汰 钛 燤 溙 呔 傣
掏	涛 滔 饕 韬 弢 绦 縚 搯 慆 槄 幍 翢 嫍 蜪
逃	桃 陶 萄 淘 涛 啕 洮 焘 梼 匋 咷 绹 鞀 醄 𫘦 錭 駣 祹 鋾
偷	媮
头	投 牏 酘
黈	妵 紏 钭 蘣
透	斢
贪	滩 摊 瘫 坍 怹 抩 舑 緂 探
谈	弹 痰 潭 谭 檀 坛 昙 坛 覃 郯 锬 餤 驔 镡 倓 醰 貚 婒 憛 藫 橝 黮 𫛴
坦	毯 袒 襢 忐 禫 菼 𫎫 嗿 羶 憳 醓 裧
探	叹 叹 碳 炭 赕 埮 湠 羰
汤	镗 鼞 蹚 蝪
堂	糖 唐 塘 膛 螳 棠 糖 搪 镗 溏 螗 瑭 赯 榶 樘 漟 煻 鎕 闛 橖 蓎 磄 踼 薚 鶶 傏 啺 坣 禟 糃 糛 鄌 餹 饄 摚 篖 膅 蚫 鏜 鑱 隚 餳
倘	躺 傥 淌 帑 惝 镋 镋 戃 曭 爣 矘
趟	烫 铴 摥
疼	腾 藤 籐 誊 滕 螣 縢
梯	踢 剔 焍
贴	帖 怗
铁	帖 驖 僣
帖	餮 蛈
挑	祧 恌 庣 𬶐
条	调 笤 佻 迢 蜩 髫 岧 苕 龆 鲦 鞗 芀 鎥 趒 祒
挑	窕 𫍥 宨 嬥
跳	眺 粜 朓 覜 𫖯 絩 窱 脁
天	添 倎 屇 酟 婖
田	甜 填 恬 阗 畋 窴 沺 盷 湉 菾 磌
舔	忝 殄 腆 腼 淟 餂 𧹖 悿 蠶 晪 痶
掭	煔 瑱
听	厅 汀 桯 艼 耵
停	庭 廷 亭 蜓 霆 婷 渟 莛 朾 筳 蝏 聤 葶 鼮 楟 榳 閮 嵉 𬘩
挺	艇 町 梃 颋 珽 脡 铤 烶 圢 侹
题	提 啼 堤 蹄 醍 禔 稊 缇 荑 𫘨 隄 𫛸 惿 厗 鍗 偍 趧 謕 鶙 崹 睼 蝭 蕛 𫛴 嗁 埞 漽 瑅 碮 禵 腣 蹏 遆 綈 緹 罤 題 鮷 鴺 䴘 鵜
体	體 绨
替	惕 涕 屉 悌 剃 锑 嚏 倜 薙 𣨼 裼 揥 籊 鬄 悐 褅 逖 鹈
秃	𪉍 涋 捸 嶀
脱	拖 託 托 堶 侂 捝 扥 矺 沰 馲 侻 𫍡 魠
驼	陀 驮 沱 佗 鸵 跎 橐 坨 紽 酡 砣 阤 𬶍 岮 碢 鞁 驒 鼍 铊 袉 饦
妥	椭 撱 庹 嫷
拓	唾 柝 箨 萚 跅 毻 毤
推	蓷 藬
颓	穨 𬯎 魋 橔 僓 蹪 弚
腿	俀
退	蜕 駾 螁
湍	煓 貒
团	抟 团 漙 剸 慱 鏄 鷻 𣏢
彖	褖
吞	暾 啍 涒 旽
屯	囤 豚 饨 臀 軘 鲀 忳 芚 噸 拵
汆	噸 畽
褪	螁
通	恫 蓪 痌 炵 熥 狪
同	童 铜 桐 潼 瞳 彤 佟 僮 峒 侗 艟 曈 膧 穜 罿 硐 橦 氃 獞 茼 烔 浵 鉖 餇 仝 酮 迵 粡 𫄡 朣 犝 蕫 鲖 鼨 爞 哃 𫍣 勭 庝 晍 燑 秱 蚒 眮 砼 硧 鉵 銅
统	筒 桶 捅 垌 筩 姛
痛	同 恸 蘳
图	途 突 徒 涂 屠 凸 荼 塗 餘 酴 瘏 稌 腯 峹 葖 𪉍 捈 怢 鍎 跿 梌 湥 筡 蒤 瑹 𬳿 鶟 鷋 鼵 嵞 廜 潳 鷵 凃 啚 図 圗 𨱄 圖 堗 宊 揬 蝋 馟
土	吐 钍 芏 唋
兔	吐 菟 鵵 堍
拿	挐 拏 誽
那	哪
那	纳 呐 讷 钠 捺 娜 肭 衲 𫐇 妠 豽 魶 笝
𡥧	摨
乃	奶 迺 氖 嬭 奈 氝 釢 艿
耐	奈 褦 鼐 柰 倷 螚 渿 镎
馁	哪 腇
挠	铙 桡 呶 猱 怓 𫍢 髐 嶩 獶 𫄣 獿 夒
脑	恼 瑙
闹	淖
羺	獳
耨	鎒 嗕 𫍦
囝	囡
南	男 难 喃 楠 柟 暔 諵 奻 萳 莮
赧	戁 蝻 湳 腩 揇
难	婻
曩	攮 灢
能	苧 儜
捏	踗 鑈
孽	镍 蹑 聂 镊 涅 嗫 囓 臬 乜 啮 臲 𫔶 陧 啮 敜 颞 糱 蘗 疌 嵲 踂 篞 蘖 蠥 钀 巕 圼 孼 枿 糵 菍 齧 囁 囐 帇 痆 聶 艝 艠 躡 鉨 鉩 鑷 鎳 隉 顳
鸟	袅 嬲 嬝 袅 茑 褭
纽	扭 钮 忸 狃 炄 莥
年	黏 粘 姩
捻	撚 撵 拈 辇 碾 涊 簐 跈 䟢 鲶
念	念 淰 齞 廿 鼰
娘	娘
宁	凝 狞 咛 柠 宁 拧 𫛢 鑏 寍 聍 𪥰
泞	佞
泥	尼 妮 倪 霓 怩 猊 蜺 𫐐 郳 麑 鯓 鲵 𫠜 臡 秜 狋 觬 婗 淣 呢 狔 屔 跜 铌 鶂
你	妳 拟 祢 儗 旎 暱 坭 柅 薿 檷 抳 苨 馜 隬 譺
逆	溺 匿 腻 泥 睨 暱 惄 鹢 鹝 嫟 縌 迡 堄
挪	娜 傩 捼 梛
诺	懦 糯 搦 挼 逽 懧 糑
暖	𫗬 煖 渜
农	浓 脓 侬 哝 秾 襛 𬪩 齈 鬞
奴	驽 孥 笯 蒘
努	弩 砮
虐	疟 谑
女	籹 钕
忸	恧 衄 朒
拉	啦 喇 柆 鞡 翋 菈
剌	邋 旯
喇	藞
腊	蜡 镴 辣 剌 臘 落 鬎 瘌 揧 楋
乐	垃 勒 肋 泐 埒 叻 仂 捋 扐 阞 砳 鳓 氻 哷 竻
来	莱 徕 涞 騋 箂 崃 郲 铼 鯠 梾 庲 鶆 唻
赖	癞 濑 籁 睐 赉 藾 娕
雷	累 擂 嫘 镭 羸 缧 罍 檑 畾 櫑 瓃 蠝 𫐙 壨 欙
累	垒 儡 漯 耒 磊 蕾 诔 藟 樏 癗 礌 絫 磥 鑸 瘣 櫑 櫐 礨 灅 讄 鸓 頛 礧 蘲 蔂
类	泪 累 擂 颣 酹 銇 儽 蘱 禷
劳	牢 痨 涝 唠 醪 浶 铹 簩 蟧 崂
老	姥 佬 栳 狫 轑 咾 橑 铑 恅 荖
劳	络 烙 酪 嫪 軂 𣓿 僗
楼	喽 娄 蝼 髅 偻 蒌 廔 溇 耧 𤋏 𫍴 艛 鞻 鷜 䁖
篓	搂 𪣻 嵝
漏	陋 露 镂 瘘
兰	篮 蓝 栏 拦 澜 褴 婪 岚 阑 襕 谰 斓 籣 欗 糷 灆 㳕 譋 𨅬 儖 厱 𪢠 懢 燣 𫞨 䍀 葻 蘫 襽 韊 蘭 嵐 攔 斕 欄 瀾 籃 藍 襤 讕 鑭 闌
览	懒 揽 榄 缆 𡒄 爦 灠 醂 嬾 顲 浨
烂	滥 缆 镧 爁 壏
郎	狼 廊 螂 瑯 琅 榔 稂 莨 蜋 桹 筤 锒 俍 崀 欴
朗	阆 硠 峎 悢 誏 烺 塱
浪	埌 蒗
棱	崚 棱 薐 蔆 倰 楞
愣	踜 楞
列	烈 劣 裂 猎 捩 冽 鬣 躐 洌 茢 睙 擸 趔 姴 迾 脟 蛚 蛶 颲 儠 𫚓 䴕 犣
聊	寮 辽 疗 寥 撩 僚 潦 嘹 缭 镣 嫽 獠 鹩 屪 鹨 膋 漻 摎 豂 嵺 憀 嶚 敹 窷 膫 簝 镽 飂 飉 顟 尞 嶛 竂 蹘 髎 廫 療 繚 賿 遼 醸 鷯
了	瞭 蓼 憭 钌 暸 鄝 蟟
廖	料 瞭 燎 尥 撂 炓 蟉 窲
刘	流 留 硫 琉 榴 浏 瘤 遛 旒 骝 镠 飗 鹠 懰 鎏 泵 镏 媹 嬼 嵧 藰 裗 麍 鷎 蓅 鰡 巯 劉 嚠 橊 瑠 瑬 璢 畄 畱 疁 癅 磂 蒥 鐂 駠 駵 驑 旈 瀏 綂 鎦 餾 騮 鱪
柳	绺 罶 铆 飹 珋
六	陆 溜 馏 霤 坴 翏 雡 廇 塯 蹓
连	联 怜 廉 莲 涟 帘 镰 鲢 奁 琏 簾 裢 𪡏 镰 鬑 溓 蠊 梿 𦈐 謰 覝 磏 濂 翴 薕 蹥 譧 奱 嬚 亷 劆 匲 匳 嫾 慩 櫣 濓 燫 籢 聨 聫 聮 螊 奩 漣 聯 臁 蓮 褳 連 鐮 魺 鰱
脸	鄻 膦 摙 僆 羷
练	炼 恋 炼 链 殓 敛 潋 楝 裣 湅 澰 蔹 歛 莶 萰 堜
林	临 邻 淋 鳞 麟 霖 磷 琳 遴 嶙 燐 璘 粼 辚 潾 痳 疄 瞵 惏 暽 罧 𬴊 碄 箖 甐 繗 僯 翷 蹸 𪤚 𬭸 晽 瀶 矝 粦 隣 臨 厸 斴 杮 枾 獜 轔 鄰 颪 魿 鮲 鱗
凛	懔 廪 檩 菻 亃 𬘭
吝	躏 蔺 赁 橉 𫔴 焛
良	梁 量 粮 凉 粱 梁 椋 𫟅 辌 駺
两	俩 魉 緉 裲
量	亮 谅 辆 喨 晾 凉 唡 踉 湸 悢
零	玲 灵 铃 龄 陵 凌 菱 聆 羚 苓 伶 绫 凌 翎 鸰 囹 蛉 瓴 泠 舲 酃 𫐉 𨱋 櫺 柃 棂 睖 砱 詅 輘 霝 鲮 醽 嶺 昤 澪 呬 坽 夌 姈 狑 皊 呤 琌 笭 裬 蘦 憐 婈 駖 蕶 𫞠 堎 岺 朎 靈 燯 碐 祾 秢 竛 紷 袊 跉 阾 霊 霗 霛 麢 龗 刢 孁 掕 欞 獜 綾 聢 衑 鈴 𫠂 魿 鱠 鯪 鹷 齡
领	岭 彾
令	另 炩
离	璃 黎 梨 篱 厘 牦 罹 貍 骊 犁 漓 漓 狸 藜 蜊 蠡 鹂 嫠 褵 黧 梩 漦 缡 蔾 牦 釐 蓠 剺 喱 籬 醨 鲡 劙 㛤 廲 騹 孷 樆 謧 𫚞 鵹 攡 丽 菞 鑗 黐 粍 麶
李	裏 里 理 礼 里 哩 浬 鲤 娌 俚 澧 逦 醴 蠡 鳢 锂 粴 豊 峛 欚
力	立 利 丽 历 坜 例 历 莉 厉 励 砺 粒 莅 雳 沥 俪 隶 砾 吏 荔 慄 栗 俐 痢 疠 笠 戾 唳 郦 琍 詈 呖 溧 蛎 枥 沴 粝 栎 轹 𬍛 鬁 猁 盭 篥 苙 唎 屴 跞 钋 鬲 皪 秝 瑮 𫐆 岦 朸 𪲔 禲 赲 𫁡 砅 𪵱 砬 悷 蚸 历 筣 𫄫 蜧 磿 斄 犡 苈 蠫 𫛽 麜 攦 觻 鷑 攭 鱳 靋 栵 浰 塛 搮 蝷 儮 曞 讈 瓥 鱱 娳 蒞 蠇 𫟷 銐 隷 雴 鬴 鳨 儷 勵 厯 嚦 壢 櫪 櫟 棙 瀝 沵 癘 癧 礪 礫 糲 翽 翬 藶 蠣 蛠 躒 轢 酈 靂
罗	螺 萝 锣 逻 箩 骡 啰 猡 㑩 覶 摞 椤 虆 镙 鸁 剆
裸	瘰 臝 蠃 蓏 𨱍
落	骆 洛 络 雒 烙 酪 泺 荦 咯 珞 纙 袼 硌 鮥 鵅 峈
峦	銮 鸾 滦 脔 𪢮 栾 曫 羉 癵
乱	薍
伦	论 轮 沦 仑 仑 纶 抡 囵 碖 𬬭 惀 陯 𰰨 踚 棆 蜦
论	溣
龙	隆 笼 咙 聋 珑 胧 窿 泷 癃 栊 砻 昽 巃 眬 茏 𨀁 豅 鏧 鑨 靇 蠪 襱 𫛟 儱 龒 蠬 屸 嶐 湰 滝 漋 𤇭 礲 竜 篭 蕯 霳 驡 𫜲 嚨 櫳 瀧 瓏 礱 籠 聾 朧 蘢
陇	拢 垄
衖	哢 𪫌 梇
卢	芦 庐 胪 炉 颅 泸 鲈 轳 垆 鸬 玈 罏 舻 𬬻 籚 栌 𠰷 攎 𫊮 纑 廬 爐 瓐 𪾦 蘆 髗 魲 盧 壚 櫨 瀘 獹 皶 臚 艫 轤 険 顱 鱸 鸕 黸
鲁	虏 掳 卤 卤 橹 𫇛 硵 𫓺 鏀 蓾 撸 氇
路	陆 录 鹿 露 赂 禄 碌 氯 麓 鹭 戮 辘 逯 漉 辂 僇 潞 箓 璐 甪 稑 穋 簏 醁 𫘧 渌 琭 盝 磟 录 菉 蔍 錴 垏 鏕 鯥 摝 硉 睩 廘 熝 踛 蕗 螰 簬 鵱 淕 塶 蹗 侓 剹 勎 勠 娽 峍 錄 椂 樚 淥 祿 籙 绿 膔 虂 觮 趢 录 鏴 𫠋 鵦 圥 簶 粶 綠 賂 輅 轆 陸 鴼 鷺
略	掠 锊 撂 㧰
挛	孪
驴	闾 榈 藘 㥪 氀 𦝼
吕	旅 履 侣 铝 屡 缕 褛 娄 膂 溇 穞 梠 郘 挔 絽 儢 祣
律	绿 率 虑 滤 嵂 膟 鑢 菉 葎 勴
嘎	旮
轧	噶 钆
哥	歌 割 鸽 搁 胳 戈 肐 疙 渮 牁 菏 滒 麧
格	革 隔 阁 葛 骼 蛤 咯 膈 轕 嗝 搿 郃 韐 塥 觡 鬲 合 挌 佮 輵 𫚗 敆 茖 愅 獦 镉 齃 呄 敋 槅 臈 諽 𫠅 匌 擱 臵 蛒 裓 醗 鎘 閣 鞐 鰪
葛	哿 舸 擖 鲄 𩨀 笴
个	各 铬 虼 个
该	垓 陔 赅 荄 侅 峐 胲 祴 絯 豥 賌 𬮿
概	盖 丐 钙 溉 戤 摡 瓂
高	糕 膏 篙 羔 皋 櫜 睪 鼛 槔 睾 滜 韟
稿	搅 搞 槁 缟 杲 暠 檺 筶
告	诰 郜 锆 祰 煰
句	沟 勾 钩 枸 泃 篝 缑 構 芶 耩
狗	茍 岣 枸 苟 笱 耇 茩 蚼
够	购 垢 构 媾 彀 搆 诟 遘 觏 冓 姤 雊 傋 瞉 簼 鞲 唦
干	甘 幹 竿 肝 尴 柑 坩 泔 咁 疳 玕 杆 矸 虷 筸 蜬 鳱 嵅
敢	感 赶 杆 橄 秆 澉 皯 盰 趕
干	赣 淦 绀 旰 骭 詌 干 灨 涻 簳 嵅
跟	根
亘	艮 茛
刚	钢 缸 岗 纲 冈 肛 扛 槓 罡 疘 舡 釭 堽 𥐻 㭎 笐 堈 犅
港	岗
更	耕 庚 粳 羹 赓 浭 緪 鹒 菮 搄
梗	耿 哽 绠 鲠 埂 骾 郠 挭
更	亘 堩
姑	孤 辜 咕 沽 估 菇 菰 呱 蛄 痼 箍 鸪 觚 酤 泒 罛 箛 钴 鮕 夃 柧 𨱃 軱 家 嫴 橭
瓜	括 刮 蜗 刮 聒 鸹 栝 適 䯄 胍 脶 筈 葀 劀 瘑 緺 懖 趏 膼
寡	剐
挂	卦 褂 罫 罣 絓 诖 掛 髺
郭	锅 蝈 埚 啯 崞 埻 墎 㳡
国	帼 虢 馘 掴 聝 腘 𬇹 慖 𫂆
果	裹 椁 蜾 輠 粿 猓 淉 惈 鐹 锞
拐	拐 拐
怪	旝 夬 廥 𤶊
归	规 龟 瑰 闺 圭 珪 皈 傀 妫 槻 鲑 椝 邽 窐 沩 嫢 摫
鬼	轨 诡 癸 匦 晷 宄 簋 佹 垝 氿 姽 蟡 庪 祪 蛫 觤 厬
贵	桂 柜 跪 刿 溎 鳜 昋 炔 筀 櫃 嶡 𫋻 暩
官	关 观 冠 棺 矜 鳏 纶 倌 莞 瘝 毌 鱞
管	馆 莞 琯 筦 脘 痯 錧
惯	贯 灌 罐 掼 盥 鹳 冠 观 丱 爟 瓘 祼 矔 鑵 涫 悺 悹 雚 鱹
滚	衮 鲧 绲 辊 掍 蔉
棍	璭
光	胱 洸 桄 珖 炚 茪 銧 垙 烡
广	犷
逛	桄 臩 臦 矌
工	公 功 供 攻 宫 恭 躬 弓 蚣 红 龚 肱 觥 疘 釭 𬕂 塨 愩 匑 共 幊 侊 厷 咣 宮 杛 玜 糼 糿 觵 躳 髸 䂵 篏 篒 紅 靏 龏 龔
巩	拱 汞 共 珙 矿 栱 廾 拲 蛬 穬
共	供 贡 羾 摃
骨	鹘
股	古 鼓 骨 谷 谷 贾 凸 蛊 汩 牯 滑 罟 嘏 诂 毂 鹄 瞽 臌 盬 羖 蛌 扢 钴 杚 淈 狜 唃 尳 榖 蓇 濲 瀔 愲 𦈔 薣 唂 焸 瑴 皷 糓 馉 鼔 轂 蠱 詁 賈 鈷 鵠 鶻
故	固 顾 僱 雇 锢 告 估 痼 梏 榾 牿 堌 崮 凅 棝 稒
咖	喀 哈 鉲
卡	咳 佧
喀	髂
科	柯 刻 棵 颗 苛 瞌 磕 蚵 蝌 轲 稞 窠 珂 砢 簻 薖 峇 钶 樖 犐 嵙
咳	壳
可	渴 哿 坷 岢 堁 敤 嶱 閜
客	课 刻 克 克 喀 溘 恪 嗑 榼 缂 髁 氪 骒 搕 厒 勀
开	揩 痎 侅
凯	慨 楷 恺 剀 岂 铠 垲 闿 锴 颽 暟 輆
慨	忾 愒 咳 欬 烗 勓 壒
考	烤 拷 栲 攷 薧 洘
靠	铐 犒
抠	𫸩 芤 袧 鏂
扣	寇 叩 蔻 扣 鷇 筘 佝 怐 滱 瞉 簆
刊	堪 勘 戡 看 龛 嵁
砍	侃 坎 崁 槛 欿 𫐘 歁 歞 埳 凵 顑
看	瞰 勘 阚 矙 磡 衎 墈 鬫 竷
肯	啃 垦 恳 龈 龂 豤 錹
掯	硍 裉
康	慷 糠 鏮 漮 嫝
亢	抗 炕 伉 匟 囥 犺 闶 邟 钪
坑	硁 铿 牼 吭 阬 硻 銵 𫰛 挳 鍞
哭	枯 窟 骷 跍 挎 桍 刳 顝 胐 橭
夸	誇 姱 荂 晇 侉
垮	侉 銙
跨	胯 骻
括	扩 阔 廓 鞹 漷 蛞 姡 霩 籗
呙	㖞
快	块 会 筷 桧 刽 郐 浍 脍 哙 狯 侩 鲙 𫘝 𫘽 欳
亏	窥 盔 闚 刲 悝 鞹 鍷 茥 藈 𠯠 岿 蘬
魁	睽 奎 揆 葵 逵 戣 夔 骙 暌 鄈 頯 聧 楏 櫆 湀 馗 楑 犪 躨
傀	跬 𫠆 煃 蹞 峞
愧	溃 匮 馈 餽 喟 篑 媿 聩 愦 箦 蒉 瞆 椢 樻 鐀 𪡞 撌 騩 硊 蔮
宽	髋 𣎑
款	窾 梡
昆	昆 坤 琨 锟 焜 裈 晜 鲲 菎 𫘥 髡 惃 猑
捆	捆 悃 梱 阃 壸 稛 硱 裍 齫
困	困 涃
匡	框 筐 诓 劻 恇 洭
狂	诳 𫛭
况	矿 旷 框 眶 邝 贶 圹 纩 絖 懭 爌 彉
空	崆 倥 箜 悾 硿 涳 錓
恐	孔 倥
空	控 鞚
苦	楛
库	裤 酷 喾 矻 瘔 趶
喝	呵 诃 峆
何	合 和 河 荷 核 盒 禾 褐 劾 阖 合 曷 龢 涸 盍 核 盖 貉 阂 纥 滆 翮 蠍 嗑 龁 郃 餲 鹖 鉌 鲄 鞨 菏 姀 毼 熆 蒚 篕 螛 礉 盉 廅 楁 澕 趷
贺	和 鹤 喝 荷 吓 赫 郝 暍 嗃 熇 猲 翯 佫 煂
咳	嗨 咍
还	孩 骸 颏
海	醢 烸
害	亥 骇 嗨 氦 嗐 絯 餀
黑	嘿 潶
蒿	嚆 薅
号	毫 豪 壕 濠 蚝 貉 嚎 鹤 蚵 嗥 籇 諕 勂 譹
好	郝
号	耗 浩 皓 镐 涸 昊 好 灏 澔 皜 颢 鄗 秏 淏 滈 皞 哠 悎 鰝 昦 薃
猴	侯 喉 篌 𬭤 糇 瘊 銗 翭 鯸 葔
后	候 厚 後 逅 鲎 垕 堠 郈 鄇 缿 洉
酣	鼾 蚶 憨 顸 𫠐 唅 甝 谽 嫨
寒	含 函 涵 韩 邯 汗 邗 干 琀 梒 鋡 焓
喊	罕 廠 蔊 豃 嚂
和	汉 汗 旱 焊 憾 翰 撼 悍 颔 扞 瀚 闬 捍 暵 熯 晥 犴 睅 菡 豻 銲 釬 𫘣 哻 涆 淊 𫘛 蜭 颌 螒 顄 雗 攌 譀 鋎 鶾 傼 咊 垾 惒 猂 皔 莟 蛿 娨 屽 攼 晘 貋 頜 頷
痕	拫 鞎
很	狠
行	航 杭 吭 颃 桁 迒 苀 骯 蚢 斻 貥 雽 魧
行	沆
亨	哼 脝 諻
横	恒 衡 恆 珩 蘅 桁 姮 鑅 楻 誙 諻 揘 佷
横	啈 澋 绗
忽	呼 乎 惚 滹 戏 猢 欻 膴 虖 吰 虍 幠 寣 昒 歑 烼 垀 曶 啒 峘 淴 謼 匢 淲
花	华 哗 𪉊 錵
华	滑 劃 猾 哗 哗 桦 骅 铧 豁 划 崋 釫 螖
话	化 画 划 桦 华 婳 摦 崋 嬅 杹 觟 槬 繣 𣶩
活	佸 钬 萿
火	夥 伙 钬
或	获 获 和 惑 祸 霍 货 豁 壑 蠖 嚄 藿 镬 矱 檴 濩 砉 雘 硅 擭 湱 𬴃 謋 捇 沎 眓 掝 嗀 瓁 臒 攉 瀖 曤 矐 韄 靃 剨 咟 𪠸 彟 旤 𣒌 癨 矆 礊 耯 鳠 嚿 奯 禍 紦 艧 蒦 貨 鑊 閄 鹱
怀	淮 徊 槐 踝 佪 懷 褢 褱 櫰 瀤
坏	壞 諙 孬 咶 蘹 蘾
灰	挥 辉 恢 诙 晖 麾 徽 堕 裈 㧑 隳 𪸩 翚 豗 袆 洃 隓 顪 鰴 拻 𠯠 禈
回	回 蛔 茴 蚘 洄 痐 恛 藱
会	悔 诲 毁 毁 贿 虺 蟲 烠 毇 檓 毁
会	惠 汇 绘 慧 汇 秽 诲 贿 晦 彗 讳 溃 卉 蕙 濊 烩 喙 恚 荟 翙 阓 嘒 槥 篲 缋 𰬸 蟪 㻅 𫝬 憓 潓 瞺 𬤝 譿 鏸 橞 廆 詴 圚 蔧 𤞃 餯 鐬 饖 芔 禬 𫋻 會 僡 儶 嚖 彚 恵 懳 暳 櫘 汇 熭 絵 詯 譮 𫖃 韢 颒 噦 寭 檜 㱮 匯 澮 潰 燴 穢 繪 繢 薈 諱 誨 賄 鞼
欢	驩 讙 獾 犿 懽 酄 𫛝
还	环 桓 缳 鬟 锾 镮 寰 阛 梡 洹 𤩽 貆 澴 荁 萑 肒 捖 羦 懁 豲 嬛 狟 雈
缓	皖 澣 睆 輐
换	唤 宦 患 幻 焕 奂 涣 痪 豢 梡 逭 擐 漶 垸 轘 瑍 觨 嚾 瞣
婚	昏 荤 阍 惛 睯 殙 棔 涽 敯 睧
魂	浑 馄 混 珲 楎 𫗥 棞 顐 鼲 繉 轋
混	睔
混	浑 溷 诨 圂 慁 辊 倱 梡
荒	慌 肓 衁 巟 嚝
黄	徨 惶 簧 璜 磺 蝗 煌 皇 凰 湟 遑 隍 潢 篁 喤 艎 锽 熿 韹 鳇 堭 蟥 偟 穔 鷬 媓 𫘩 崲 葟 𫗮 撗 獚 趪 墴 瑝 鱑 黃 癀 纟 鈬 鰉 鰼
谎	恍 晃 幌 洸 怳 榥 熀 鎤 滉 皝
晃	軦
轰	哄 烘 薨 訇 吽 揈 渹 哅 𫐒 谾 鍧 焢 𫚉
红	洪 宏 鸿 虹 弘 泓 讧 𬭎 闳 黉 竑 纮 翃 浤 鞃 灴 荭 耾 仜 汯 竤 鈜 霟 妅 玒 谹 渱 舼 觸 谼 篊 彋 瓨 苰 叿 娂 宖 潂 粠 紭 𫟄 翝 葓 闂 硡 紅 葒 閎 鴻 黌
哄	唝
哄	汞 澒 蕻 鍙
胡	湖 壶 蝴 糊 狐 弧 葫 胡 瑚 糊 斛 鹄 囫 縠 胡 觳 醐 猢 搰 鹕 槲 媩 抇 鰗 焀 魱 螜 瀫 楜 嘝 𫛷 喖 壷 瓳 絗 蔛 鍸 頶 壺 煳 箶 駅 鵠 鶘 鶻
虎	琥 浒 唬 许 汻
护	户 互 沪 扈 瓠 怙 祜 笏 冱 戽 楛 沍 岵 鄠 臛 頀 枑 槴 昈 嫭 婟 嫮 熩 豰 綔 謢 蔰 冴 嬳 戶 戸 摢 滬 玍 蘆 鳸 帍 簄 钎 鸌
机	基 积 绩 迹 激 迹 姬 鸡 饥 肌 稽 饥 奇 畸 碁 箕 矶 讥 羁 幾 機 乩 屐 跻 玑 几 叽 畿 嵇 犄 赍 其 期 居 唧 𪟝 禨 欚 疠 羇 虀 觭 霙 蛣 𫓯 枅 丌 尐 簊 蟣 鐖 𪲎 稘 毄 樍 諅 齍 鞿 鑇 鰿 齑 笄 剞 𬯀 鸄 癪 卟 坖 峜 朞 槣 竒 筓 𫆏 𫌀 覉 覊 譤 躸 跡 韲 鳮 鸡 擊 嗘 積 績 羈 耭 譏 齎 躋 鎺 鑙 飢 餏 雞 齏
家	加 嘉 佳 家 迦 枷 袈 痂 笳 珈 跏 茄 葭 豭 耞 麚 泇 毠 镓 𫛤 猳 幏 犌 貑 夹
夹	挟 颊 蛱 荚 浃 戛 郏 恝 袷 䇲 裌 铗 𬂩 跲 舺 唊 铪 硈 扴 鞂 鞈 𫛥
假	甲 贾 钾 岬 胛 斝 榎 瘕 槚 婽 玾 徦 椵 夏
价	假 架 驾 嫁 贾 稼 價
街	接 皆 阶 揭 偕 嗟 喈 幯 结 湝 薢 袺 啑 椄 菨 蝔 鶛
节	洁 杰 捷 竭 劫 截 结 傑 颉 诘 桀 睫 讦 咭 拮 羯 栉 桔 孑 疖 絜 偈 撷 倢 劼 婕 楬 碣 鲒 岊 榤 犵 袺 嵑 栨 𩨀 滐 鉣 鐑 衱 迼 崨 嵥 楶 趌 踕 擳 瀄 鍻 蠽 昅 揤 緁 巀 緳 偼 刦 刧 刼 卩 搩 擮 莭 葜 蓵 蠘 誱 卪 厇 緕 結 節 蜐 蠞 訐 詰 頡 鮚
姐	解 姊 檞 媎
界	借 介 戒 藉 届 疥 芥 诫 解 唶 喈 玠 蚧 犗 褯 吤 岕 價 砎 悈 紒 祴 躤 繲
教	交 胶 骄 焦 娇 郊 跤 浇 蛟 蕉 礁 椒 茭 姣 鲛 僬 憍 艽 鹪 燋 詨 鱎 𨱓 䴔 鷮 嘄 憿 膲 穚 𫋇 鷍 嶕 蟭 噍 教 嬌 澆 茮 虠 驕 鮫 鷦
脚	角 缴 搅 勦 矫 绞 姣 佼 饺 皎 侥 剿 较 铰 狡 皦 儌 筊 𫊸 摷 挢 捁 灚 曒 漅 劋 𫍤 煍 撹 晈 烄 璬 腳 踋 僥 撟 攪 暞 矯 絞 繳 臫 覐 賋 贔 鉸 餃
教	叫 校 较 觉 轿 窖 皭 醮 徼 噭 峤 挍 斠 珓 釂 滘 窌 嘂 潐 譥
纠	揪 啾 鸠 𫐖 湫 樛 揫 勼 朻 牞 觓 揂 萛 阄
九	久 酒 玖 赳 灸 韭 纠
就	究 救 旧 舅 臼 柩 疚 咎 僦 鹫 厩 捄 慦 鯦 麔
间	监 坚 尖 兼 肩 艰 奸 奸 煎 缄 溅 渐 笺 歼 菅 戋 鞬 牋 椷 缣 湔 熸 蒹 鹣 廌 犍 篯 豜 鞯 鬋 钘 鑯 鲣 鳒 櫼 熞 蕑 揃 搛 幵 菺 靬 葌 𫛚 餰 礛 𩨃 鵳 瀸 虃 惤 猏 麉 偂 姧 尶 椾 瀐 玪 睷 礷 譼 閚 韀 韯 馢 魐 冿 凲 囏 堅 開 戔 殲 漸 濺 監 箋 緘 縑 艱 間 韉 鮋 鰹 鶼 黬
简	捡 剪 减 检 拣 茧 俭 碱 柬 笕 翦 謇 戬 蹇 谫 趼 堿 囝 鰔 挸 湕 睑 寋 藆 襺 暕 瑐 倹 減 検 瀽 鹼 絸 蠒 谫 鹻 儉 弿 揀 撿 梘 檢 瞼 礆 筧 簡 襉 譾 鐧
见	建 健 渐 件 间 监 键 鉴 箭 剑 舰 鉴 贱 践 谏 毽 荐 饯 腱 溅 僭 槛 闲 洊 俴 牮 栫 楗 珔 瀳 涧 瞷 薦 𬣡 榗 糋 鰎 蔪 鋻 螹 裥 糮 鑳 踺 鑑 鐧 鍵 間 餞
今	金 禁 津 斤 巾 筋 襟 矜 浸 觔 衿 祲 瑧 菳 珒 埐 𫄛 嶜 惍
紧	仅 锦 谨 尽 觐 瑾 馑 槿 墐 殣 堇 慬 菫 卺
进	近 尽 禁 晋 尽 浸 劲 觐 烬 廑 噤 靳 缙 仅 荩 妗 赆 寖 搢 肵 琎 賮 嬧 榗 僸 蓳 瘽 嚍 浕 璶 伒 溍 凚 厪 唫 盡 晉 歏 瑨 劤 勁 濅 燼 縉 藎 覲 贐 進 齽
将	江 疆 僵 浆 姜 姜 豇 僵 缰 螀 橿 茳 礓 瓨 翞
讲	奖 蒋 桨 顜 膙
降	匠 酱 强 将 绛 糨 洚 謽 嵹 彊 弶 袶
经	精 京 惊 睛 茎 晶 菁 兢 泾 鲸 荆 旌 粳 黥 箐 䴖 巠 婛 旍 鵛 鶁 鼱 麠 仱 驚 亰 坕 婙 梷 経 腈 莖 荊 葏 涇 猄 縅 緪 經 鯨 鹶 麖
景	警 井 颈 阱 儆 璟 憬 刭 璥 丼 烃 憼 暻 蟼 燛
敬	竟 镜 静 境 净 竞 迳 径 靖 劲 凊 胫 痉 獍 倞 靓 竫 婧 𣐕 𠇹 净 𫈎 擏 弪 妌 徑 曔 浄 淸 滰 濪 瀞 竧 竸 誩 靜 淨 勁 弳 痙 競 經 脛 逕 鏡 靚
及	级 极 即 集 急 击 疾 籍 吉 寂 辑 脊 圾 唧 嫉 汲 亟 喫 棘 藉 瘠 楫 岌 笈 鹡 戢 殛 蹐 伋 蒺 耤 芨 蕺 踖 钑 佶 堲 姞 濈 襋 墼 潗 鴶 嶯 潔 忣 湒 極 銡 狤 鏶 蝍 衱 偮 庴 莋 塉 槉 漃 膌 蓻 橶 蕀 轚 霵 彶 揤 楖 秸 鞊 螏 觙 亼 即 喞 愱 撃 檝 焏 皀 禝 箿 艥 郆 鍓 雦 雧 卙 皍 級 緝 詰 趞 輯
几	给 己 挤 脊 戟 济 幾 麂 庋 虮 剞 掎 泲 踦 魕 丮 穖 妀 撠
计	记 既 纪 际 继 季 寄 技 妓 济 剂 系 悸 祭 忌 暨 冀 骑 鲫 稷 跻 荠 骥 霁 蓟 髻 罽 觊 伎 洎 瘈 跽 哜 塈 惎 漈 穧 芰 蔇 痵 癠 穄 𫚖 鲚 鯚 𬶭 旡 刉 臮 裚 穊 𫍪 鬾 瞡 檕 𫞦 鵋 齌 懻 瀱 𬶨 蘮 蘻 兾 剤 垍 墍 彐 彑 既 曁 梞 𪲛 櫭 済 稩 継 魝 劑 嚌 斊 濟 皍 縘 紀 繼 薺 萕 葪 薊 蘎 覬 計 記 際 霽 驥 鯯 鰂 鱭 鯽
居	拘 驹 沮 疽 蛆 狙 俱 车 锯 裾 苴 趄 罝 菹 娵 椐 腒 崌 痀 琚 雎 涺 葅 𬶋 鶋 斪 揟 蜛 踙 𪨶 倶 凥 婮 跔 鴡 眗 車 鋦 鋸 鎛 駒
噘	嗟 撅
决	觉 绝 爵 掘 嚼 诀 厥 獗 蹶 蕨 崛 攫 倔 抉 噱 矍 觖 角 孓 玨 劂 橛 爝 谲 𪨗 觼 玦 脚 臄 𫈵 躩 戄 桷 潏 𫛞 貜 趹 鳜 傕 嵑 瘚 蠼 𫔎 镢 玃 捔 芵 焆 鈌 蚗 谻 赽 僪 憰 蟨 彏 𫚪 鷢 堀 殌 穱 決 屫 挗 𪮖 斍 橜 欔 欮 焳 熦 爑 珏 疦 砄 绝 蟩 覚 蹷 逫 龣 叏 孒 憠 氒 爴 矡 絕 覐 覺 訣 譎 镢 钁
捐	娟 鹃 涓 镌 圈 蠲 朘 身 脧 裐
卷	卷 埢 菤 臇
倦	卷 眷 绢 隽 悁 狷 圈 獧 睊 睠 罥 鄄 帣 锩 腃 韏 鬳
军	君 均 钧 皲 囷 麇 莙 鲪 桾 蚐 袀 𫖳 龟 碅
窘	蜠
俊	菌 郡 峻 竣 隽 濬 骏 蕈 浚 珺 畯 焌 捃 馂 箘 寯 晙 呁 鵘 葰 蔨
扃	坰 𬳶
窘	迥 煚 泂 炅 䌹 褧 冏 颎 囧 皛 炯 幜 顈
局	鞠 菊 橘 掬 跼 桔 挶 鞫 局 匊 踘 锔 鵙 䴗 椈 焗 淗 驧 狊 梮 郹 犑 輂 箤 趜 鵴 蘜 鼳 陱 𩧺 婅 巈 毩 粷 諊 蹫 躹 鄓 毱 鋦
举	矩 咀 莒 沮 龃 榉 筥 踽 蒟 椇 櫃 竘 袓 跙 蝺
据	句 具 巨 剧 聚 俱 拒 距 锯 惧 巨 炬 讵 遽 倨 瞿 踞 飓 泃 苣 窭 醵 屦 秬 虡 𪧘 鐻 佢 據 粔 姖 怚 絇 足 耟 岠 埧 蚷 駏 澽 𫎌 躆 洰 焣 壉 犋
七	妻 欺 戚 漆 栖 凄 凄 柒 萋 戚 溪 沏 諆 郪 娸 㶉 嘁 𫖹 悊 桤 磎 倛 咠 棲 谿 悽 唭 徛 桼 僛 緀 磩 霋 魌 鶈 攲 墄 慽 捿 榿 紪 莵 莻 轀
卡	酠
恰	洽 帢 愘 殎
切	沏
茄	伽 癿
切	窃 妾 怯 惬 挈 箧 锲 契 朅 踥 鯜 蛪 緀 藒 洯
敲	锹 橇 撬 跷 硗 𫏋 墝 幧 繑 髜 鐰 鏒 塙 鄡 墽 骹 庨 郻 頝
桥	瞧 侨 乔 樵 翘 憔 荞 硚 谯 簥 趫 燆 劁 𪡀 嫶 趬 敿
巧	悄 愀 鹊 雀 燋 頝
翘	窍 俏 峭 鞘 诮 撬 壳 帩 撽 躈
秋	邱 丘 蚯 秋 鳅 鹙 楸 坵 萩 偢 緧 媝 蓲 趥 龟 恘 蝵 蟗 蠤
求	球 囚 仇 酋 裘 遒 毬 泅 𫚧 逑 俅 厹 璆 絿 艽 虬 蝤 觩 赇 盚 𨱇 頄 鼽 訄 犰 朹 梂 𫟲 煪 苬 紌 脙 莍 崷 僋 蛷 鮂 𩾁 殏
千	铅 迁 签 牵 谦 签 嵌 仟 阡 千 骞 愆 佥 悭 搴 褰 粁 岍 汧 纤 芊 掔 扦 檶 鐱 婜 羟 攐 攓 譣 顩 奷 懺 𫖶 麉 櫏 圱 圲 拪 撁 攑 杄 欦 汘 熑 膁 諐 遷 鹐 僉 孯 慳 牽 籤 臤 蚈 謙 谸 蹮 釺 鉛 騫 鬜
前	钱 干 潜 黔 钳 虔 箝 钤 掮 媊 揵 燂 拑 鬵 灊 黚 忴 扲 岒 漧 葥 鳹 𩨊 鰬 仱 姏 蚙 軡 榩 乹 歬 潛 濳 銭 蕁 鈐 錢 鉗 飀
遣	浅 谴 缱 槏 撖 懺 蜸
欠	歉 倩 慊 茜 堑 芡 傔 嗛 椠 纤 篟 𬘬 棈 蒨 輤
亲	侵 钦 衾 骎 嵚 綅 瀙 锓
勤	琴 秦 禽 擒 芹 檎 懃 噙 芩 螓 鈙 嫀 斳 耹 靲 澿 庈 肣 蚙 軡 雂
寝	昑 寑 曋 螼 坅 顉
沁	揿 唚 菣
枪	腔 鎗 羌 呛 抢 锵 镪 蜣 跄 斨 玱 椌 蹡 锖 矼 𡺃 将 牄 謒
强	墙 蔷 戕 墙 嫱 樯 爿 漒 蘠 𪪞 彊
强	抢 襁 磢 傸 墏 𫄶
呛	羻 唴 炝
清	青 轻 倾 卿 氢 蜻 顷 鲭 圊 氰 狅 郬
情	晴 擎 倾 檠 勍 殑 樈 殌
请	顷 庼
庆	罄 亲 凊 綮 謦 磬 漀 汫 鑋 靘 掅 碃 罊
其	期 齐 奇 旗 骑 祈 棋 祺 碁 祁 崎 琦 岐 歧 琪 麒 鳍 畦 脐 祇 耆 淇 跂 枝 綦 骐 衹 蕲 圻 锜 旗 萁 蜞 埼 墘 蛴 颀 懠 艩 蚔 𬨂 藄 鄿 鲯 鬐 蚑 𫓹 掑 岓 埼 翗 釮 亓 蚚 稘 鬿 踑 鮨 鶀 鵸 玂 麡 濝 亝 刏 帺 斉 棋 檱 櫀 璂 禥 竒 粸 綨 芪 蜝 褀 齊 剘 弜 愭 斊 猉 綥 臍 薺 萕 蘄 蠐 鉶 錏 頎 騏 騎 鰭
起	启 岂 乞 绮 杞 稽 綮 屺 棨 敧 芑 婍 邔 芞 呇
企	气 器 汽 弃 契 砌 泣 迄 讫 汔 憩 缉 亟 葺 碛 栔 愒 妻 蟿 𬭭 盵 蚑 忔 湆 氣 諿 湇 甈 鼜 呚 噐 棄 憇 摖 炁 矵 磜 礘 呮 夡 敵 暣 磧 緝 訖
区	屈 驱 趋 躯 岖 曲 蛆 瞿 袪 敺 蛐 佉 砠 胠 岨 祛 呿 凵 抾 阹 镼 魼 𫛵 鱋 紶 髷 伹 區 坥 岴 憈 虗 袦 𫍮 趨 軀 駈 嶇 覷 詘 駆 驅
缺	阙 蒛
却	确 鹊 雀 怯 阙 榷 搉 恪 壳 阕 悫 埆 確 碏 碻 𬒈 硞 皵 毃 礭
圈	悛 棬 弮 絟 惓
全	权 泉 诠 拳 铨 痊 颧 蜷 筌 卷 荃 鬈 牷 辁 佺 犬 踡 醛 恮 婘 犈 觠 𩧴 巏 齤 蠸 姾 瑔 跧 縓 灥 孉 搼 権 洤 湶 硂 酫 騡 權 蒊 詮 輇 銓 顴 鳈
犬	绻 甽 畎 琄 虇 汱 圈
劝	券 牶 烇 絭
逡	踆 峮
羣	裙 宭
芎	穹 銎
穷	琼 芎 穹 跫 蛩 惸 邛 璚 䓖 瞏 茕 筇 輁 藑 桏 赹 笻 橩 蒆
渠	劬 曲 衢 蟝 瞿 籧 璩 氍 蘧 磲 蕖 朐 軥 鸲 翑 葋 豦 懅 螶 鼩 匷 灈 欋 臞 蠷 躣 胊 斪 淭 菃 翵 戵 爠 璖 癯 豞 鑺 鸜 曲 鴝
取	曲 娶 龋 浀 紶
去	趣 娶 漆 觑 阒 湨 麮 刞 鼁
西	希 吸 携 嘻 牺 稀 悉 溪 析 蟋 熙 禧 膝 栖 厘 嬉 兮 犀 晰 羲 畦 曦 僖 蜥 扱 熹 奚 盻 觿 𫍻 晞 欷 蹊 樨 巇 淅 皙 唏 烯 傒 徯 恓 窸 粞 豨 醯 鼷 氥 浠 潝 燨 瓗 疧 酅 媐 巂 悕 睎 硒 蠵 𫔔 榽 歖 爔 琋 螇 俙 徆 怷 娭 屖 谿 莃 菥 僁 橀 螝 豯 貕 鵗 𫘬 𫘱 郋 桸 惁 凞 闟 诶 礂 厀 噏 嬆 嵆 嵠 忚 愾 扸 攜 擕 焁 焈 熈 熺 熻 犧 瞦 胿 蒵 讗 豀 鏭 隵 黊 滷 唽 怸 璽 繥 舾 觹 觽 錫 騒 鬶
瞎	虾 岈 颬 鍜
暇	峡 辖 霞 侠 狭 挟 匣 呷 遐 硖 狎 瑕 斜 黠 柙 祫 洽 舝 碬 騢 搳 烚 冾 笚 縖 珨 陕 磍 赮 魻 蕸 俠 峽 炠 狹 睱 縀 鎋 陿 𫚥 硤 筪 翈 轄 鏐 陝
下	夏 吓 厦 暇 罅 芐 欱 鏬 鶷
些	歇 蝎 蠍 猲 褉 嗋
协	鞋 斜 胁 谐 邪 偕 颉 挟 絜 携 撷 勰 缬 襭 𣍰 慀 劦 蝢 垥 拹 籺 奊 龤 愶 搚 瑎 熁 燲 恊 挾 旪 綊 翓 脇 衺 鞵 擷 纈 脅 膎 裃 裄 裇 褌 諧 頡
写	血
谢	械 泄 屑 泻 懈 卸 泄 蟹 解 屉 亵 榭 契 骇 廨 渫 邂 燮 楔 絏 薤 绁 媟 嶰 澥 瀣 獬 躞 灺 疶 鞢 骱 駴 偰 檞 𬹼 伳 妎 祄 榍 韰 屧 焎 揳 齥 躠
消	销 萧 潇 宵 逍 嚣 箫 硝 霄 哮 骁 枭 蟏 枵 魈 鸮 哓 绡 嘐 歊 㴋 烋 獢 虓 蛸 痚 𢙒 灱 呺 穘 洨 涍 痟 萷 踃 膮 藃 櫹 髇 𪵑 虈 庨 啋 窙 顤 謼
学	洨 笅 郩
小	晓 筱 筿 𫍲
校	笑 孝 效 酵 啸 肖 傚 恔 熽 踍
修	休 羞 修 咻 庥 貅 髹 馐 鸺 滫 樇 臹 茠 銝 蓨 鎀 潃
朽	宿 糔
秀	绣 锈 袖 嗅 宿 臭 锈 琇 溴 岫 珛 玊 殠 褎 螑
先	仙 掀 鲜 纤 暹 姗 孅 𪫺 跹 铦 籼 韱 枮 氙 馦 嬐 仚 屳 奾 杴 忺 澖 灦 祆 僊 嘕 蓒 褼 廯 襳 珗 硟 秈 纎 苮 鱻 纖 薟 躚 蹮 酰 𫑷 銽 鍁 鮮
贤	闲 嫌 鹹 咸 弦 衔 弦 娴 娴 涎 啣 舷 闲 痫 𫍯 蚿 憪 鹇 娹 葴 胘 蛝 羬 燅 礥 鹇 唌 婱 甉 痃 藖 衘 贒 輱 醎 嫺 癇 稴 臤 銜 賢 閒 鷳
险	显 鲜 癣 藓 铣 燹 跣 崄 蚬 姺 尟 幰 猃 狝 𤞤 筅 韅 毨 烍 鍌 搟 鼸 𫜮 赻 攇 禒
县	现 线 限 宪 献 羡 陷 腺 馅 蚬 苋 霰 伣 僩 岘 𬀪 𪾢 豏 轞 鋧 涀 瀗 粯 娊 𪭾 錎 姭 咞 𠯟 垷 悓 橌 獻 絤 线 臔 誢 饀 𪎉 縣 憲 峴 櫶 現 線 臽 莧 見 軐 餡
心	新 辛 薪 欣 锌 馨 鑫 莘 炘 歆 芯 昕 䜣 鈊 盺 兟 𫷷 忻 妡 噷
寻	𬩽 杺 攳 襑
信	衅 芯 焮 舋 膷 囟 妡 煡 阠
乡	相 香 箱 湘 襄 镶 厢 骧 缃 芗 瓖 𬙋 欀 葙 忀
详	祥 降 翔 庠
想	响 享 饷 飨 鲞 𫗵 晑
巷	向 相 像 项 象 橡 向 向 蚃 萫 闀 蟓 襐 鐌 乡 恦 潒 鱌
兴	星 猩 腥 馨 惺 骍 煋 瑆 勝 垶 蛵 觲 馫
行	形 型 刑 邢 陉 硎 铏 饧 侀 烆 洐 胻 鋞 濴
省	醒 擤 渻
行	兴 性 幸 姓 杏 幸 悻 荇 婞 莕 涬
习	昔 息 席 惜 媳 锡 袭 熄 席 褶 檄 觋 隰 裼 嶍 螅 鳛 臘 槢 焟 謵 鎴 欯 棤 蒠 瘜 獥 薂 霫 飁 騽 蝷 榏 漝 焬 獵 趘 習 怸 椺 襲 覡 趞
喜	洗 徙 玺 鳃 屣 蓰 囍 枲 蟢 𫄳 𫄥 蹝 酾 匚 狶 𫍰 簁 葸 漇 敼
细	戏 系 系 系 夕 汐 隙 歙 阋 翕 穸 咥 屭 绤 肸 鄎 醯 饩 滊 褉 酅 潟 舄 矽 𫔔 卌 怬 釸 鎎 𨰿 赩 郤 𪸕 覤 蕮 黖 謑 虩 忥 恄 摡 禊 齂
须	需 虚 须 嘘 墟 戌 胥 𬣙 籲 歔 盱 媭 𦈡 殈 旴 呴 楈 嬬 鑐 欨 倠 稰 縃 蝑 蕦 驉 魖 晇 幁 揟 糈 偦 噓 欰 疞 竬 虗 虛 譃 褜 褝 須 頊
薛	靴 噱 峃 吙
学	穴 鸴 觷 踅 燢 泶 壆
雪	鳕
血	雪 穴 削 趐 泬 謞 岤 袕
宣	轩 喧 瑄 萱 暄 埙 儇 谖 埙 嬛 揎 翾 諠 愃 晅 鍹 𬸣 梋 煖 萲 愋 佡 昍 𫓶 媗 禤 蝖 蠉 矎 亙 吅 喛 弲 煊 睻 箮 翧 蕿 藼 蘐 𣈶 𫍽 諼 軒
玄	旋 悬 漩 璇 璇 伭 妶 琁 玹 嫙 誸 还 县 蜁
选	咺 烜
炫	绚 漩 眩 泫 渲 旋 眴 楦 敻 铉 衒 蔙 駽 鞙 旋 昡 楥 袨 縼 讂 贙
勋	薰 熏 燻 醺 峋 曛 焄 獯 𫄸 臐 蔒 勋 矄
寻	巡 询 循 旬 驯 浔 珣 𫊻 洵 荀 徇 恂 峋 栒 𬊈 璇 𬘓 郇 鲟 槆 挦 枔 咰 𬍤 橁 荨 㖊 伨 偱 廵 杊 毥 狥 駨 鱏 尋 潯 畃 詢 馴 魢 鱘
讯	训 迅 逊 殉 驯 徇 巽 汛 蕈 噀 侚 潠 韗 迿 鵔
兄	凶 胸 兇 匈 汹 忷 哅 恟
雄	熊 赨
敻	诇
许	栩 煦 咻 诩 冔 姁 湑 谞 醑 鄦 珝 喣
序	续 蓄 绪 叙 絮 旭 恤 恤 酗 婿 畜 洫 旮 侐 慉 溆 藚 顼 芧 藇 魆 勖 勗 訹 𫚈 烅 怴 垿 窢 瞲 𫓰 沀 昫 瞁 伵 敘 壻 敍 槒 汿 潊 珬 盢 稸 緖 聟 賉 嘼 緒 續 肷
之	知 只 织 支 枝 汁 只 吱 芝 脂 肢 蜘 祇 栀 祗 氏 枳 ㄓ 胝 鸱 卮 搘 秖 蹠 泜 𫛛 汥 秪 榰 胑 衼 椥 坧 巵 梔 祬 秓 馶 鵄 鼅 倁 擲 疷 織 𪉆
渣	扎 喳 楂 查 齇 柤 皻 抯 挓 樝 𫍹
扎	札 扎 闸 炸 霅 铡 哳 劄 蚻 譗 蠿
眨	渣 鲊 厏 苲
榨	栅 炸 诈 乍 搾 蚱 咋 蠟 咤 溠 砟 醡 鲊 痄 簎
遮	螫 晢 嫬
折	哲 折 慑 褶 谪 辄 摘 辙 慴 蜇 磔 乇 詟 晢 𫚚 耴 悊 砓 謺 虴 鸅 讘 瓋 喆 嚞 埑 籷 讁 輙 銸 厇 啠 歽 蟄 𫌇 謫 輒 轍 驝
者	赭 锗
这	浙 蔗 鹧 柘 宅 檡 烢 蟅
著	遮 晢 嫬
摘	斋 齐 捚
宅	翟
窄	岝
债	寨 祭 责 瘵 砦
朝	招 昭 召 著 嘲 钊 駋 𬬿 晁 盄 鍣 妱
找	沼 爪 菬 瑵
照	赵 召 罩 兆 肇 诏 晁 笊 櫂 炤 雿 狣 棹 箌 𫛱 垗 旐 曌
周	周 州 洲 舟 粥 赒 啁 盩 诪 辀 喌 騆 鸼 洀 淍 𫟻 珘 徟 𫐏 侜 婤
轴	妯
帚	肘 睭 𫚡
昼	皱 宙 纣 绉 胄 咒 繇 甃 籀 咮 酎 僽 怞 胄 噣 𩧨
詹	沾 瞻 毡 沾 旃 谵 鳣 觇 邅 栴 鹯 𫘰 佔 呫 𫗴 钻 𧮪 薝 譠
展	斩 盏 辗 搌 崭 琖 魙 醆 飐 椫 皽 蹍 嫸 榐 橏
占	战 站 暂 佔 栈 颤 湛 绽 𫏐 蘸 虥 轏 輚 偡
真	针 珍 贞 侦 祯 斟 箴 砧 甄 臻 桢 榛 诊 蓁 獉 溱 碪 胗 针 鱵 媜 駗 薽 禛 樼 潧 瑊 遉 寊 蒧 轃 籈 鷏 堻 嫃 帪 揁 搸 昣 栕 珎 真 蒖 酙 𨱅 錱 靕 偵 儬 楨 湞 禎 貞 針 闓
诊	枕 疹 轸 畛 袗 缜 稹 紾 鬒 眕 黰 辴 抮 抌 笉 絼 祳 晸 縥 黕
镇	阵 振 震 赈 朕 枕 鸩 揕 酖 眹 娠 侲 挋 栚 蜄 桭 𫍨 敶
张	章 彰 漳 樟 璋 獐 嫜 暲 鄣 蟑 𫠒 慞 傽 墇 騿 遧
长	掌 涨 仉 绱
丈	仗 帐 障 账 胀 杖 涨 幛 瘴 嶂 扙 瞕 粀
争	徵 蒸 睁 征 挣 筝 正 怔 狰 铮 峥 诤 症 钲 烝 篜 姃 炡 埩 聇 丁 眐
整	拯 氶 撜 糽
郑	正 证 政 证 症 挣 帧
珠	朱 诸 株 猪 蛛 茱 朱 诛 铢 侏 洙 潴 邾 橥 槠 祩 𫉄 絑 袾 觰 鴸 蠩 蝫 鮢 藸
抓	挝 髽 檛
捉	桌 涿 棹 穛
卓	茁 浊 拙 濯 酌 灼 著 啄 镯 擢 琢 诼 倬 斲 斮 棁 椓 焯 蝃 踔 𬸦 彴 汋 斫 禚 篧 浞 棳 謶 錣 啅 罬 斀 蠗 圴 剢 灂 嚉 妰 撯 擆 斵 晫 梲 槕 泎 炪 烵 琸 硺 籱 丵 仢 劅 斱 濁 犳 繳 訒 諑 鉵 䦃 鐲
追	锥 椎 隹 骓 鵻 腄 鴭
缀	坠 赘 缒 惴 餟 硾 膇 鑆
专	砖 耑 颛 塼 𫑘 𫚋 剸 嫥 瑼 篿 鷒 䏝 蟤
转	啭
传	赚 篆 撰 譔 馔 僎 瑑 䌸 腞
谆	屯 肫 窀 迍 宒 訰
准	準 隼 埻 𬘯
装	庄 桩 妆 粧 莊 梉
状	壮 撞 戆 焋
中	钟 终 忠 钟 衷 忪 盅 螽 伀 妐 蔠 柊 煄 彸 舯 炂 籦
种	肿 冢 踵 冢
中	种 重 仲 众 尰 湩 狆 衶 偅 堹 𫟆
竹	筑 逐 烛 蠋 築 竺 术 躅 舳 轴 窋 蓫 笁 趉 鱁 灟 𧑏 茿 篫
主	属 煮 嘱 贮 渚 瞩 著 麈 拄 瘃 𣃁 砫 陼 𡠟 壴 罜 𣚚 濘 𪾣
住	著 助 注 祝 驻 注 柱 蛀 铸 炷 薴 伫 箸 杼 纻 翥 寧 柷 羜 馵 疰 莇 鉒 紸 嵀 跓 軴 樦 麆 櫡 殶 諔 壓 嗻 拀 着 𥩟 筯 鋳 霔 飳 佇 坾 苧 訒 訩 詗 詖 譸 讅 諝 貯 鑄 駐
直	职 质 值 植 执 殖 掷 姪 侄 跖 蛰 踯 桎 埴 稙 摭 絷 柣 犆 秷 擿 馽 慹 樴 膱 懫 蟙 褁 瓡 嬂 蘵 値 儨 執 漐 禃 聀 貭 釞 擲 瓆 縶 職 譛 躑 軄 鰚
只	指 纸 止 旨 址 征 祇 趾 祉 咫 枳 酯 恉 沚 阯 芷 黹 轵 疻 晊 厎 坁 藢 栺 淽 滍
至	制 治 志 制 致 置 智 秩 志 稚 质 峙 致 帜 滞 挚 窒 炙 痔 雉 识 懥 痣 轾 骘 帙 陟 知 寘 忮 桎 踬 蛭 贽 鸷 厔 锧 豸 庤 彘 猘 畤 疐 紩 觯 郅 铚 偫 跱 遰 鋕 𬃊 袟 騺 淛 狾 礩 胵 膣 螲 挃 洷 覟 庢 鴙 迣 翐 臸 𫘠 祑 觢 鴩 垁 妷 娡 崻 徏 恎 搱 洔 熫 秲 稺 穉 筫 綕 袠 豑 隲 劕 幟 徝 摯 旘 櫛 滯 芖 觗 觶 譲 識 質 贄 躓 輊 馕 驇 騭 鯯 鷙
喫	蚩 痴 癡 嗤 吃 ㄔ 郗 魑 笞 𫄨 鸱 媸 摛 瓻 螭 眵 齝 離 貾 𫍧 瞝 齹 黐 麶
差	插 叉 喳 艖 嗏 扠 杈 偛 疀 𫟿
查	察 茶 搽 槎 锸 碴 臿 垞 秅
诧	岔 刹 差 汊 衩 蠟 侘 姹 紁
车	砗 莗
扯	撦 奲
彻	澈 辙 撤 掣 坼 屮 迠 硩
拆	钗 差 偨
柴	豺 侪 祡 喍
虿	袃 囆
抄	钞 超 勦 弨 怊 訬 剿 罺
朝	潮 巢 嘲 晁 樔 轈 鄛
吵	炒 眧
抽	瘳 搊 𥬠 犨 婤
愁	仇 筹 绸 酬 稠 䌷 踌 畴 惆 裯 俦 雠 帱 鯈 䓓 𫝩 椆 絒 菗 㤽 詶 雔 燽 栦
醜	丑 瞅 杻 杽 吜 莥
臭	簉 溴 殠 憱
搀	梴 襜 辿 鋓 惉 嬓 欃
缠	蝉 禅 馋 谗 潺 蟾 巉 婵 单 澶 廛 孱 劖 毚 瀍 瀺 躔 镵 磛 艬 僝 棎 湹 鋋 煘 獑 繵 嚵 酁 單 単 嬋 潹 緾 纒 鄽 鯅 禪 纏 蟬 誗 讒 镚 鐔 饞
产	铲 阐 铲 蒇 啴 冁 丳 𡶴 𬊤 谄 骣 𪩷 𦈎 浐 簅 灛 旵 𫟠
忏	羼 儳
嗔	琛 瞋 郴 𫎩 棽 謓 諃 搷 堔
陈	沉 晨 臣 尘 辰 娠 忱 宸 谌 煁 茞 𫈟 樄 莐 愖 鈂 螴 麎 𫜀 伔 敶
捵	碜 鍖 裖 墋 踸 贂
趁	称 衬 榇 谶 疢 龀 嚫 藽 𠋆
昌	倡 猖 娼 阊 菖 鲳 伥 鼚 锠 淐 琩 裮
长	常 场 尝 裳 偿 肠 嫦 鲿 徜 尝 苌 鋿 粻
场	厂 敞 氅 昶 𬬮
唱	倡 畅 怅 鬯 韔
称	撑 瞠 蛏 偁 柽 赪 琤 橕 鏿 浾 埥 棦 牚 竀 崝 饓
成	程 承 盛 乘 诚 呈 城 惩 澄 橙 丞 澂 枨 酲 宬 晟 裎 郕 埕 掁 浈 珵 荿 騬 脀 脭 揨 峸 铖 塍 乗 堘 塖 娍 崢 懲 挰 晠 椉 洆 瀓 珹 筬 棖 畻 誠 鋮
逞	骋 悜 庱 塣
称	秤 偁 牚
出	初 出 䝙
绰	辍 龊 婼 啜 惙 歠 醊 婥 畷 逴 娖 吷 珿 磭 腏 趠 擉 𪢕
踹	嘬
吹	炊
垂	锤 槌 搥 椎 陲 锤 捶 棰 箠 圌 湷 倕 菙 缍 娷 腄 甀
吹	炊 諈
穿	川 鐉 氚 瑏
传	船 遄 椽 歂 𫍱 暷 輲
喘	舛 荈
串	钏 玔 汌 賗
春	椿 杶 輴 焞 䲠 媋 暙 鶞
纯	脣 醇 淳 莼 鹑 漘 𬭚 唇 憌 鯙
蠢	惷 踳 偆 萶
窗	创 疮 囱 憃 戗 𪭢
牀	幢 撞 橦
闯	抢 漺
创	闯 怆 刱 𪺷
充	冲 冲 舂 忡 憧 珫 茺 浺 蹖 祌
重	崇 蟲 虫 種 翀 蝩 隀 繭 痋
冲	铳 揰
除	储 厨 锄 橱 雏 刍 躇 滁 蹰 篨 耡 蜍 鉏 蒢 跦 鶵 幮 䝙 趎 犓
处	楚 储 础 杵 褚 楮 濋 檚
处	触 畜 绌 矗 黜 俶 怵 搐 歜 诎 鄐 斶 亍 豖 泏 琡 踀 滀 儊 臅 敊
持	池 迟 驰 匙 弛 墀 坻 踟 箎 茬 蚳 篪 蚔 茌 痄 忯 汦 荎 栘 歭 耛 貾 趍 箈 徲 謘 徥
尺	齿 耻 呎 侈 褫 欼 搋 蚇 恀 拸 姼 傂 誃 鉹 伬 𫛶
赤	翅 斥 饬 叱 炽 啻 傺 敕 眙 抶 饎 栻 遫 彳 跮 踅 鷘 乿 瘛 鉓 哧 淔 痸 懘 戠 摰 𠡠 恜 慗 慸 憏 杘 灻 烾 痓 糦 翄 腟 趩 侙 卙 旘 熾 翤 飭
失	施 师 诗 湿 湿 狮 尸 ㄕ 虱 嘘 蝨 屍 蓍 葹 鸤 邿 湤 𫄟 𫚕 浉 鶳 箷 褷 襹 蛳 師 瑡 籭 蒒 釶 鍦 溼 獅 褜 詩 釃 魳 鲺 鯴 鰮
杀	沙 纱 砂 莎 煞 鲨 裟 杉 痧 铩 𫚌 榝 猀 帴 𢫬 蔱 硰
煞	霎 厦 嗄 歃 箑 翣 萐 喢
奢	赊 奓 檨 譇
蛇	舌 甚 佘 什 揲 铊
舍	舍
社	设 射 涉 舍 摄 赦 歙 麝 厍 猞 滠 蔎 韘 騇 拾 叶 捑 蠂
骰	繺
晒	曬 閷 杀
烧	稍 梢 艄 捎 弰 蛸 莦 筲 旓 髾 輎 鮹 蕱
杓	韶 芍 勺 玿 圴 牊
少	绍 哨 邵 召 卲 劭 袑 睄 潲
收	荍
手	首 守 掱 艏
受	售 寿 兽 授 瘦 狩 绶
山	扇 衫 杉 删 珊 膻 舢 煽 潸 跚 姗 芟 苫 搧 掺 縿 䅟 挻 烻 狦 笘 剼
闪	陜 睒 晱 覢
善	扇 汕 擅 膳 缮 鄯 煽 讪 单 赡 疝 鳝 骟 𫮃 嬗 掞 摲 𫍸 墡 钐 蟺 赸 儃 僐 彡 磰 蟮 譱 饍 鱓 傓 撣 禪 繕 蔶 訕 贍 釤 騸 鱔
身	深 伸 申 绅 呻 信 参 娠 莘 甡 侁 籸 葠 诜 𬳽 燊 砷 柛 氠 屾 珅 胂 阠 妽 峷 眒 叄 參 叁 叅 扟 籶 薓 𬬹 敒 甧 瘆 紳 裑 訷 詵 鮴 鵢
神	甚
沈	审 婶 沈 谂 谉 矧 哂 采 瞫 邥 覾
慎	肾 渗 甚 蜃 沁 葚 椹 脤 抻 侺 𫓵
商	伤 殇 觞 汤 漡 蔏 螪 謪 鬺
赏	晌 上
上	尚 爙 姠 仩
生	声 胜 升 牲 升 甥 笙 升 泩 鉎 鼪 呏 狌 湦 焺 鵿
绳	渑 憴 譝 鱦 溗
省	眚 冼 箵 偗
胜	盛 圣 剩 嵊 乘 賸 聖 貹
书	输 殊 舒 梳 疏 蔬 枢 纾 抒 摅 姝 樗 摴 殳 杸 陎 𦈌 橾 祋 𨐅 鵨 藲
刷	唰 鮛
朔	硕 烁 数 铄 嗍 率 蟀 帅 搠 妁 槊 箾 蒴 勺 欶 揱 獡 𫔈
摔	衰 缞 孈
率	帅 蟀 咰 𫄴
谁	脽
说	睡 税 蜕 帨 涚 裞
栓	闩 拴
盾	楯 吮 揗 䞐
顺	舜 瞬 蕣 鬊 瞚
双	霜 孀 艭 骦 鷞 𪥫 礵
爽	塽 樉 漺 慡 縔
叔	熟 淑 塾 赎 孰 菽 秫 襡 埱 焂 跾 鸀 虪
数	鼠 属 暑 署 薯 蜀 黍 癙 潻 𫉄 钃 婌 襩 糬 韣
术	数 树 束 述 署 竖 疏 恕 庶 曙 墅 漱 倏 戍 澍 翛 沭 裋 𬬸 尌 儵 鏣 鶐
十	什 石 时 实 食 拾 蚀 硕 射 提 莳 湜 鲥 埘 祏 鼫 鉐 榯 湁 𪶄 鼭 寔
使	始 史 驶 矢 屎 豕
市	是 事 世 士 势 识 室 示 试 视 式 氏 适 释 饰 侍 誓 逝 嗜 恃 仕 柿 使 螫 弑 噬 拭 豉 媞 筮 舐 轼 谥 贳 奭 戺 澨 𬤊 襫 铈 揓 𫟸 唑 翨 銴 谥 遾 簭 鳀 齛 跩 烒 崼 徥 詍 戠 褆 衋 冟 勢 卋 卶 呩 嬕 弒 昰 柹 狧 眎 眡 舓 餙 餝 䴓 丗 兘 叓 啇 眂 睗 蒔 薭 視 識 試 諡 貰 軾 釋 鈰 飾
惹	喏 若
热	渃
饶	荛 娆 桡 蛲 𫋹
绕	遶 隢
柔	揉 韖 蹂 𫐓 楺 禸 葇 𫔄 鞣 騥 鶔 媃 蝚 鰇
糅	鍕 粈 煣
然	燃 髯 蛅 蚺 袡
染	冉 髯 苒 珃 橪 呥 姌 嫨
人	任 仁 壬 纴 兒 芢 銋
忍	稔 荏 腍 棯 栠 荵
任	认 刃 饪 赁 轫 衽 纫 妊 恁 仞 讱 韧 牣 鵀 屻 肕 軠
攘	禳 穰 勷 瀼 瓤 儴 獽 蘘 躟 鬤 蠰
嚷	壤 攘 爙
让	懹
仍	礽 陾
若	弱 箬 偌 𦶟 鄀 篛 蒻 楉 鶸
蕤	緌 婑
蕊	橤 繠 惢 桵
瑞	锐 芮 睿 蚋 叡 枘 汭
堧	壖 撋
软	阮 蠕 耎 蝡 瓀 緛 礝 朊
润	闰 橍
容	荣 融 溶 绒 熔 戎 蓉 镕 茸 榕 羢 嵘 瑢 肜 毧 狨 瀜 茙 烿 蝾 𫞡 媶 榵 褣 駥 髶 𫚦 鷛 峵 嵤 搑 曧 穁 縙 榮 螎 鳙 嶸 栄 絨 蠑
冗	茸 氄 傇 軵
如	儒 孺 茹 蠕 嚅 濡 袽 襦 𫛪 筎 臑 醹 挐 薷 铷 曘 燸 帤 蕠
乳	汝 辱 擩 女 侞
入	辱 褥 孺 茹 洳 缛 蓐 溽 鄏 媷 嗕
日	衵 驲 鈤
资	兹 滋 吱 姿 諮 孜 咨 赀 玆 ㄗ 辎 淄 龇 缁 孳 粢 髭 嵫 菑 镃 鹚 鼒 孖 𫞚 甾 鄑 鲻 锱 趑 椔 鈭 鶅 齍 栥 紎 崰 秶 𧏗 茲 姕 孶 葘 赍 賷 鍿 頿 斊 湽 禌 稵 緇 茊 諮 豶 貲 資 輺 輜 錙 頾 鯑 𫚤 鯔 鰃 鹚 齜
扎	匝 咂 唼 嘁 抸 𫓬
杂	咱 砸 偺 雥 磼
则	责 择 泽 啧 窄 舴 咋 帻 笮 赜 迮 崱 荝 謮 蠌 贼 蠈
仄	侧 昃 庂 稄
灾	栽 哉 渽 賳
仔	宰 崽 载 縡
在	再 载
遭	糟 蹧 傮
早	枣 澡 藻 蚤 璪 缲
造	皁 燥 噪 慥 噪 竈 躁 皂 趮 矂
邹	诌 鄹 诹 啁 掫 菆 陬 驺 鲰 棸 緅 棷 郰 㛀 黀 齱 齺
奏	骤 揍
簪	鐕
咱	偺 糌
拶	攒 寁 昝 禶 喒 儹 揝 礸
赞	暂 赞 錾 瓒 𪴙 酂 饡 𪷽 囋 趱
脏	赃 臜 牂 臧
藏	脏 葬 奘
曾	增 憎 罾 缯 矰 橧 磳 𫘯 璔
赠	甑
租	蒩
昨	作 砟 椊 筰 稓 葃
左	佐 𦈛
做	作 坐 座 酢 祚 凿 柞 怍 胙 阼 葄 夎
堆	厜 羧 嶉 𫄹
嘴	璻 觜 嶊 噿 濢
最	罪 醉 檇 蕞 晬 檌 絊 祽 鋷 墬 嶵
钻	躜
纂	钻 缵 籫 儹
赚	钻 攥 饡
尊	遵 樽 墫 𨱔 嶟 繜 𫜄 壿
撙	噂 墫 僔 譐
俊	圳 捘 鳟 銌 燇
宗	踪 纵 综 棕 鬃 𫎆 騣 鬷 翪 熧 倧 惾 猣 稯 艐 嵕 蝬
总	摠 偬 熜 朡 蓗
纵	糉 综 从 疭 昮
足	族 卒 嗾 捽 崒 踿 哫 傶 踤
组	祖 阻 俎 诅 珇 靻
子	仔 紫 梓 籽 滓 耔 訾 笫 秭 胏 茈 吇 杍 芓 呰 矷 𫓦 訿
自	字 恣 渍 眦 孳 剚 胔 胾 扻 倳 牸
疵	庛 雌 ㄘ 差 趀 骴
擦	搽 嚓
册	策 测 侧 厕 恻 䇲 畟 茦 粣 拺 矠 憡 蓛
才	财 材 裁 才
采	彩 採 睬 踩 彩 跴 采 棌 婇
蔡	菜 采 採 縩
操	糙 鄵 喿
曹	槽 嘈 漕 螬 艚 嶆
草	懆 騲 艸
糙	操 肏 襙
凑	辏 腠 楱
参	餐 骖
残	蚕 惭 嬠
惨	憯 朁 噆 黪
灿	孱 璨 粲 澯
参	㟥 梫
岑	涔 梣 笒 埁
苍	仓 沧 舱 伧 鸧 凔 嵢
藏	鑶
曾	层 嶒 鄫 碀
粗	麤 觕
搓	撮 磋 蹉 蒫 遳 髊
瘥	矬 鹾 痤 醝 嵯 蔖
瑳	脞 縒 硰
错	措 挫 锉 撮 剉 厝 莝 侳 剒 𫜬 蓌
摧	催 崔 嗺 墔 磪 鏙 榱 衰
凗	慛
璀	趡 漼
翠	脆 粹 悴 瘁 萃 啐 淬 倅 毳 橇 焠 竁 膬 綷 膵 脺 濢
撺	蹿 鋑
攒	巑 劗
窜	篡 爨 篹
村	皴
存	袸
忖	刌
寸	吋 籿
匆	聪 从 囱 璁 𪻐 枞 骢 苁 𫓩 熜 棇 暰 葱 瞛 蟌 鍐 囪 忩 怱 悤 楤 樬 漗 焧 燪 総 緫 繱 聡 聦 聰 蔥 鏓 騘 樅 禕 篵 蓯 鍯 驄
从	丛 淙 琮 悰 潀 漎 賨 𫓽 婃 孮 徖 慒
欉	藂 謥
殂	徂
促	醋 簇 蹴 蔟 蹙 猝 卒 错 趣 趋 镞 瘯 踧 槭 梀 噈 窣 殧 鼀
词	辞 慈 磁 瓷 雌 祠 疵 茨 粢 糍 柌 嬨 濨 呲 飺 薋
此	佌 泚 玼 跐 皉
次	刺 赐 厕 伺 佽 蛓 莿 朿 栨 蠔 絘
司	思 斯 丝 私 撕 厮 鸶 嘶 ㄙ 澌 缌 偲 罳 飔 禠 虒 楒 锶 凘 泀 蕬 鉰 私 覗 榹 禗 蜤 磃 謕 蟴 鷈 鼶 廝 厶 媤 恖 簛 蟖 騦 絲 噝 緦 螄 鐁 鑓 鍶 鷥
撒	仨
洒	撒 靸 灑
萨	卅 趿 飒 攃 馺 隡
色	塞 瑟 圾 啬 涩 穑 濇 轖 𰶎 铯 璱 翜 𪺭 𫗋 濏
鳃	腮 毢 揌
赛	塞 僿
艘	骚 缫 搔 臊 慅 溞 𩙫 𫚫
扫	嫂 埽
扫	氉 瘙
搜	飕 鄋 搜 廋 溲 馊 獀 醙 嗖 锼 𩨄
叟	嗾 薮 擞 瞍 𫍲 䉤
三	参 毵 攕 𩭹
散	伞 繖 糁 𫔌
散	𨸃
森	参 椮 罧 襂 㡎 𥮾
丧	桑
嗓	颡 搡 磉 鎟 褬
僧	鬙
苏	苏 酥 稣 苏 櫯
缩	梭 莎 唆 娑 蓑 嗦 傞 挲 蓑 桫 蹜 莏 趖 摍
所	索 锁 琐 璅 唢 摵 𫔅 鏼
虽	绥 濉 睢 荽 毸 眭 浽 哸 娞 荾 滖
随	隋 雟
髓	嶲 瀡 巂 靃
岁	遂 碎 穗 隧 祟 燧 谇 睟 穟 璲 檖 襚 𬭼 邃 埣 賥 檅 繀 禭 旞 䍁 鐆
酸	酸 狻
算	蒜 筭
孙	飧 荪 狲 搎 槂 薞 蕵
损	笋 榫 簨 鎨
潠	𢙏
松	松 淞 嵩 忪 菘 娀 崧 濍 倯 硹 蜙
耸	怂 悚 竦 傱 愯 嵷 駷
送	宋 颂 讼 诵
诉	速 素 肃 宿 塑 夙 粟 溯 𫗧 愬 蓿 觫 愫 膆 谡 嗉 橚 溯 涑 㴋 簌 蔌 樕 遫 骕 鱐 鹔 嫊 玊 榡 洬 栜 傃 溹 憟 𨱈 縤 藗 僳
四	似 赐 嗣 饲 寺 肆 祀 俟 伺 泗 巳 耜 儩 姒 笥 驷 兕 涘 柶 汜 肂 貄 蕼 洍 佀 侶 孠 杫 𣽷 牭 禩 竢 𫟳 鈻 亖 娰 攺 逘 飼 駟
阿	ㄚ
啊	阿
喔	ㄛ
阿	婀 疴 ㄜ 屙 峉 锕
额	讹 鹅 娥 哦 蛾 峨 莪 俄 囮 吪 硪 蚵 锇 迗 珴 涐 皒 睋 魤
恶	饿 俄 鄂 厄 遏 锷 扼 鳄 颚 呃 愕 噩 轭 阨 鹗 垩 谔 萼 咢 哑 崿 搤 詻 阏 頞 堨 腭 枙 胺 堮 岋 鑩 櫮 砐 砨 蚅 豟 軶 圔 搹 蝁 嶭 餩 蘁
挨	哀 埃 唉 哎 ㄞ 诶
挨	皑 𫘤 敳
矮	蔼 霭 欸 毐 昹 佁
爱	碍 艾 暧 瑷 隘 嗳 乂 叆 僾 堨 嫒 𰾭 賹 濭 鴱 譪 诶 𫉁
凹	ㄠ 坳 柪
熬	敖 遨 翱 嗷 螯 鳌 鼇 鏖 骜 廒 獒 璈 聱 鏊 滶 磝 隞 摮 蔜 𫂃 謷 爊
袄	媪 芺 镺
傲	澳 奥 懊 墺 奡 扷 擙 詏 嶴
欧	瓯 殴 呕 讴 鸥 ㄡ 怄 区 𬉼 蓲 櫙
偶	藕 呕 耦 吘 湡 腢 蕅
呕	沤 噢
安	鞍 庵 谙 氨 铵 ㄢ 鹌 媕 侒 盦 峖 痷 腤 萻 韽 垵
雸	玵 啽
俺	唵 晻 堷
暗	案 岸 按 黯 庵 暗 犴 豻 匼 桉 洝 荌 錌 匎 婩 儑
恩	嗯 ㄣ
摁	體
肮	醃 ㄤ
昂	卬
軮	绑
盎	醠
鞥	ㄥ
ㄦ	儿
儿	而 洏 耏 胹 輀 侕 栭 陑 鲕 檽 聏 荋 唲 鸸
尔	耳 洱 饵 迩 珥 駬 薾 铒 峏 尒 栮
二	贰 佴 刵 咡 樲 聏 毦 眲 衈
一	壹 衣 依 医 伊 揖 噫 漪 猗 咿 ㄧ 祎 繄 黟 曀 铱 泆 鹥 欹 郼 圪 溰 稦 燚 洢 陭 蛜 嫛 瑿 檹 毉 黳 嶬 吚 壱 夁 嬄 弌 旑 訲 覎 覥 锿 銥
呀	压 鸦 鸭 押 丫 桠 煆 孲
牙	芽 涯 衙 蚜 押 枒 犽 齖 伢 堐
亚	哑 雅 挜 厊 庌 蕥 雃 疋
亚	讶 迓 砑 氩 娅 揠 铔 聐 轧 圠 襾 玡 猰 窫 𫜰
耶	噎 蠮
爷	耶 椰 琊 揶 擨
也	野 冶 埜 漜
业	叶 页 夜 咽 谒 拽 靥 邺 烨 瞱 𢬍 射 晔 馌 煠 鍱 鐷 澲 鎑 偞 殗 嶪 擛 亱 僷 墷 嶫 曗 枼 殜 爗 皣 瞸 餣 驜 鵺 鸈 業 譁 嚈 弽 曄 枽 燁 牃 礏 謁 鄴 靨 頁
崖	睚 啀 娾
要	腰 夭 妖 邀 麼 吆 哟 喓 祅 葽 𫍚
摇	谣 尧 遥 姚 洮 瑶 侥 淆 肴 飖 傜 繇 峣 徭 殽 猺 轺 爻 垚 崤 铫 珧 柼 猇 鳐 餚 媱 烑 窑 嗂 愮 榣 顤 倄 壵 嶤 幺 搖 暚 瑤 窯 蘨 鎐 餆 僥 堯 蛍 訤 謠 軺 遙 銚 靝 鰩
咬	窈 舀 夭 殀 杳 窅 窔 鷕 宎 抭 苭 眑 偠 溔 榚 騕 岆 嫍 蓔
要	药 耀 曜 钥 鹞 拗 燿 袎 靿 艞 覞 穾 筄 药 獟 趭
优	忧 幽 悠 呦 攸 耰 麀 櫌 鄾 懮 怮 嚘 瀀 纋 蚴
由	遊 游 尤 油 邮 犹 猷 铀 𬨎 疣 蚰 莸 斿 蝣 訧 逌 楢 鱿 優 沋 浟 偤 秞 莤 怣 櫾 滺 猶 肬 逰 駀 鲉 蕕 輏 邎 郵 醔 鈾 鞧 魷
有	友 酉 莠 牖 黝 羑 泑 铕 岰 庮 苃 聈 槱
又	右 幼 诱 佑 柚 釉 祐 有 宥 侑 囿 鼬 卣 姷 狖 峟 貁 鴢 擾 牰 迶
烟	焉 淹 殷 腌 咽 胭 奄 湮 烟 嫣 燕 蔫 阉 厌 崦 臙 鄢 漹 猒 珚 偣 嬮 酀 醃
研	言 颜 严 延 沿 炎 癌 盐 巖 筵 簷 阎 妍 蜒 檐 埏 喦 揅 碞 𫄧 郔 岩 孍 楌 礹 閰 娮 𫓪 狿 虤 𩖖 壛 麙 壧 莚 嵒 厳 塩 姸 嵓 巌 𪨷 櫩 琂 硏 蔅 詽 颜 麣 嚴 厃 厈 開 昖 鹽 襷 鉛 閆 閻 顏
眼	演 掩 衍 郾 偃 兖 甗 俨 魇 剡 弇 罨 沇 𪩘 扊 揜 渰 蝘 黡 姶 戭 棪 嬿 𫚢 鼹 琰 匽 厣 椼 抁 䶮 酓 嵃 愝 萒 隒 裺 褗 𬸘 黤 曮 惔 躽 馣 黭
验	燕 厌 晏 雁 宴 淹 艳 燄 彦 堰 砚 咽 咽 唁 餍 研 䜩 谚 沿 谳 焱 酽 赝 喭 滟 爓 闫 鷃 嬿 𫛩 醼 焰 牪 姲 鷰 椻 曣 恹 婩 傿 鴈 𪡋 𫘫 觾 艳 驠 莚 敥 偐 墕 妟 嬊 彥 暥 曕 灔 滟 𤇄 艶 豓 豣 赝 隁 騐 鳫 厭 囐 懕 灩 硯 襷 覀 觃 諺 讞 贗 釅 𫑷 饜 驗
因	音 阴 姻 殷 茵 慇 氤 瘖 喑 堙 愔 禋 𬘡 裀 𬮱 骃 铟 蒑 𬤇 垔 韾 洇 凐 歅 噾 霠 韽 黫 摿 侌 婣 栶 洕 溵 秵 筃 𦈑 陰 陻 隂 隌 鞇 囙 磤 蔭 銦 阥
银	吟 寅 淫 鄞 龈 檐 霪 垠 夤 狺 嚚 崟 訚 蟫 婬 冘 苂 𬬱 圁 烎 凐 荶 殥 蔩 𣘴 𫜃 鏔 噖 墾 斦 泿 滛 犾 璌 碒 訡 訔 鈝 銀 齦
引	饮 隐 尹 瘾 蚓 聽 靷 纼 𬙂 讔 趛 螾 馻 鈏 檃 濦 𦻕 粌
印	饮 隐 荫 胤 荫 窨 慭 湚 垽 𪺽 朄 酳
央	秧 殃 鸯 鞅 泱 坱 胦 柍 佒 姎 紻 𫓭 雵
杨	阳 扬 洋 羊 佯 烊 疡 钖 徉 飏 旸 炀 垟 昜 禓 蛘 玚 珜 鐊 崵 鸉 眻 婸
养	仰 氧 痒 鞅 卬 攁 岟 炴 抰 癢 懩 蝆
样	养 恙 漾 怏 炀 瀁 羕
应	英 鹰 婴 莺 樱 膺 瑛 鹦 嘤 罂 缨 撄 璎 嫈 甖 䓨 煐 韺 甇 霙 碤 礯 朠 蝧 渶 褮 偀 霒 蘡 譻 蠳 鶧 噟 媖 𫝭 𪧀 応 锳 鑍 鸎 嚶 嬰 應 攖 櫻 瓔 纓 罌 鶯 鋩 鷪 鸚 鷹
营	迎 蝇 萤 赢 盈 莹 萦 瀛 荥 嬴 茔 荧 楹 滢 潆 籯 瀯 謍 攍 巆 廮 藀 僌 櫿 溁 盁 籝 萾 蠅 営 瀅 耺 塋 滎 熒 螢 營 縈 鎣 贏 閈
影	景 颖 颍 瘿 郢 瀴 矨 梬 浧
应	硬 映 媵 滢 蓥 摬 賏
遗	疑 移 宜 怡 姨 仪 夷 谊 胰 贻 饴 咦 诒 沂 颐 彝 椸 痍 圯 嶷 笫 桋 匜 宧 洟 簃 𫍙 貤 迻 杝 柂 袲 酏 峓 眱 羠 鈶 寲 侇 珆 衪 銕 呲 恞 萓 沶 栘 瓵 袘 羨 蛦 暆 跠 歋 熪 箷 螔 顊 謻 觺 鸃 冝 凒 彛 扅 枱 泤 眤 竩 苐 迱 乁 儀 宐 巸 弬 沵 讉 詒 貽 遺 頉 頥 頤 飴 鮧 鴺
以	已 乙 倚 椅 矣 蚁 舣 迤 苡 偯 扆 旖 螘 扡 酏 鳦 钇 𬺈 𫖮 檥 鉯 迆 胣 𥐟 掜 陭 崺 晲 轙 呂 庡 笖 肔 苢 裿 𫐎 鈘 攺 艤 蟻 逘 锿 釔
意	义 易 议 亦 益 异 艺 亿 忆 译 液 役 翼 疫 毅 逸 邑 抑 肄 绎 溢 缢 轶 诣 屹 佚 翌 羿 驿 掖 懿 裔 臆 曳 奕 蜴 腋 衣 刈 翳 挹 镒 呓 弈 佾 乂 弋 艾 怿 劓 圛 斁 薏 悒 瘗 仡 勚 埸 峄 帟 曀 杙 枻 殪 浥 熠 艗 襼 饐 黓 亄 唈 燡 藙 豷 寱 阣 熤 劮 檍 嗌 廙 镱 鞥 醳 醷 翊 肊 異 枍 伿 浂 澺 芅 熼 玴 抴 蘙 俋 焲 燱 晹 垼 𬬩 捙 欭 埶 羛 隿 殔 跇 裛 嫕 緆 膉 靾 槷 潩 蓺 墿 𪽷 谥 𫄷 瀷 帠 槸 霬 鷾 齸 讛 豛 𨱁 阝 鯣 億 囈 嶧 憶 懌 悥 殹 痬 瘞 癔 繹 縊 藝 螠 讠 議 譯 詣 誼 豙 転 軼 鎰 鐿 驛 骮 鷧
屋	乌 污 污 圬 诬 呜 巫 钨 邬 洿 歍 ㄨ 恶 于 杇 陓 剭 窏 腛 𫛦 螐
哇	蛙 挖 洼 呱 娲 窪 穵 溛 窊 窐 漥
瓦	佤
袜	嗢 腽
窝	倭 涡 莴 猧 踒
我	婐 捰
握	卧 沃 渥 斡 龌 幄 涴 偓 濣 焥
威	崴 偎 煨 葳 隈 逶 烓 椳 渨 碨 愄 揋 葨 隇 溾 詴 蝛 覣 燰
为	围 微 危 唯 维 惟 违 韦 薇 巍 桅 闱 潍 帷 嵬 帏 囗 𣲗 溦 鄬 鍏 𬶏 涠 洈 𫌭 醀 霺 瀢 濻 癓 欈 沩 爲 圍 幃 潙 潿 濰 維 違 闈 陒 韋
委	尾 伟 纬 萎 诿 苇 痿 猥 炜 亹 隗 娓 韪 寪 洧 玮 䓕 蘤 韡 鲔 磈 𫇭 𬱟 𬀩 痏 骫 㭏 浘 艉 芛 鍡 峗 壝 喡 徫 腲 蜲 儰 蓶 崣 硊 踓 斖
为	位 未 魏 卫 味 伪 谓 胃 喂 慰 喂 尉 渭 畏 蔚 蘶 猬 犩 遗 亹 霨 硙 罻 褽 薉 媦 蜼 藯 𬭬 菋 犚 𫗪 贀 讆 躗 稣 鮇 徻 伪 嬒 为 蝟 緭 螱 衞 錗 爲 衛 叞 苿 蠨 蟐 謂 軎 遺
湾	弯 豌 剜 莞 蜿 刓 潫
完	玩 顽 丸 汍 纨 芄 烷 婠 岏 抏
晚	碗 挽 宛 婉 娩 皖 挽 莞 浣 蜿 畹 菀 琬 鞔 绾 晼 綩 鲩 倇 脕 睕 鋄 睌 葂 啘 埦 捾 晩 梚 椀 盌 萖 鋔 箢 綰 𫓸 鎫 錩 鍠
万	玩 腕 惋 卍 玩 忨 仴 𬘫 萬 蟃 捥 踠
温	瘟 辒 塭 馧 瞃 豱 殟
文	闻 纹 蚊 玟 雯 阌 炆 芠 琝 閺 闅 鼤 駇 魰 𪉃
稳	吻 刎 呡 桽
问	闻 紊 文 汶 抆 免 揾 璺 妏
汪	尪 尢
王	亡
往	网 枉 罔 惘 魍 辋 㲿 網 暀 菵 臦
忘	妄 望 旺 王 朢 迋 莣
翁	嗡 螉 鹟 霐
蓊	滃 暡 浻 瞈 聬 塕
瓮	甕 齆 罋
无	吴 吾 梧 巫 芜 唔 蜈 诬 毋 亡 牾 膴 麌 鼯 郚 鋘 铻 峿 浯 珸 俉 鯃 莁 鷡 洖 瞴 譕
五	午 武 舞 侮 伍 鹉 怃 妩 𣲘 庑 仵 忤 碔 甒 摀 啎 捂 嵨 玝 倵 橆 躌
勿	物 务 恶 误 悟 晤 雾 戊 钨 坞 兀 骛 寤 𫐄 杌 婺 鹜 垩 沕 迕 遻 鋈 屼 扤 煟 卼 焐 靰 阢 粅 矹 芴 垭 逜 痦 齀 蘁 岉 恶 蓩
淤	迂 瘀 纡 ㄩ 毹 箊 扜 穻 盓
约	曰 哕 箹 焥
月	越 乐 悦 阅 粤 跃 嶽 岳 耀 钥 曜 药 钺 说 刖 瀹 籥 樾 爚 礿 禴 趯 𫐄 𬸚 龠 狘 玥 戉 泧 钥 抈 蚎 蘥 鸙 妜 悅 捳 敫 枂 楽 粵 蚏 跀 阅 龥 樂 哾 恱 櫟 篗 籆 籰 蘔 說 躍 鑰 鉞 閱
冤	渊 鸳 鸢 宛 眢 蜎 鹓 肙 鋺 惌 棩 蒬 裷 鼘 葾 蜵 裫 駌 嬽 灁
原	元 员 园 圆 缘 源 援 媛 袁 猿 垣 沅 辕 爰 圜 鼋 嫄 橼 芫 湲 𫘪 笎 羱 蝯 邧 蝝 妧 萲 螈 蚖 杬 榞 溒 媴 猭 獂 榬 蒝 鎱 邍 鶢
远	妴
院	愿 怨 苑 远 媛 瑗 願 掾 褑 夗 謜 禐 噮
晕	氲 缊 赟 奫 蝹
云	雲 匀 昀 耘 芸 纭 煴 筠 涢 沄 畇 筼 澐 𤈶 鋆 芸 妘 伝 縜 荺 郧 枃 眃
允	陨 殒 狁 𫕥 褞 抎 賱 輑 𫟵 阭
运	韵 孕 熨 蕴 愠 酝 恽 晕 韫 郓 蕰 枟 𦈉 鶤 员
佣	庸 雍 拥 壅 痈 臃 墉 镛 慵 饔 邕 廱 雝 嗈 灉 鄘 噰 澭 蕹 滽 郺
佣	喁 颙 傛 槦 嫆 嵱 嫞
永	泳 咏 勇 拥 踊 涌 蛹 甬 壅 恿 臃 俑 踊 埇 塎 禜 湧 悀 銢
用	傭 蒏
于	愉 鱼 娱 余 於 渔 予 愚 餘 竽 榆 逾 虞 俞 舆 瑜 渝 隅 臾 腴 盂 谀 逾 舁 圩 欤 觎 畬 萸 嵎 窬 妤 揄 歈 禺 轝 隃 雩 杅 楰 玗 𦈕 羭 蝓 褕 瘐 艅 狳 邘 玙 硢 𥫣 釪 崳 湡 鄃 腧 睮 雓 澞 蕍 螸 謣 鮽 鵌 蘛 鸆 鸒 衧 唹 堣 堬 雽 歶 旟 鰅 齵 虧 伃 兪 哊 娯 娛 扵 桙 楡 畭 萮 酑 鍝 魣 歟 漁 畲 輿 茰 覦 讋 諛 鎔 餘 骬 魚 鷠
与	语 雨 予 羽 屿 宇 禹 庾 龉 噢 圄 圉 窳 伛 俣 敔 噳 楀 瑀 與 萭 貐 偊 祤 斞 鄅 寙 篽 蘌 斔 螤 婾 嬩 懙 聥 鰸 傴 匬 嶼 語 齬
育	遇 预 玉 欲 域 喻 愈 誉 狱 欲 浴 裕 煜 寓 御 与 钰 豫 御 郁 吁 谕 愈 鬱 驭 昱 毓 芋 尉 熨 俞 峪 聿 妪 彧 饫 鬻 谷 鹬 燠 蜮 堉 语 瘉 棫 滪 矞 禺 罭 蓣 遹 阈 隩 鹆 棜 淢 燏 獝 繘 魊 薁 驈 悆 𫛣 鋊 淯 黦 栯 砡 礜 欥 𨉗 輍 悇 稢 蒮 噊 鳿 醧 饇 爩 灪 戫 袬 緎 蓹 𫓾 穥 缷 蕷 蜟 譽 語 諭 逳 鈺 閾 預 飫 馭 鵒 鷸